taxonName	taxonPath	recordCount
Porites porites (Pallas, 1766)	Animalia|Cnidaria|Anthozoa|Scleractinia|Poritidae|Porites|porites|Porites porites (Pallas, 1766)	36
Montastraea annularis (Ellis & Solander, 1786)	Animalia|Cnidaria|Anthozoa|Scleractinia|Faviidae|Montastraea|annularis|Montastraea annularis (Ellis & Solander, 1786)	32
Porites astreoides Lamarck, 1816	Animalia|Cnidaria|Anthozoa|Scleractinia|Poritidae|Porites|astreoides|Porites astreoides Lamarck, 1816	30
Agaricia Lamarck, 1801	Animalia|Cnidaria|Anthozoa|Scleractinia|Agariciidae|Agaricia||Agaricia Lamarck, 1801	16
Montastraea faveolata (Ellis & Solander, 1786)	Animalia|Cnidaria|Anthozoa|Scleractinia|Faviidae|Montastraea|faveolata|Montastraea faveolata (Ellis & Solander, 1786)	16
Dichocoenia stokesi Milne Edwards & Haime, 1848	Animalia|Cnidaria|Anthozoa|Scleractinia|Meandrinidae|Dichocoenia|stokesi|Dichocoenia stokesi Milne Edwards & Haime, 1848	14
Pelecanus occidentalis Linnaeus, 1766	Animalia|Chordata|Aves|Pelecaniformes|Pelecanidae|Pelecanus|occidentalis|Pelecanus occidentalis Linnaeus, 1766	14
Montastraea cavernosa Linnaeus, 1767	Animalia|Cnidaria|Anthozoa|Scleractinia|Faviidae|Montastraea|cavernosa|Montastraea cavernosa Linnaeus, 1767	12
Coereba flaveola (Linnaeus, 1758)	Animalia|Chordata|Aves|Passeriformes|Coerebidae|Coereba|flaveola|Coereba flaveola (Linnaeus, 1758)	10
Sula leucogaster (Boddaert, 1783)	Animalia|Chordata|Aves|Suliformes|Sulidae|Sula|leucogaster|Sula leucogaster (Boddaert, 1783)	10
Fregata magnificens Mathews, 1914	Animalia|Chordata|Aves|Suliformes|Fregatidae|Fregata|magnificens|Fregata magnificens Mathews, 1914	9
Colpophyllia natans (Houttuyn, 1772)	Animalia|Cnidaria|Anthozoa|Scleractinia|Faviidae|Colpophyllia|natans|Colpophyllia natans (Houttuyn, 1772)	8
Tyrannus dominicensis (Gmelin, 1788)	Animalia|Chordata|Aves|Passeriformes|Tyrannidae|Tyrannus|dominicensis|Tyrannus dominicensis (Gmelin, 1788)	8
Crotophaga ani Linnaeus, 1758	Animalia|Chordata|Aves|Cuculiformes|Cuculidae|Crotophaga|ani|Crotophaga ani Linnaeus, 1758	8
Molossus molossus (Pallas, 1766)	Animalia|Chordata|Mammalia|Chiroptera|Molossidae|Molossus|molossus|Molossus molossus (Pallas, 1766)	8
Acropora cervicornis (Lamarck, 1816)	Animalia|Cnidaria|Anthozoa|Scleractinia|Acroporidae|Acropora|cervicornis|Acropora cervicornis (Lamarck, 1816)	8
Himantopus mexicanus (Statius Muller, 1776)	Animalia|Chordata|Aves|Charadriiformes|Recurvirostridae|Himantopus|mexicanus|Himantopus mexicanus (Statius Muller, 1776)	6
Margarops fuscatus (Vieillot, 1808)	Animalia|Chordata|Aves|Passeriformes|Mimidae|Margarops|fuscatus|Margarops fuscatus (Vieillot, 1808)	6
Diploria labyrinthiformis (Linnaeus, 1758)	Animalia|Cnidaria|Anthozoa|Scleractinia|Faviidae|Diploria|labyrinthiformis|Diploria labyrinthiformis (Linnaeus, 1758)	6
Montastraea franksi (Gregory, 1895)	Animalia|Cnidaria|Anthozoa|Scleractinia|Faviidae|Montastraea|franksi|Montastraea franksi (Gregory, 1895)	4
Leucophaeus atricilla (Linnaeus, 1758)	Animalia|Chordata|Aves|Charadriiformes|Laridae|Leucophaeus|atricilla|Leucophaeus atricilla (Linnaeus, 1758)	4
Siderastrea siderea (Ellis & Solander, 1786)	Animalia|Cnidaria|Anthozoa|Scleractinia|Siderastreidae|Siderastrea|siderea|Siderastrea siderea (Ellis & Solander, 1786)	4
Actitis macularius (Linnaeus, 1766)	Animalia|Chordata|Aves|Charadriiformes|Scolopacidae|Actitis|macularius|Actitis macularius (Linnaeus, 1766)	4
Phoenicopterus ruber Linnaeus, 1758	Animalia|Chordata|Aves|Phoenicopteriformes|Phoenicopteridae|Phoenicopterus|ruber|Phoenicopterus ruber Linnaeus, 1758	4
Eulampis holosericeus (Linnaeus, 1758)	Animalia|Chordata|Aves|Apodiformes|Trochilidae|Eulampis|holosericeus|Eulampis holosericeus (Linnaeus, 1758)	4
Mniotilta varia (Linnaeus, 1766)	Animalia|Chordata|Aves|Passeriformes|Parulidae|Mniotilta|varia|Mniotilta varia (Linnaeus, 1766)	4
Stephanocoenia intersepta (Lamarck, 1816)	Animalia|Cnidaria|Anthozoa|Scleractinia|Astrocoeniidae|Stephanocoenia|intersepta|Stephanocoenia intersepta (Lamarck, 1816)	4
Streptopelia decaocto (Frivaldszky, 1838)	Animalia|Chordata|Aves|Columbiformes|Columbidae|Streptopelia|decaocto|Streptopelia decaocto (Frivaldszky, 1838)	4
Orthorhyncus cristatus (Linnaeus, 1758)	Animalia|Chordata|Aves|Apodiformes|Trochilidae|Orthorhyncus|cristatus|Orthorhyncus cristatus (Linnaeus, 1758)	4
Anous stolidus (Linnaeus, 1758)	Animalia|Chordata|Aves|Charadriiformes|Laridae|Anous|stolidus|Anous stolidus (Linnaeus, 1758)	4
Thalasseus maximus (Boddaert, 1783)	Animalia|Chordata|Aves|Charadriiformes|Laridae|Thalasseus|maximus|Thalasseus maximus (Boddaert, 1783)	3
Fissidens hornschuchii Montagne, 1840	Plantae|Bryophyta|Bryopsida|Fissidentales|Fissidentaceae|Fissidens|hornschuchii|Fissidens hornschuchii Montagne, 1840	3
Thalasseus maximus (Boddaert, 1783)	Animalia|Chordata|Aves|Charadriiformes|Laridae|Thalaseus|maximus|Thalasseus maximus (Boddaert, 1783)	3
Tringa melanoleuca (Gmelin, 1789)	Animalia|Chordata|Aves|Charadriiformes|Scolopacidae|Tringa|melanoleuca|Tringa melanoleuca (Gmelin, 1789)	3
Anas bahamensis Linnaeus, 1758	Animalia|Chordata|Aves|Anseriformes|Anatidae|Anas|bahamensis|Anas bahamensis Linnaeus, 1758	3
Himantopus mexicanus	Animalia|Chordata|Aves|Charadriiformes|Recurvirostridae|Himantopus|Himantopus mexicanus	2
Nyctanassa violacea (Linnaeus, 1758)	Animalia|Chordata|Aves|Pelecaniformes|Ardeidae|Nyctanassa|violacea|Nyctanassa violacea (Linnaeus, 1758)	2
Meandrina meandrites (Linnaeus, 1758)	Animalia|Cnidaria|Anthozoa|Scleractinia|Meandrinidae|Meandrina|meandrites|Meandrina meandrites (Linnaeus, 1758)	2
Charadrius wilsonia Ord, 1814	Animalia|Chordata|Aves|Charadriiformes|Charadriidae|Charadrius|wilsonia|Charadrius wilsonia Ord, 1814	2
Coccyzus minor (Gmelin, 1788)	Animalia|Chordata|Aves|Cuculiformes|Cuculidae|Coccyzus|minor|Coccyzus minor (Gmelin, 1788)	2
Onychoprion anaethetus (Scopoli, 1786)	Animalia|Chordata|Aves|Charadriiformes|Laridae|Onychoprion|anaethetus|Onychoprion anaethetus (Scopoli, 1786)	2
Tiaris bicolor (Linnaeus, 1766)	Animalia|Chordata|Aves|Passeriformes|Emberizidae|Tiaris|bicolor|Tiaris bicolor (Linnaeus, 1766)	2
Anas americana Gmelin, 1789	Animalia|Chordata|Aves|Anseriformes|Anatidae|Anas|americana|Anas americana Gmelin, 1789	2
Tringa flavipes (Gmelin, 1789)	Animalia|Chordata|Aves|Charadriiformes|Scolopacidae|Tringa|flavipes|Tringa flavipes (Gmelin, 1789)	2
Heliotropium curassavicum	Plantae|Magnoliophyta|Magnoliopsida|Boraginales|Boraginaceae|Heliotropium|Heliotropium curassavicum	2
Pluvialis squatarola (Linnaeus, 1758)	Animalia|Chordata|Aves|Charadriiformes|Charadriidae|Pluvialis|squatarola|Pluvialis squatarola (Linnaeus, 1758)	2
Molossus molossus subsp. fortis Miller, 1913	Animalia|Chordata|Mammalia|Chiroptera|Molossidae|Molossus|molossus|Molossus molossus subsp. fortis Miller, 1913	2
Haematopus palliatus Temminck, 1820	Animalia|Chordata|Aves|Charadriiformes|Haematopodidae|Haematopus|palliatus|Haematopus palliatus Temminck, 1820	2
Ixobrychus exilis (Gmelin, 1789)	Animalia|Chordata|Aves|Pelecaniformes|Ardeidae|Ixobrychus|exilis|Ixobrychus exilis (Gmelin, 1789)	2
Phaethon aethereus Linnaeus, 1758	Animalia|Chordata|Aves|Phaethontiformes|Phaethontidae|Phaethon|aethereus|Phaethon aethereus Linnaeus, 1758	2
Zenaida aurita (Temminck, 1809)	Animalia|Chordata|Aves|Columbiformes|Columbidae|Zenaida|aurita|Zenaida aurita (Temminck, 1809)	2
Hemitoma octoradiata	Animalia|Mollusca|Gastropoda|Fissurellidae|Hemitoma|Hemitoma octoradiata	2
Dendrogyra cylindrus Ehrenberg, 1834	Animalia|Cnidaria|Anthozoa|Scleractinia|Meandrinidae|Dendrogyra|cylindrus|Dendrogyra cylindrus Ehrenberg, 1834	2
Hirundo rustica Linnaeus, 1758	Animalia|Chordata|Aves|Passeriformes|Hirundinidae|Hirundo|rustica|Hirundo rustica Linnaeus, 1758	2
Setophaga petechia	Animalia|Chordata|Aves|Passeriformes|Parulidae|Setophaga|petechia|Setophaga petechia	2
Falco sparverius Linnaeus, 1758	Animalia|Chordata|Aves|Falconiformes|Falconidae|Falco|sparverius|Falco sparverius Linnaeus, 1758	2
Sternula antillarum Lesson, 1847	Animalia|Chordata|Aves|Charadriiformes|Laridae|Sternula|antillarum|Sternula antillarum Lesson, 1847	2
Calidris mauri (Cabanis, 1857)	Animalia|Chordata|Aves|Charadriiformes|Scolopacidae|Calidris|mauri|Calidris mauri (Cabanis, 1857)	2
Tiaris bicolor (Linnaeus, 1766)	Animalia|Chordata|Aves|Passeriformes|Thraupidae|Tiaris|bicolor|Tiaris bicolor (Linnaeus, 1766)	2
Patagioenas squamosa (Bonnaterre, 1792)	Animalia|Chordata|Aves|Columbiformes|Columbidae|Patagioenas|squamosa|Patagioenas squamosa (Bonnaterre, 1792)	2
Sterna hirundo Linnaeus, 1758	Animalia|Chordata|Aves|Charadriiformes|Laridae|Sterna|hirundo|Sterna hirundo Linnaeus, 1758	2
Ardea herodias Linnaeus, 1758	Animalia|Chordata|Aves|Pelecaniformes|Ardeidae|Ardea|herodias|Ardea herodias Linnaeus, 1758	2
Phaethon aethereus Linnaeus, 1758	Animalia|Chordata|Aves|Phaethontiformes|Phaethontidae|PhaÃ«thon|aethereus|Phaethon aethereus Linnaeus, 1758	2
Setophaga petechia (Linnaeus, 1766)	Animalia|Chordata|Aves|Passeriformes|Parulidae|Setophaga|petechia|Setophaga petechia (Linnaeus, 1766)	2
Cicindela trifasciata	Animalia|Arthropoda|Insecta|Coleoptera|Carabidae|Cicindela|Cicindela trifasciata	1
Lolliguncula brevis (Blainville, 1823)	Animalia|Mollusca|Cephalopoda|Teuthida|Loliginidae|Lolliguncula|brevis|Lolliguncula brevis (Blainville, 1823)	1
Calidris himantopus (Bonaparte, 1826)	Animalia|Chordata|Aves|Charadriiformes|Scolopacidae|Calidris|himantopus|Calidris himantopus (Bonaparte, 1826)	1
Formicidae	Animalia|Arthropoda|Insecta|Hymenoptera|Formicidae|||Formicidae	1
Lolliguncula brevis (Blainville, 1823)	Animalia|Mollusca|Cephalopoda|Myopsida|Loliginidae|Lolliguncula|brevis|Lolliguncula brevis (Blainville, 1823)	1
Phaethon lepturus Daudin, 1802	Animalia|Chordata|Aves|Phaethontiformes|Phaethontidae|Phaethon|lepturus|Phaethon lepturus Daudin, 1802	1
Solanum polygamum Vahl	Plantae|Tracheophyta|Magnoliopsida|Solanales|Solanaceae|Solanum|polygamum|Solanum polygamum Vahl	1
Calidris pusilla (Linnaeus, 1766)	Animalia|Chordata|Aves|Charadriiformes|Scolopacidae|Calidris|pusilla|Calidris pusilla (Linnaeus, 1766)	1
Columbina passerina (Linnaeus, 1758)	Animalia|Chordata|Aves|Columbiformes|Columbidae|Columbina|passerina|Columbina passerina (Linnaeus, 1758)	1
Anas discors Linnaeus, 1766	Animalia|Chordata|Aves|Anseriformes|Anatidae|Anas|discors|Anas discors Linnaeus, 1766	1
Fissidens zollingeri Montagne, 1845	Plantae|Bryophyta|Bryopsida|Fissidentales|Fissidentaceae|Fissidens|zollingeri|Fissidens zollingeri Montagne, 1845	1
Bourreria baccata Raf.	Plantae|Magnoliophyta|Magnoliopsida|Boraginales|Boraginaceae|Bourreria|baccata|Bourreria baccata Raf.	1
Formicidae Latreille, 1802	Animalia|Arthropoda|Insecta|Hymenoptera|Formicidae|||Formicidae Latreille, 1802	1
Flakea papillata O. E. Erikss.	Fungi|Ascomycota|Eurotiomycetes|Verrucariales||Agonimia|papillata|Flakea papillata O. E. Erikss.	1
Phaethon lepturus Daudin, 1802	Animalia|Chordata|Aves|Phaethontiformes|Phaethontidae|PhaÃ«thon|lepturus|Phaethon lepturus Daudin, 1802	1
Thalasseus sandvicensis (Latham, 1787)	Animalia|Chordata|Aves|Charadriiformes|Laridae|Thalasseus|sandvicensis|Thalasseus sandvicensis (Latham, 1787)	1
Solanum torvum Sw.	Plantae|Tracheophyta|Magnoliopsida|Solanales|Solanaceae|Solanum|torvum|Solanum torvum Sw.	1
Thalasseus sandvicensis (Latham, 1787)	Animalia|Chordata|Aves|Charadriiformes|Laridae|Thalaseus|sandvicensis|Thalasseus sandvicensis (Latham, 1787)	1