taxonName	taxonPath	recordCount
Paratrechina longicornis (Latreille, 1802)	Animalia|Arthropoda|Insecta|Hymenoptera|Formicidae|Paratrechina|longicornis|Paratrechina longicornis (Latreille, 1802)	108
Pheidole megacephala (Fabricius, 1793)	Animalia|Arthropoda|Insecta|Hymenoptera|Formicidae|Pheidole|megacephala|Pheidole megacephala (Fabricius, 1793)	106
Chioninia spinalis (Boulenger, 1906)	Animalia|Chordata|Reptilia|Squamata|Scincidae|Chioninia|spinalis|Chioninia spinalis (Boulenger, 1906)	77
Monomorium subopacum (Smith, 1858)	Animalia|Arthropoda|Insecta|Hymenoptera|Formicidae|Monomorium|subopacum|Monomorium subopacum (Smith, 1858)	70
Lepisiota capensis (Mayr, 1862)	Animalia|Arthropoda|Insecta|Hymenoptera|Formicidae|Lepisiota|capensis|Lepisiota capensis (Mayr, 1862)	52
Passer iagoensis (Gould, 1838)	Animalia|Chordata|Aves|Passeriformes|Passeridae|Passer|iagoensis|Passer iagoensis (Gould, 1838)	45
Brachyponera Emery, 1901	Animalia|Arthropoda|Insecta|Hymenoptera|Formicidae|Pachycondyla||Brachyponera Emery, 1901	44
Falco tinnunculus Linnaeus, 1758	Animalia|Chordata|Aves|Falconiformes|Falconidae|Falco|tinnunculus|Falco tinnunculus Linnaeus, 1758	43
Corvus ruficollis Lesson, 1831	Animalia|Chordata|Aves|Passeriformes|Corvidae|Corvus|ruficollis|Corvus ruficollis Lesson, 1831	35
Conus cuneolus Reeve, 1843	Animalia|Mollusca|Gastropoda|Neogastropoda|Conidae||cuneolus|Conus cuneolus Reeve, 1843	34
Passer hispaniolensis (Temminck, 1820)	Animalia|Chordata|Aves|Passeriformes|Passeridae|Passer|hispaniolensis|Passer hispaniolensis (Temminck, 1820)	33
Sylvia conspicillata Temminck, 1820	Animalia|Chordata|Aves|Passeriformes|Sylviidae|Sylvia|conspicillata|Sylvia conspicillata Temminck, 1820	32
Camponotus maculatus (Fabricius, 1782)	Animalia|Arthropoda|Insecta|Hymenoptera|Formicidae|Camponotus|maculatus|Camponotus maculatus (Fabricius, 1782)	32
Teloschistes flavicans (Sw.) Norman	Fungi|Ascomycota|Lecanoromycetes|Teloschistales|Teloschistaceae|Teloschistes|flavicans|Teloschistes flavicans (Sw.) Norman	30
Egretta garzetta (Linnaeus, 1766)	Animalia|Chordata|Aves|Pelecaniformes|Ardeidae|Egretta|garzetta|Egretta garzetta (Linnaeus, 1766)	28
Arenaria interpres (Linnaeus, 1758)	Animalia|Chordata|Aves|Charadriiformes|Scolopacidae|Arenaria|interpres|Arenaria interpres (Linnaeus, 1758)	28
Apus alexandri Hartert, 1901	Animalia|Chordata|Aves|Apodiformes|Apodidae|Apus|alexandri|Apus alexandri Hartert, 1901	27
Columba livia Gmelin, 1789	Animalia|Chordata|Aves|Columbiformes|Columbidae|Columba|livia|Columba livia Gmelin, 1789	27
Plagiolepis puncta Forel, 1910	Animalia|Arthropoda|Insecta|Hymenoptera|Formicidae|Plagiolepis|puncta|Plagiolepis puncta Forel, 1910	26
Gymnoscelis lindbergi Herbulot, 1957	Animalia|Arthropoda|Insecta|Lepidoptera|Geometridae|Gymnoscelis|lindbergi|Gymnoscelis lindbergi Herbulot, 1957	24
Conus crotchii Reeve, 1849	Animalia|Mollusca|Gastropoda|Neogastropoda|Conidae||crotchii|Conus crotchii Reeve, 1849	24
Eremopterix nigriceps (Gould, 1839)	Animalia|Chordata|Aves|Passeriformes|Alaudidae|Eremopterix|nigriceps|Eremopterix nigriceps (Gould, 1839)	24
Conus venulatus Hwass in Bruguière, 1792	Animalia|Mollusca|Gastropoda|Neogastropoda|Conidae||venulatus|Conus venulatus Hwass in Bruguière, 1792	24
Ammomanes cinctura (Gould, 1839)	Animalia|Chordata|Aves|Passeriformes|Alaudidae|Ammomanes|cinctura|Ammomanes cinctura (Gould, 1839)	23
Gorgadesia mira Tav.	Fungi|Ascomycota|Arthoniomycetes|Arthoniales|Roccellaceae|Gorgadesia|mira|Gorgadesia mira Tav.	22
Sylvia atricapilla (Linnaeus, 1758)	Animalia|Chordata|Aves|Passeriformes|Sylviidae|Sylvia|atricapilla|Sylvia atricapilla (Linnaeus, 1758)	22
Ardea cinerea Linnaeus, 1758	Animalia|Chordata|Aves|Pelecaniformes|Ardeidae|Ardea|cinerea|Ardea cinerea Linnaeus, 1758	21
Ramalina rubrotincta Krog & Østh.	Fungi|Ascomycota|Lecanoromycetes|Lecanorales|Ramalinaceae|Ramalina|rubrotincta|Ramalina rubrotincta Krog & Østh.	20
Halcyon leucocephala (Statius Muller, 1776)	Animalia|Chordata|Aves|Coraciiformes|Alcedinidae|Halcyon|leucocephala|Halcyon leucocephala (Statius Muller, 1776)	20
Calidris alba (Pallas, 1764)	Animalia|Chordata|Aves|Charadriiformes|Scolopacidae|Calidris|alba|Calidris alba (Pallas, 1764)	19
Bubulcus ibis (Linnaeus, 1758)	Animalia|Chordata|Aves|Pelecaniformes|Ardeidae|Bubulcus|ibis|Bubulcus ibis (Linnaeus, 1758)	19
Lepidoptera	Animalia|Arthropoda|Insecta|Lepidoptera||||Lepidoptera	18
Gymnoscelis Mabille, 1868	Animalia|Arthropoda|Insecta|Lepidoptera|Geometridae|Gymnoscelis||Gymnoscelis Mabille, 1868	18
Pandion haliaetus (Linnaeus, 1758)	Animalia|Chordata|Aves|Accipitriformes|Pandionidae|Pandion|haliaetus|Pandion haliaetus (Linnaeus, 1758)	17
Roccella canariensis Darb.	Fungi|Ascomycota|Arthoniomycetes|Arthoniales|Roccellaceae|Rocella|canariensis|Roccella canariensis Darb.	17
Roccella canariensis Darb.	Fungi|Ascomycota|Arthoniomycetes|Arthoniales|Roccellaceae|Roccella|canariensis|Roccella canariensis Darb.	17
Charadrius alexandrinus Linnaeus, 1758	Animalia|Chordata|Aves|Charadriiformes|Charadriidae|Charadrius|alexandrinus|Charadrius alexandrinus Linnaeus, 1758	17
Estrilda astrild (Linnaeus, 1758)	Animalia|Chordata|Aves|Passeriformes|Estrildidae|Estrilda|astrild|Estrilda astrild (Linnaeus, 1758)	16
Conus irregularis G.B. Sowerby II, 1858	Animalia|Mollusca|Gastropoda|Neogastropoda|Conidae||irregularis|Conus irregularis G.B. Sowerby II, 1858	16
Roccella vicentina (Vain.) Follmann	Fungi|Ascomycota|Arthoniomycetes|Arthoniales|Roccellaceae|Roccella|vicentina|Roccella vicentina (Vain.) Follmann	16
Roccella vicentina (Vainio) Vainio	Fungi|Ascomycota|Arthoniomycetes|Arthoniales|Roccellaceae|Rocella|vicentina|Roccella vicentina (Vainio) Vainio	16
Monomorium destructor (Jerdon, 1851)	Animalia|Arthropoda|Insecta|Hymenoptera|Formicidae|Monomorium|destructor|Monomorium destructor (Jerdon, 1851)	16
Ramalina maderensis Motyka	Fungi|Ascomycota|Lecanoromycetes|Lecanorales|Ramalinaceae|Ramalina|maderensis|Ramalina maderensis Motyka	16
Himantopus himantopus (Linnaeus, 1758)	Animalia|Chordata|Aves|Charadriiformes|Recurvirostridae|Himantopus|himantopus|Himantopus himantopus (Linnaeus, 1758)	15
Acrocephalus brevipennis (Keulemans, 1866)	Animalia|Chordata|Aves|Passeriformes|Acrocephalidae|Acrocephalus|brevipennis|Acrocephalus brevipennis (Keulemans, 1866)	15
Charadrius hiaticula Linnaeus, 1758	Animalia|Chordata|Aves|Charadriiformes|Charadriidae|Charadrius|hiaticula|Charadrius hiaticula Linnaeus, 1758	14
Numida meleagris (Linnaeus, 1758)	Animalia|Chordata|Aves|Galliformes|Numididae|Numida|meleagris|Numida meleagris (Linnaeus, 1758)	14
Alaemon alaudipes (Desfontaines, 1789)	Animalia|Chordata|Aves|Passeriformes|Alaudidae|Alaemon|alaudipes|Alaemon alaudipes (Desfontaines, 1789)	14
Monomorium bicolor Emery, 1877	Animalia|Arthropoda|Insecta|Hymenoptera|Formicidae|Monomorium|bicolor|Monomorium bicolor Emery, 1877	14
Tringa nebularia (Gunnerus, 1767)	Animalia|Chordata|Aves|Charadriiformes|Scolopacidae|Tringa|nebularia|Tringa nebularia (Gunnerus, 1767)	14
Cursorius cursor (Latham, 1787)	Animalia|Chordata|Aves|Charadriiformes|Glareolidae|Cursorius|cursor|Cursorius cursor (Latham, 1787)	14
Monomorium exiguum Forel, 1894	Animalia|Arthropoda|Insecta|Hymenoptera|Formicidae|Monomorium|exiguum|Monomorium exiguum Forel, 1894	14
Numenius phaeopus (Linnaeus, 1758)	Animalia|Chordata|Aves|Charadriiformes|Scolopacidae|Numenius|phaeopus|Numenius phaeopus (Linnaeus, 1758)	13
Amietophrynus regularis (Reuss, 1833)	Animalia|Chordata|Amphibia|Anura|Bufonidae|Amietophrynus|regularis|Amietophrynus regularis (Reuss, 1833)	12
Ramalina subgeniculata Nyl.	Fungi|Ascomycota|Lecanoromycetes|Lecanorales|Ramalinaceae|Ramalina|subgeniculata|Ramalina subgeniculata Nyl.	12
Parmotrema tinctorum (Despr. ex Nyl.) Hale	Fungi|Ascomycota|Lecanoromycetes|Lecanorales|Parmeliaceae|Parmotrema|tinctorum|Parmotrema tinctorum (Despr. ex Nyl.) Hale	12
Dacus frontalis Becker, 1922	Animalia|Arthropoda|Insecta|Diptera|Lauxaniidae|Dacus|frontalis|Dacus frontalis Becker, 1922	12
Remora remora (Linnaeus, 1758)	Animalia|Chordata|Actinopterygii|Perciformes|Echeneidae|Remora|remora|Remora remora (Linnaeus, 1758)	12
Actitis hypoleucos (Linnaeus, 1758)	Animalia|Chordata|Aves|Charadriiformes|Scolopacidae|Actitis|hypoleucos|Actitis hypoleucos (Linnaeus, 1758)	11
Conus damottai Trovão, 1979	Animalia|Mollusca|Gastropoda|Neogastropoda|Conidae||damottai|Conus damottai Trovão, 1979	10
Heterodermia leucomelos (L.) Poelt	Fungi|Ascomycota|Lecanoromycetes|Teloschistales|Physciaceae|Heterodermia|leucomelos|Heterodermia leucomelos (L.) Poelt	10
Pauropsylla Rübsaamen, 1899	Animalia|Arthropoda|Insecta|Hemiptera|Triozidae|Pauropsylla||Pauropsylla Rübsaamen, 1899	10
Euphorbia hirta	Plantae|Magnoliophyta|Magnoliopsida|Malpighiales|Euphorbiaceae|Euphorbia|Euphorbia hirta	10
Porites astreoides Lamarck, 1816	Animalia|Cnidaria|Anthozoa|Scleractinia|Poritidae|Porites|astreoides|Porites astreoides Lamarck, 1816	10
Lantana camara	Plantae|Magnoliophyta|Magnoliopsida|Lamiales|Verbenaceae|Lantana|Lantana camara	10
Sula leucogaster (Boddaert, 1783)	Animalia|Chordata|Aves|Suliformes|Sulidae|Sula|leucogaster|Sula leucogaster (Boddaert, 1783)	9
Plantae	Plantae|||||||Plantae	9
Conus josephinae Rolán, 1980	Animalia|Mollusca|Gastropoda|Neogastropoda|Conidae||josephinae|Conus josephinae Rolán, 1980	9
Conus venulatus Hwass in Bruguière, 1792	Animalia|Mollusca|Gastropoda|Neogastropoda|Conidae|Conus|venulatus|Conus venulatus Hwass in Bruguière, 1792	9
Dirinaria applanata (Fée) D. D. Awasthi	Fungi|Ascomycota|Lecanoromycetes|Teloschistales|Physciaceae|Dirinaria|applanata|Dirinaria applanata (Fée) D. D. Awasthi	8
Conus trochulus Reeve, 1844	Animalia|Mollusca|Gastropoda|Neogastropoda|Conidae||trochulus|Conus trochulus Reeve, 1844	8
Ardea purpurea Linnaeus, 1766	Animalia|Chordata|Aves|Pelecaniformes|Ardeidae|Ardea|purpurea|Ardea purpurea Linnaeus, 1766	8
Pseudupeneus prayensis (Cuvier, 1829)	Animalia|Chordata|Actinopterygii|Perciformes|Mullidae|Pseudupeneus|prayensis|Pseudupeneus prayensis (Cuvier, 1829)	8
Usnea fragilescens Hav. ex Lynge	Fungi|Ascomycota|Lecanoromycetes|Lecanorales|Parmeliaceae|Usnea|fragilescens|Usnea fragilescens Hav. ex Lynge	8
Platalea leucorodia Linnaeus, 1758	Animalia|Chordata|Aves|Pelecaniformes|Threskiornithidae|Platalea|leucorodia|Platalea leucorodia Linnaeus, 1758	8
Hymenoptera	Animalia|Arthropoda|Insecta|Hymenoptera||||Hymenoptera	8
Ricinus communis	Plantae|Magnoliophyta|Magnoliopsida|Malpighiales|Euphorbiaceae|Ricinus|Ricinus communis	8
Lavandula rotundifolia Benth.	Plantae|Tracheophyta|Magnoliopsida|Lamiales|Lamiaceae|Lavandula|rotundifolia|Lavandula rotundifolia Benth.	8
Ipomoea purpurea	Plantae|Magnoliophyta|Magnoliopsida|Solanales|Convolvulaceae|Ipomoea|Ipomoea purpurea	8
Roccella boergesenii Vain.	Fungi|Ascomycota|Arthoniomycetes|Arthoniales|Roccellaceae|Roccella|boergesenii|Roccella boergesenii Vain.	8
Cladophora Kützing, 1843	Plantae|Chlorophyta|Ulvophyceae|Cladophorales|Cladophoraceae|Cladophora||Cladophora Kützing, 1843	8
Roccella boergesenii Vainio	Fungi|Ascomycota|Arthoniomycetes|Arthoniales|Roccellaceae|Rocella|boergesenii|Roccella boergesenii Vainio	8
Gallinula chloropus (Linnaeus, 1758)	Animalia|Chordata|Aves|Gruiformes|Rallidae|Gallinula|chloropus|Gallinula chloropus (Linnaeus, 1758)	8
Tringa glareola Linnaeus, 1758	Animalia|Chordata|Aves|Charadriiformes|Scolopacidae|Tringa|glareola|Tringa glareola Linnaeus, 1758	8
Conus irregularis G.B. Sowerby II, 1858	Animalia|Mollusca|Gastropoda|Neogastropoda|Conidae|Conus|irregularis|Conus irregularis G.B. Sowerby II, 1858	7
Asplenium aethiopicum (Burm. f.) Bech.	Plantae|Pteridophyta|Polypodiopsida|Polypodiales|Aspleniaceae|Asplenium|aethiopicum|Asplenium aethiopicum (Burm. f.) Bech.	7
Conus fuscoflavus Röckel, Rolán & Monteiro, 1980	Animalia|Mollusca|Gastropoda|Neogastropoda|Conidae||fuscoflavus|Conus fuscoflavus Röckel, Rolán & Monteiro, 1980	7
Asplenium aethiopicum (Burm. f.) Bech.	Plantae|Tracheophyta|Polypodiopsida|Polypodiales|Aspleniaceae|Asplenium|aethiopicum|Asplenium aethiopicum (Burm. f.) Bech.	7
Zonaria picta (Gray, 1824)	Animalia|Mollusca|Gastropoda|Littorinimorpha|Cypraeidae|Zonaria|picta|Zonaria picta (Gray, 1824)	7
Conus borgesi Trovão, 1979	Animalia|Mollusca|Gastropoda|Neogastropoda|Conidae||borgesi|Conus borgesi Trovão, 1979	6
Monomorium floricola (Jerdon, 1851)	Animalia|Arthropoda|Insecta|Hymenoptera|Formicidae|Monomorium|floricola|Monomorium floricola (Jerdon, 1851)	6
Arabidopsis thaliana (L.) Heynh.	Plantae|Tracheophyta|Magnoliopsida|Brassicales|Brassicaceae|Arabidopsis|thaliana|Arabidopsis thaliana (L.) Heynh.	6
Orthoptera	Animalia|Arthropoda|Insecta|Orthoptera||||Orthoptera	6
Arabidopsis thaliana (L.) Heynh.	Plantae|Magnoliophyta|Magnoliopsida|Brassicales|Brassicaceae|Arabidopsis|thaliana|Arabidopsis thaliana (L.) Heynh.	6
Calidris ferruginea (Pontoppidan, 1763)	Animalia|Chordata|Aves|Charadriiformes|Scolopacidae|Calidris|ferruginea|Calidris ferruginea (Pontoppidan, 1763)	6
Diptera	Animalia|Arthropoda|Insecta|Diptera||||Diptera	6
Tedania Gray, 1867	Animalia|Porifera|Demospongiae|Poecilosclerida|Tedaniidae|Tedania||Tedania Gray, 1867	6
Ramalina peruviana Ach.	Fungi|Ascomycota|Lecanoromycetes|Lecanorales|Ramalinaceae|Ramalina|peruviana|Ramalina peruviana Ach.	6
Calidris pugnax (Linnaeus, 1758)	Animalia|Chordata|Aves|Charadriiformes|Scolopacidae|Philomachus|pugnax|Calidris pugnax (Linnaeus, 1758)	6
Euphorbia hirta L.	Plantae|Magnoliophyta|Magnoliopsida|Malpighiales|Euphorbiaceae|Euphorbia|hirta|Euphorbia hirta L.	6
Roccella allorgei Abbayes	Fungi|Ascomycota|Arthoniomycetes|Arthoniales|Roccellaceae|Roccella|allorgei|Roccella allorgei Abbayes	6
Microloxia Warren, 1893	Animalia|Arthropoda|Insecta|Lepidoptera|Geometridae|Microloxia||Microloxia Warren, 1893	6
Ramalina lacera (With.) J. R. Laundon	Fungi|Ascomycota|Lecanoromycetes|Lecanorales|Ramalinaceae|Ramalina|lacera|Ramalina lacera (With.) J. R. Laundon	6
Antipathes spinescens Gray, 1857	Animalia|Cnidaria|Anthozoa|Antipatharia|Myriopathidae|Tanacetipathes|spinescens|Antipathes spinescens Gray, 1857	6
Anopheles arabiensis Patton, 1905	Animalia|Arthropoda|Insecta|Diptera|Culicidae|Anopheles|arabiensis|Anopheles arabiensis Patton, 1905	6
Zonaria picta (Gray, 1824)	Animalia|Mollusca|Gastropoda|Neotaenioglossa|Cypraeidae|Zonaria|picta|Zonaria picta (Gray, 1824)	6
	|||||||	6
Asplenium aethiopicum subsp. braithwaitii Ormonde	Plantae|Tracheophyta|Polypodiopsida|Polypodiales|Aspleniaceae|Asplenium|aethiopicum|Asplenium aethiopicum subsp. braithwaitii Ormonde	6
Roccella allorgei Des Abb.	Fungi|Ascomycota|Arthoniomycetes|Arthoniales|Roccellaceae|Rocella|allorgei|Roccella allorgei Des Abb.	6
Neophron percnopterus (Linnaeus, 1758)	Animalia|Chordata|Aves|Accipitriformes|Accipitridae|Neophron|percnopterus|Neophron percnopterus (Linnaeus, 1758)	5
Bidens pilosa	Plantae|Magnoliophyta|Magnoliopsida|Asterales|Asteraceae|Bidens|Bidens pilosa	5
Linga adansoni (d'Orbigny, 1839)	Animalia|Mollusca|Bivalvia|Veneroida|Lucinidae|Lucina|adansoni|Linga adansoni (d'Orbigny, 1839)	5
Callithamnion Lyngbye, 1819	Plantae|Rhodophyta|Florideophyceae|Ceramiales|Ceramiaceae|Callithamnion||Callithamnion Lyngbye, 1819	5
Sporobolus spicatus (Vahl) Kunth	Plantae|Tracheophyta|Liliopsida|Poales|Poaceae|Sporobolus|spicatus|Sporobolus spicatus (Vahl) Kunth	5
Callithamnion Lyngbye, 1819	Plantae|Rhodophyta|Florideophyceae|Ceramiales|Callithamniaceae|Callithamnion||Callithamnion Lyngbye, 1819	5
Ardea purpurea subsp. bournei Naurois, 1966	Animalia|Chordata|Aves|Pelecaniformes|Ardeidae|Ardea|purpurea|Ardea purpurea subsp. bournei Naurois, 1966	5
Polysiphonia R.K. Greville, 1823	Plantae|Rhodophyta|Florideophyceae|Ceramiales|Rhodomelaceae|Polysiphonia||Polysiphonia R.K. Greville, 1823	5
Halcyon leucocephala subsp. acteon (Lesson, 1830)	Animalia|Chordata|Aves|Coraciiformes|Alcedinidae|Halcyon|leucocephala|Halcyon leucocephala subsp. acteon (Lesson, 1830)	5
Euphorbia hirta L.	Plantae|Tracheophyta|Magnoliopsida|Malpighiales|Euphorbiaceae|Euphorbia|hirta|Euphorbia hirta L.	5
Corvus ruficollis Lesson, 1830	Animalia|Chordata|Aves|Passeriformes|Corvidae|Corvus|ruficollis|Corvus ruficollis Lesson, 1830	5
Linga adansoni (d'Orbigny, 1839)	Animalia|Mollusca|Bivalvia|Lucinoida|Lucinidae|Lucina|adansoni|Linga adansoni (d'Orbigny, 1839)	5
Circus aeruginosus (Linnaeus, 1758)	Animalia|Chordata|Aves|Accipitriformes|Accipitridae|Circus|aeruginosus|Circus aeruginosus (Linnaeus, 1758)	5
Sporobolus spicatus (Vahl) Kunth	Plantae|Magnoliophyta|Liliopsida|Poales|Poaceae|Sporobolus|spicatus|Sporobolus spicatus (Vahl) Kunth	5
Polysiphonia Greville, 1823	Plantae|Rhodophyta|Florideophyceae|Ceramiales|Rhodomelaceae|Polysiphonia||Polysiphonia Greville, 1823	5
Hirundo rustica Linnaeus, 1758	Animalia|Chordata|Aves|Passeriformes|Hirundinidae|Hirundo|rustica|Hirundo rustica Linnaeus, 1758	4
Phyllanthus niruri var. scabrellus	Plantae|Magnoliophyta|Magnoliopsida|Malpighiales|Phyllanthaceae|Phyllanthus|niruri|Phyllanthus niruri var. scabrellus	4
Acrocephalus brevipennis (Keulemans, 1866)	Animalia|Chordata|Aves|Passeriformes|Sylviidae|Acrocephalus|brevipennis|Acrocephalus brevipennis (Keulemans, 1866)	4
Phyllanthus niruri var. scabrellus (Webb) Müll.Arg.	Plantae|Tracheophyta|Magnoliopsida|Malpighiales|Phyllanthaceae|Phyllanthus|niruri|Phyllanthus niruri var. scabrellus (Webb) Müll.Arg.	4
Mugil cephalus Linnaeus, 1758	Animalia|Chordata|Actinopterygii|Mugiliformes|Mugilidae|Mugil|cephalus|Mugil cephalus Linnaeus, 1758	4
Hypodematium crenatum (Forsk.) Kuhn, 1879	Plantae|Pteridophyta|Polypodiopsida|Polypodiales|Dryopteridaceae|Hypodematium|crenatum|Hypodematium crenatum (Forsk.) Kuhn, 1879	4
Ardea purpurea subsp. purpurea	Animalia|Chordata|Aves|Pelecaniformes|Ardeidae|Ardea|purpurea|Ardea purpurea subsp. purpurea	4
Conus ermineus Born, 1778	Animalia|Mollusca|Gastropoda|Neogastropoda|Conidae||ermineus|Conus ermineus Born, 1778	4
Asparagus squarrosus J.A.Schmidt	Plantae|Tracheophyta|Liliopsida|Asparagales|Asparagaceae|Asparagus|squarrosus|Asparagus squarrosus J.A.Schmidt	4
Jania J.V.Lamouroux, 1812	Plantae|Rhodophyta|Florideophyceae|Corallinales|Corallinaceae|Jania||Jania J.V.Lamouroux, 1812	4
Heterodermia obscurata (Nyl.) Trevis.	Fungi|Ascomycota|Lecanoromycetes|Teloschistales|Physciaceae|Heterodermia|obscurata|Heterodermia obscurata (Nyl.) Trevis.	4
Stichopathes Brook, 1889	Animalia|Cnidaria|Anthozoa|Antipatharia|Antipathidae|Stichopathes||Stichopathes Brook, 1889	4
Euphorbia chamaesyce L.	Plantae|Magnoliophyta|Magnoliopsida|Malpighiales|Euphorbiaceae|Euphorbia|chamaesyce|Euphorbia chamaesyce L.	4
Platysiphonia delicata (Clemente) Cremades, 1990	Plantae|Rhodophyta|Florideophyceae|Ceramiales|Sarcomeniaceae|Platysiphonia|delicata|Platysiphonia delicata (Clemente) Cremades, 1990	4
Conus delanoyae Trovão, 1979	Animalia|Mollusca|Gastropoda|Neogastropoda|Conidae|Conus|delanoyae|Conus delanoyae Trovão, 1979	4
Calidris minuta (Leisler, 1812)	Animalia|Chordata|Aves|Charadriiformes|Scolopacidae|Calidris|minuta|Calidris minuta (Leisler, 1812)	4
Conus roeckeli Rolán, 1980	Animalia|Mollusca|Gastropoda|Neogastropoda|Conidae||roeckeli|Conus roeckeli Rolán, 1980	4
Euphorbia chamaesyce L.	Plantae|Tracheophyta|Magnoliopsida|Malpighiales|Euphorbiaceae|Euphorbia|chamaesyce|Euphorbia chamaesyce L.	4
Prosopis juliflora	Plantae|Magnoliophyta|Magnoliopsida|Fabales|Fabaceae|Prosopis|Prosopis juliflora	4
Ramalina bourgeana Mont. ex Nyl.	Fungi|Ascomycota|Lecanoromycetes|Lecanorales|Ramalinaceae|Ramalina|bourgeana|Ramalina bourgeana Mont. ex Nyl.	4
Clausinella punctigera (Dautzenberg & H. Fischer, 1906)	Animalia|Mollusca|Bivalvia|Veneroida|Veneridae|Clausinella|punctigera|Clausinella punctigera (Dautzenberg & H. Fischer, 1906)	4
Thalassodes quadraria Guenée, 1857	Animalia|Arthropoda|Insecta|Lepidoptera|Geometridae|Thalassodes|quadraria|Thalassodes quadraria Guenée, 1857	4
Scopula paneliusi subirrorata Herbulot, 1957	Animalia|Arthropoda|Insecta|Lepidoptera|Geometridae|Scopula|paneliusi|Scopula paneliusi subirrorata Herbulot, 1957	4
Scopula paneliusi Herbulot, 1957	Animalia|Arthropoda|Insecta|Lepidoptera|Geometridae|Scopula|paneliusi|Scopula paneliusi Herbulot, 1957	4
Ficus carica	Plantae|Magnoliophyta|Magnoliopsida|Rosales|Moraceae|Ficus|Ficus carica	4
Lotus purpureus Webb	Plantae|Tracheophyta|Magnoliopsida|Fabales|Fabaceae|Lotus|purpureus|Lotus purpureus Webb	4
Calonectris edwardsii (Oustalet, 1883)	Animalia|Chordata|Aves|Procellariiformes|Procellariidae|Calonectris|edwardsii|Calonectris edwardsii (Oustalet, 1883)	4
Desmapsamma anchorata (Carter, 1882)	Animalia|Porifera|Demospongiae|Poecilosclerida|Desmacididae|Desmapsamma|anchorata|Desmapsamma anchorata (Carter, 1882)	4
Dracaena draco (L.) L.	Plantae|Magnoliophyta|Liliopsida|Asparagales|Asparagaceae|Dracaena|draco|Dracaena draco (L.) L.	4
Sylvia conspicillata orbitalis	Animalia|Chordata|Aves|Passeriformes|Sylviidae|Sylvia|conspicillata|Sylvia conspicillata orbitalis	4
Caloplaca carphinea (Fr.) Jatta	Fungi|Ascomycota|Lecanoromycetes|Teloschistales|Teloschistaceae|Caloplaca|carphinea|Caloplaca carphinea (Fr.) Jatta	4
Ulva Linnaeus, 1753	Plantae|Chlorophyta|Ulvophyceae|Ulvales|Ulvaceae|Ulva||Ulva Linnaeus, 1753	4
Gelochelidon nilotica (Gmelin, 1789)	Animalia|Chordata|Aves|Charadriiformes|Laridae|Gelochelidon|nilotica|Gelochelidon nilotica (Gmelin, 1789)	4
Calotropis procera	Plantae|Magnoliophyta|Magnoliopsida|Gentianales|Apocynaceae|Calotropis|Calotropis procera	4
Amaranthus lividus L.	Plantae|Magnoliophyta|Magnoliopsida|Caryophyllales|Amaranthaceae|Amaranthus|lividus|Amaranthus lividus L.	4
Streptopelia decaocto (Frivaldszky, 1838)	Animalia|Chordata|Aves|Columbiformes|Columbidae|Streptopelia|decaocto|Streptopelia decaocto (Frivaldszky, 1838)	4
Hypnea spinella (C.Agardh) Kützing, 1847	Plantae|Rhodophyta|Florideophyceae|Gigartinales|Cystocloniaceae|Hypnea|spinella|Hypnea spinella (C.Agardh) Kützing, 1847	4
Phaethon aethereus Linnaeus, 1758	Animalia|Chordata|Aves|Phaethontiformes|Phaethontidae|Phaëthon|aethereus|Phaethon aethereus Linnaeus, 1758	4
Volvarina taeniata (G.B. Sowerby II, 1846)	Animalia|Mollusca|Gastropoda|Neogastropoda|Marginellidae|Volvarina|taeniata|Volvarina taeniata (G.B. Sowerby II, 1846)	4
Delichon urbicum (Linnaeus, 1758)	Animalia|Chordata|Aves|Passeriformes|Hirundinidae|Delichon|urbicum|Delichon urbicum (Linnaeus, 1758)	4
Hemidactylus bouvieri (Bocourt, 1870)	Animalia|Chordata|Reptilia|Squamata|Gekkonidae|Hemidactylus|bouvieri|Hemidactylus bouvieri (Bocourt, 1870)	4
Asparagus squarrosus J.A.Schmidt	Plantae|Magnoliophyta|Liliopsida|Asparagales|Asparagaceae|Asparagus|squarrosus|Asparagus squarrosus J.A.Schmidt	4
Hypodematium crenatum (Forssk.) Kuhn	Plantae|Tracheophyta|Polypodiopsida|Polypodiales|Hypodematiaceae|Hypodematium|crenatum|Hypodematium crenatum (Forssk.) Kuhn	4
Isturgia Hübner, 1823	Animalia|Arthropoda|Insecta|Lepidoptera|Geometridae|Isturgia||Isturgia Hübner, 1823	4
Mesophoyx intermedia (Wagler, 1829)	Animalia|Chordata|Aves|Pelecaniformes|Ardeidae|Egretta|intermedia|Mesophoyx intermedia (Wagler, 1829)	4
Alvania multinodula Hoenselaar & Goud, 1998	Animalia|Mollusca|Gastropoda|Neotaenioglossa|Rissoidae|Alvania|multinodula|Alvania multinodula Hoenselaar & Goud, 1998	4
Crotalaria retusa L.	Plantae|Tracheophyta|Magnoliopsida|Fabales|Fabaceae|Crotalaria|retusa|Crotalaria retusa L.	3
Passer domesticus (Linnaeus, 1758)	Animalia|Chordata|Aves|Passeriformes|Passeridae|Passer|domesticus|Passer domesticus (Linnaeus, 1758)	3
Conus damottai Trovão, 1979	Animalia|Mollusca|Gastropoda|Neogastropoda|Conidae|Conus|damottai|Conus damottai Trovão, 1979	3
Exocoetus volitans Linnaeus, 1758	Animalia|Chordata|Actinopterygii|Beloniformes|Exocoetidae|Exocoetus|volitans|Exocoetus volitans Linnaeus, 1758	3
Eucinostomus melanopterus (Bleeker, 1863)	Animalia|Chordata|Actinopterygii|Perciformes|Gerreidae|Eucinostomus|melanopterus|Eucinostomus melanopterus (Bleeker, 1863)	3
Laurencia microcladia Kützing, 1865	Plantae|Rhodophyta|Florideophyceae|Ceramiales|Rhodomelaceae|Laurencia|microcladia|Laurencia microcladia Kützing, 1865	3
Conus salreiensis Rolán, 1980	Animalia|Mollusca|Gastropoda|Neogastropoda|Conidae|Conus|salreiensis|Conus salreiensis Rolán, 1980	3
Makaira nigricans Lacepède, 1802	Animalia|Chordata|Actinopterygii|Perciformes|Istiophoridae|Makaira|nigricans|Makaira nigricans Lacepède, 1802	3
Roccella africana Vainio	Fungi|Ascomycota|Arthoniomycetes|Arthoniales|Roccellaceae|Rocella|africana|Roccella africana Vainio	3
Pluvialis dominica (Statius Muller, 1776)	Animalia|Chordata|Aves|Charadriiformes|Charadriidae|Pluvialis|dominica|Pluvialis dominica (Statius Muller, 1776)	3
Thalasseus sandvicensis (Latham, 1787)	Animalia|Chordata|Aves|Charadriiformes|Laridae|Thalaseus|sandvicensis|Thalasseus sandvicensis (Latham, 1787)	3
Conus evorai Monteiro, Fernandes & Rolán, 1995	Animalia|Mollusca|Gastropoda|Neogastropoda|Conidae||evorai|Conus evorai Monteiro, Fernandes & Rolán, 1995	3
Andropogon gayanus Kunth	Plantae|Magnoliophyta|Liliopsida|Poales|Poaceae|Andropogon|gayanus|Andropogon gayanus Kunth	3
Conus fuscoflavus Röckel, Rolán & Monteiro, 1980	Animalia|Mollusca|Gastropoda|Neogastropoda|Conidae|Conus|fuscoflavus|Conus fuscoflavus Röckel, Rolán & Monteiro, 1980	3
Galeoides decadactylus (Bloch, 1795)	Animalia|Chordata|Actinopterygii|Perciformes|Polynemidae|Galeoides|decadactylus|Galeoides decadactylus (Bloch, 1795)	3
Gelidium J.V. Lamouroux, 1813	Plantae|Rhodophyta|Florideophyceae|Gelidiales|Gelidiaceae|Gelidium||Gelidium J.V. Lamouroux, 1813	3
Zootecus Westerlund, 1887	Animalia|Mollusca|Gastropoda|Stylommatophora|Subulinidae|Zootecus||Zootecus Westerlund, 1887	3
Hypnea flagelliformis Greville ex J.Agardh, 1851	Plantae|Rhodophyta|Florideophyceae|Gigartinales|Cystocloniaceae|Hypnea|flagelliformis|Hypnea flagelliformis Greville ex J.Agardh, 1851	3
Diplodus prayensis Cadenat, 1964	Animalia|Chordata|Actinopterygii|Perciformes|Sparidae|Diplodus|prayensis|Diplodus prayensis Cadenat, 1964	3
Hexaplex bifasciatus (A. Adams, 1853)	Animalia|Mollusca|Gastropoda|Neogastropoda|Muricidae|Hexaplex|bifasciatus|Hexaplex bifasciatus (A. Adams, 1853)	3
Spermothamnion Areschoug, 1847	Plantae|Rhodophyta|Florideophyceae|Ceramiales|Ceramiaceae|Spermothamnion||Spermothamnion Areschoug, 1847	3
Tarentola rudis Boulenger, 1906	Animalia|Chordata|Reptilia|Squamata|Phyllodactylidae|Tarentola|rudis|Tarentola rudis Boulenger, 1906	3
Laurencia obtusa (Hudson) J.V. Lamouroux	Plantae|Rhodophyta|Florideophyceae|Ceramiales|Rhodomelaceae|Laurencia|obtusa|Laurencia obtusa (Hudson) J.V. Lamouroux	3
Cardiospermum halicacabum var. microcarpum (Kunth) Bl.	Plantae|Tracheophyta|Magnoliopsida|Sapindales|Sapindaceae|Cardiospermum|halicacabum|Cardiospermum halicacabum var. microcarpum (Kunth) Bl.	3
Cardiospermum halicacabum var. microcarpum (Kunth) Blume	Plantae|Magnoliophyta|Magnoliopsida|Sapindales|Sapindaceae|Cardiospermum|halicacabum|Cardiospermum halicacabum var. microcarpum (Kunth) Blume	3
Egretta gularis (Bosc, 1792)	Animalia|Chordata|Aves|Pelecaniformes|Ardeidae|Egretta|gularis|Egretta gularis (Bosc, 1792)	3
Laurencia microcladia Kützing	Plantae|Rhodophyta|Florideophyceae|Ceramiales|Rhodomelaceae|Laurencia|microcladia|Laurencia microcladia Kützing	3
Solanum fuscatum L.	Plantae|Tracheophyta|Magnoliopsida|Solanales|Solanaceae|Solanum|fuscatum|Solanum fuscatum L.	3
Gymnothorax funebris Ranzani, 1839	Animalia|Chordata|Actinopterygii|Anguilliformes|Muraenidae|Gymnothorax|funebris|Gymnothorax funebris Ranzani, 1839	3
Myripristis jacobus Cuvier, 1829	Animalia|Chordata|Actinopterygii|Beryciformes|Holocentridae|Myripristis|jacobus|Myripristis jacobus Cuvier, 1829	3
Strumigenys emmae (Emery, 1890)	Animalia|Arthropoda|Insecta|Hymenoptera|Formicidae|Pyramica|emmae|Strumigenys emmae (Emery, 1890)	3
Laurencia obtusa (Hudson) J.V.Lamouroux, 1813	Plantae|Rhodophyta|Florideophyceae|Ceramiales|Rhodomelaceae|Laurencia|obtusa|Laurencia obtusa (Hudson) J.V.Lamouroux, 1813	3
Lethrinus atlanticus Valenciennes, 1830	Animalia|Chordata|Actinopterygii|Perciformes|Lethrinidae|Lethrinus|atlanticus|Lethrinus atlanticus Valenciennes, 1830	3
Valonia C.Agardh, 1823	Plantae|Chlorophyta|Ulvophyceae|Siphonocladales|Valoniaceae|Valonia||Valonia C.Agardh, 1823	3
Aristida adscensionis L.	Plantae|Magnoliophyta|Liliopsida|Poales|Poaceae|Aristida|adscensionis|Aristida adscensionis L.	3
Conus salreiensis Rolán, 1980	Animalia|Mollusca|Gastropoda|Neogastropoda|Conidae||salreiensis|Conus salreiensis Rolán, 1980	3
Luria lurida (Linnaeus, 1758)	Animalia|Mollusca|Gastropoda|Littorinimorpha|Cypraeidae|Luria|lurida|Luria lurida (Linnaeus, 1758)	3
Spiraserpula ypsilon Pillai & Ten Hove, 1994	Animalia|Annelida|Polychaeta|Sabellida|Serpulidae|Spiraserpula|ypsilon|Spiraserpula ypsilon Pillai & Ten Hove, 1994	3
Phorcus mariae Templado & Rolán, 2012	Animalia|Mollusca|Gastropoda||Trochidae|Phorcus|mariae|Phorcus mariae Templado & Rolán, 2012	3
Lavandula apiifolia C.Sm.	Plantae|Tracheophyta|Magnoliopsida|Lamiales|Lamiaceae|Lavandula|apiifolia|Lavandula apiifolia C.Sm.	3
Oxalis corniculata L.	Plantae|Tracheophyta|Magnoliopsida|Oxalidales|Oxalidaceae|Oxalis|corniculata|Oxalis corniculata L.	3
Trachinotus goreensis Cuvier, 1832	Animalia|Chordata|Actinopterygii|Perciformes|Carangidae|Trachinotus|goreensis|Trachinotus goreensis Cuvier, 1832	3
Pegusa lascaris (Risso, 1810)	Animalia|Chordata|Actinopterygii|Pleuronectiformes|Soleidae|Pegusa|lascaris|Pegusa lascaris (Risso, 1810)	3
Spermothamnion Areschoug, 1847	Plantae|Rhodophyta|Florideophyceae|Ceramiales|Wrangeliaceae|Spermothamnion||Spermothamnion Areschoug, 1847	3
Anas discors Linnaeus, 1766	Animalia|Chordata|Aves|Anseriformes|Anatidae|Anas|discors|Anas discors Linnaeus, 1766	3
Nephila senegalensis	Animalia|Arthropoda|Arachnida|Araneae|Araneidae|Nephila|Nephila senegalensis	3
Solanum fuscatum Willd. ex Roem. & Schult.	Plantae|Magnoliophyta|Magnoliopsida|Solanales|Solanaceae|Solanum|fuscatum|Solanum fuscatum Willd. ex Roem. & Schult.	3
Selene dorsalis (Gill, 1863)	Animalia|Chordata|Actinopterygii|Perciformes|Carangidae|Selene|dorsalis|Selene dorsalis (Gill, 1863)	3
Patella lugubris Gmelin, 1791	Animalia|Mollusca|Gastropoda|Archaeogastropoda|Patellidae|Patella|lugubris|Patella lugubris Gmelin, 1791	3
Hyparrhenia hirta (L.) Stapf	Plantae|Tracheophyta|Liliopsida|Poales|Poaceae|Hyparrhenia|hirta|Hyparrhenia hirta (L.) Stapf	3
Apsilus fuscus Valenciennes, 1830	Animalia|Chordata|Actinopterygii|Perciformes|Lutjanidae|Apsilus|fuscus|Apsilus fuscus Valenciennes, 1830	3
Roccella africana Vain.	Fungi|Ascomycota|Arthoniomycetes|Arthoniales|Roccellaceae|Roccella|africana|Roccella africana Vain.	3
Strumigenys emmae (Emery, 1890)	Animalia|Arthropoda|Insecta|Hymenoptera|Formicidae|Strumigenys|emmae|Strumigenys emmae (Emery, 1890)	3
Isturgia pulinda deerraria (Walker, 1861)	Animalia|Arthropoda|Insecta|Lepidoptera|Geometridae|Isturgia|pulinda|Isturgia pulinda deerraria (Walker, 1861)	3
Aluterus scriptus (Osbeck, 1765)	Animalia|Chordata|Actinopterygii|Tetraodontiformes|Monacanthidae|Aluterus|scriptus|Aluterus scriptus (Osbeck, 1765)	3
Oxalis corniculata L.	Plantae|Magnoliophyta|Magnoliopsida|Oxalidales|Oxalidaceae|Oxalis|corniculata|Oxalis corniculata L.	3
Rhynchelytrum villosum (Parl.) Chiov.	Plantae|Magnoliophyta|Liliopsida|Poales|Poaceae|Melinis|villosum|Rhynchelytrum villosum (Parl.) Chiov.	3
Crotalaria retusa L.	Plantae|Magnoliophyta|Magnoliopsida|Fabales|Fabaceae|Crotalaria|retusa|Crotalaria retusa L.	3
Pluvialis squatarola (Linnaeus, 1758)	Animalia|Chordata|Aves|Charadriiformes|Charadriidae|Pluvialis|squatarola|Pluvialis squatarola (Linnaeus, 1758)	3
Bractechlamys corallinoides (Orbigny in Webb & Berthelot, 1839)	Animalia|Mollusca|Bivalvia|Ostreoida|Pectinidae|Bractechlamys|corallinoides|Bractechlamys corallinoides (Orbigny in Webb & Berthelot, 1839)	3
Conus trochulus Reeve, 1844	Animalia|Mollusca|Gastropoda|Neogastropoda|Conidae|Conus|trochulus|Conus trochulus Reeve, 1844	3
Chnoospora minima (Hering) Papenfuss, 1956	Chromista|Ochrophyta|Phaeophyceae|Scytosiphonales|Scytosiphonaceae|Chnoospora|minima|Chnoospora minima (Hering) Papenfuss, 1956	3
Hyparrhenia hirta (L.) Stapf	Plantae|Magnoliophyta|Liliopsida|Poales|Poaceae|Hyparrhenia|hirta|Hyparrhenia hirta (L.) Stapf	3
Diplodus fasciatus (Valenciennes, 1830)	Animalia|Chordata|Actinopterygii|Perciformes|Sparidae|Diplodus|fasciatus|Diplodus fasciatus (Valenciennes, 1830)	3
Pagellus acarne (Risso, 1827)	Animalia|Chordata|Actinopterygii|Perciformes|Sparidae|Pagellus|acarne|Pagellus acarne (Risso, 1827)	3
Patella lugubris Gmelin, 1791	Animalia|Mollusca|Gastropoda||Patellidae|Patella|lugubris|Patella lugubris Gmelin, 1791	3
Tyto alba (Scopoli, 1769)	Animalia|Chordata|Aves|Strigiformes|Tytonidae|Tyto|alba|Tyto alba (Scopoli, 1769)	3
Conus borgesi Trovão, 1979	Animalia|Mollusca|Gastropoda|Neogastropoda|Conidae|Conus|borgesi|Conus borgesi Trovão, 1979	2
Ophiostigma abnorme (Lyman, 1878)	Animalia|Echinodermata|Ophiuroidea|Ophiurida|Amphiuridae|Ophiostigma|abnorme|Ophiostigma abnorme (Lyman, 1878)	2
Musculus subpictus (Cantraine, 1835)	Animalia|Mollusca|Bivalvia|Mytiloida|Mytilidae|Musculus|subpictus|Musculus subpictus (Cantraine, 1835)	2
Chaetodon robustus Günther, 1860	Animalia|Chordata|Actinopterygii|Perciformes|Chaetodontidae|Chaetodon|robustus|Chaetodon robustus Günther, 1860	2
Zea mays	Plantae|Magnoliophyta|Liliopsida|Poales|Poaceae|Zea|Zea mays	2
Lasaea adansoni (Gmelin, 1791)	Animalia|Mollusca|Bivalvia|Veneroida|Lasaeidae|Lasaea|adansoni|Lasaea adansoni (Gmelin, 1791)	2
Rinodina polymorphospora Giralt & van den Boom	Fungi|Ascomycota|Lecanoromycetes|Teloschistales|Physciaceae|Rinodina|polymorphospora|Rinodina polymorphospora Giralt & van den Boom	2
Punctelia subpraesignis (Nyl.) Krog	Fungi|Ascomycota|Lecanoromycetes|Lecanorales|Parmeliaceae|Punctelia|subpraesignis|Punctelia subpraesignis (Nyl.) Krog	2
Peltigera canina (L.) Willd.	Fungi|Ascomycota|Lecanoromycetes|Peltigerales|Peltigeraceae|Peltigera|canina|Peltigera canina (L.) Willd.	2
Passer hispaniolensis	Animalia|Chordata|Aves|Passeriformes|Passeridae|Passer|Passer hispaniolensis	2
Bryopsis J.V.Lamouroux, 1809	Plantae|Chlorophyta|Ulvophyceae|Bryopsidales|Bryopsidaceae|Bryopsis||Bryopsis J.V.Lamouroux, 1809	2
Orthetrum trinacria Selys, 1841	Animalia|Arthropoda|Insecta|Odonata|Libellulidae|Orthetrum|trinacria|Orthetrum trinacria Selys, 1841	2
Spyridia hypnoides (Bory de Saint-Vincent) Papenfuss, 1968	Plantae|Rhodophyta|Florideophyceae|Ceramiales|Spyridiaceae|Spyridia|hypnoides|Spyridia hypnoides (Bory de Saint-Vincent) Papenfuss, 1968	2
Laurencia J.V.Lamouroux, 1813	Plantae|Rhodophyta|Florideophyceae|Ceramiales|Rhodomelaceae|Laurencia||Laurencia J.V.Lamouroux, 1813	2
Diplodonta Bronn, 1831	Animalia|Mollusca|Bivalvia|Veneroida|Ungulinidae|Diplodonta||Diplodonta Bronn, 1831	2
Rypticus saponaceus (Bloch & Schneider, 1801)	Animalia|Chordata|Actinopterygii|Perciformes|Serranidae|Rypticus|saponaceus|Rypticus saponaceus (Bloch & Schneider, 1801)	2
Lobophora variegata (Lamouroux) Womersley ex Oliveira	Chromista|Ochrophyta|Phaeophyceae|Dictyotales|Dictyotaceae|Lobophora|variegata|Lobophora variegata (Lamouroux) Womersley ex Oliveira	2
Conus pseudonivifer Monteiro, Tenorio & Poppe, 2004	Animalia|Mollusca|Gastropoda|Neogastropoda|Conidae||pseudonivifer|Conus pseudonivifer Monteiro, Tenorio & Poppe, 2004	2
Telmatactis cricoides (Duchassaing, 1850)	Animalia|Cnidaria|Anthozoa|Actiniaria|Isophelliidae|Telmatactis|cricoides|Telmatactis cricoides (Duchassaing, 1850)	2
Lavandula rotundifolia	Plantae|Magnoliophyta|Magnoliopsida|Lamiales|Lamiaceae|Lavandula|Lavandula rotundifolia	2
Orbiculina Lamarck, 1816	Protozoa||Granuloreticulosea|Foraminiferida||Orbiculina||Orbiculina Lamarck, 1816	2
Euphorbia heterophylla L.	Plantae|Magnoliophyta|Magnoliopsida|Malpighiales|Euphorbiaceae|Euphorbia|heterophylla|Euphorbia heterophylla L.	2
Pennisetum pedicellatum Trin.	Plantae|Magnoliophyta|Liliopsida|Poales|Poaceae|Pennisetum|pedicellatum|Pennisetum pedicellatum Trin.	2
Corvus ruficollis	Animalia|Chordata|Aves|Passeriformes|Corvidae|Corvus|Corvus ruficollis	2
Ceratitis capitata (Wiedemann, 1824)	Animalia|Arthropoda|Insecta|Diptera|Tephritidae|Ceratitis|capitata|Ceratitis capitata (Wiedemann, 1824)	2
Harpa Röding, 1798	Animalia|Mollusca|Gastropoda|Neogastropoda|Harpidae|Harpa||Harpa Röding, 1798	2
Conus luquei Rolán & Trovão, 1990	Animalia|Mollusca|Gastropoda|Neogastropoda|Conidae|Conus|luquei|Conus luquei Rolán & Trovão, 1990	2
Grateloupia scutellata Kützing	Plantae|Rhodophyta|Florideophyceae|Halymeniales|Halymeniaceae|Grateloupia|scutellata|Grateloupia scutellata Kützing	2
Adansonia digitata	Plantae|Magnoliophyta|Magnoliopsida|Malvales|Malvaceae|Adansonia|Adansonia digitata	2
Sargassum C. Agardh	Chromista|Ochrophyta|Phaeophyceae|Fucales|Sargassaceae|Sargassum||Sargassum C. Agardh	2
Conus pseudonivifer Monteiro, Tenorio & Poppe, 2004	Animalia|Mollusca|Gastropoda|Neogastropoda|Conidae|Conus|pseudonivifer|Conus pseudonivifer Monteiro, Tenorio & Poppe, 2004	2
Eragrostis barrelieri Daveau	Plantae|Magnoliophyta|Liliopsida|Poales|Poaceae|Eragrostis|barrelieri|Eragrostis barrelieri Daveau	2
Dactyloctenium aegyptium (L.) Willd.	Plantae|Magnoliophyta|Liliopsida|Poales|Poaceae|Dactyloctenium|aegyptium|Dactyloctenium aegyptium (L.) Willd.	2
Tornabea scutellifera (With.) J. R. Laundon	Fungi|Ascomycota|Lecanoromycetes|Teloschistales|Physciaceae|Tornabea|scutellifera|Tornabea scutellifera (With.) J. R. Laundon	2
Chlorophyceae Wille, 1884	Plantae|Chlorophyta|Chlorophyceae|||||Chlorophyceae Wille, 1884	2
Cheiracanthium verdense Lotz, 2011	Animalia|Arthropoda|Arachnida|Araneae|Eutichuridae|Cheiracanthium|verdense|Cheiracanthium verdense Lotz, 2011	2
Limosa lapponica (Linnaeus, 1758)	Animalia|Chordata|Aves|Charadriiformes|Scolopacidae|Limosa|lapponica|Limosa lapponica (Linnaeus, 1758)	2
Ectocarpus Lyngbye, 1819	Chromista|Ochrophyta|Phaeophyceae|Ectocarpales|Ectocarpaceae|Ectocarpus||Ectocarpus Lyngbye, 1819	2
Conus josephinae Rolán, 1980	Animalia|Mollusca|Gastropoda|Neogastropoda|Conidae|Conus|josephinae|Conus josephinae Rolán, 1980	2
Conus ermineus Born, 1778	Animalia|Mollusca|Gastropoda|Neogastropoda|Conidae|Conus|ermineus|Conus ermineus Born, 1778	2
Pasiphila Warren, 1895	Animalia|Arthropoda|Insecta|Lepidoptera|Geometridae|Pasiphila||Pasiphila Warren, 1895	2
Setaria pumila	Plantae|Magnoliophyta|Liliopsida|Poales|Poaceae|Setaria|Setaria pumila	2
Carbonea (Hertel) Hertel	Fungi|Ascomycota|Lecanoromycetes|Lecanorales|Lecanoraceae|Carbonea||Carbonea (Hertel) Hertel	2
Tringa flavipes (Gmelin, 1789)	Animalia|Chordata|Aves|Charadriiformes|Scolopacidae|Tringa|flavipes|Tringa flavipes (Gmelin, 1789)	2
Chama crenulata Lamarck, 1819	Animalia|Mollusca|Bivalvia|Veneroida|Chamidae|Chama|crenulata|Chama crenulata Lamarck, 1819	2
Caretta caretta	Animalia|Chordata|Reptilia|Testudines|Cheloniidae|Caretta|Caretta caretta	2
Opeas Albers, 1850	Animalia|Mollusca|Gastropoda|Stylommatophora|Subulinidae|Opeas||Opeas Albers, 1850	2
Amaranthus lividus L.	Plantae|Tracheophyta|Magnoliopsida|Caryophyllales|Amaranthaceae|Amaranthus|lividus|Amaranthus lividus L.	2
Harpa doris Röding, 1798	Animalia|Mollusca|Gastropoda|Neogastropoda|Harpidae|Harpa|doris|Harpa doris Röding, 1798	2
Nerita senegalensis Gmelin, 1791	Animalia|Mollusca|Gastropoda|Neritopsina|Neritidae|Nerita|senegalensis|Nerita senegalensis Gmelin, 1791	2
Ulva lactuca Linnaeus	Plantae|Chlorophyta|Ulvophyceae|Ulvales|Ulvaceae|Ulva|lactuca|Ulva lactuca Linnaeus	2
Zygophyllum L.	Plantae|Magnoliophyta|Magnoliopsida|Zygophyllales|Zygophyllaceae|Zygophyllum||Zygophyllum L.	2
Passer hispaniolensis hispaniolensis	Animalia|Chordata|Aves|Passeriformes|Passeridae|Passer|hispaniolensis|Passer hispaniolensis hispaniolensis	2
Danaus chrysippus Linnaeus, 1758	Animalia|Arthropoda|Insecta|Lepidoptera|Nymphalidae|Danaus|chrysippus|Danaus chrysippus Linnaeus, 1758	2
Jatropha curcas	Plantae|Magnoliophyta|Magnoliopsida|Malpighiales|Euphorbiaceae|Jatropha|Jatropha curcas	2
Thyreus Panzer, 1806	Animalia|Arthropoda|Insecta|Hymenoptera|Apidae|Thyreus||Thyreus Panzer, 1806	2
Bulla striata Bruguière, 1792	Animalia|Mollusca|Gastropoda|Cephalaspidea|Bullidae|Bulla|striata|Bulla striata Bruguière, 1792	2
Hypnea spinella (C. Agardh) Kützing	Plantae|Rhodophyta|Florideophyceae|Gigartinales|Hypneaceae|Hypnea|spinella|Hypnea spinella (C. Agardh) Kützing	2
Acarnus tortilis Topsent, 1892	Animalia|Porifera|Demospongiae|Poecilosclerida|Acarnidae|Acarnus|tortilis|Acarnus tortilis Topsent, 1892	2
Papilio demodocus Esper, 1798	Animalia|Arthropoda|Insecta|Lepidoptera|Papilionidae|Papilio|demodocus|Papilio demodocus Esper, 1798	2
Lavandula stricta Delile	Plantae|Tracheophyta|Magnoliopsida|Lamiales|Lamiaceae|Lavandula|stricta|Lavandula stricta Delile	2
Sphaerellothecium Zopf	Fungi|Ascomycota|Dothideomycetes|Capnodiales|Mycosphaerellaceae|Sphaerellothecium||Sphaerellothecium Zopf	2
Placogorgia terceira Grasshoff, 1977	Animalia|Cnidaria|Anthozoa|Alcyonacea|Plexauridae|Placogorgia|terceira|Placogorgia terceira Grasshoff, 1977	2
Pseudochama cristella (Lamarck, 1819)	Animalia|Mollusca|Bivalvia|Veneroida|Chamidae|Pseudochama|cristella|Pseudochama cristella (Lamarck, 1819)	2
Gallinago gallinago (Linnaeus, 1758)	Animalia|Chordata|Aves|Charadriiformes|Scolopacidae|Gallinago|gallinago|Gallinago gallinago (Linnaeus, 1758)	2
Dracaena draco (L.) L.	Plantae|Tracheophyta|Liliopsida|Asparagales|Asparagaceae|Dracaena|draco|Dracaena draco (L.) L.	2
Aerva javanica (Burm. f.) Juss. ex Schult.	Plantae|Magnoliophyta|Magnoliopsida|Caryophyllales|Amaranthaceae|Aerva|javanica|Aerva javanica (Burm. f.) Juss. ex Schult.	2
Valonia C.A. Agardh, 1823	Plantae|Chlorophyta|Ulvophyceae|Siphonocladales|Valoniaceae|Valonia||Valonia C.A. Agardh, 1823	2
Cerithium atratum (Born, 1778)	Animalia|Mollusca|Gastropoda||Cerithiidae|Cerithium|atratum|Cerithium atratum (Born, 1778)	2
Acar olivercoseli Huber, 2010	Animalia|Mollusca|Bivalvia|Arcoida|Arcidae|Acar|olivercoseli|Acar olivercoseli Huber, 2010	2
Pterocladiella capillacea (S.G.Gmelin) Santelices & Hommersand, 1997	Plantae|Rhodophyta|Florideophyceae|Gelidiales|Pterocladiaceae|Pterocladiella|capillacea|Pterocladiella capillacea (S.G.Gmelin) Santelices & Hommersand, 1997	2
Merremia aegyptia	Plantae|Magnoliophyta|Magnoliopsida|Solanales|Convolvulaceae|Merremia|Merremia aegyptia	2
Buteo bannermani	Animalia|Chordata|Aves|Accipitriformes|Accipitridae|Buteo|bannermani|Buteo bannermani	2
Coccinella algerica	Animalia|Arthropoda|Insecta|Coleoptera|Coccinellidae|Coccinella|Coccinella algerica	2
Prosopis juliflora (Sw.) DC.	Plantae|Tracheophyta|Magnoliopsida|Fabales|Fabaceae|Prosopis|juliflora|Prosopis juliflora (Sw.) DC.	2
Ramalina huei Harm.	Fungi|Ascomycota|Lecanoromycetes|Lecanorales|Ramalinaceae|Ramalina|huei|Ramalina huei Harm.	2
Oxymeris fatua (Hinds, 1844)	Animalia|Mollusca|Gastropoda|Neogastropoda|Terebridae|Oxymeris|fatua|Oxymeris fatua (Hinds, 1844)	2
Diplodonta rotundata (Montagu, 1803)	Animalia|Mollusca|Bivalvia|Veneroida|Ungulinidae|Diplodonta|rotundata|Diplodonta rotundata (Montagu, 1803)	2
Conus ambiguus Reeve, 1844	Animalia|Mollusca|Gastropoda|Neogastropoda|Conidae||ambiguus|Conus ambiguus Reeve, 1844	2
Hastula lepida (Hinds, 1844)	Animalia|Mollusca|Gastropoda|Neogastropoda|Terebridae|Hastula|lepida|Hastula lepida (Hinds, 1844)	2
Crocothemis erythraea	Animalia|Arthropoda|Insecta|Odonata|Libellulidae|Crocothemis|Crocothemis erythraea	2
Euphorbia granulata Forssk.	Plantae|Magnoliophyta|Magnoliopsida|Malpighiales|Euphorbiaceae|Euphorbia|granulata|Euphorbia granulata Forssk.	2
Dasya C.A. Agardh, 1824	Plantae|Rhodophyta|Florideophyceae|Ceramiales|Dasyaceae|Dasya||Dasya C.A. Agardh, 1824	2
Cassia occidentalis L.	Plantae|Tracheophyta|Magnoliopsida|Fabales|Fabaceae|Senna|occidentalis|Cassia occidentalis L.	2
Sphyraena viridensis Cuvier, 1829	Animalia|Chordata|Actinopterygii|Perciformes|Sphyraenidae|Sphyraena|viridensis|Sphyraena viridensis Cuvier, 1829	2
Sylvia conspicillata	Animalia|Chordata|Aves|Passeriformes|Sylviidae|Sylvia|Sylvia conspicillata	2
Conus luquei Rolán & Trovão, 1990	Animalia|Mollusca|Gastropoda|Neogastropoda|Conidae||luquei|Conus luquei Rolán & Trovão, 1990	2
Actinia equina (Linnaeus, 1758)	Animalia|Cnidaria|Anthozoa|Actiniaria|Actiniidae|Actinia|equina|Actinia equina (Linnaeus, 1758)	2
Andropogon gayanus Kunth	Plantae|Tracheophyta|Liliopsida|Poales|Poaceae|Andropogon|gayanus|Andropogon gayanus Kunth	2
Charadrius alexandrinus	Animalia|Chordata|Aves|Charadriiformes|Charadriidae|Charadrius|Charadrius alexandrinus	2
Cotesia danaisae (Hedqvist, 1965)	Animalia|Arthropoda|Insecta|Hymenoptera|Braconidae|Cotesia|danaisae|Cotesia danaisae (Hedqvist, 1965)	2
Elionurus royleanus Nees ex A.Rich.	Plantae|Tracheophyta|Liliopsida|Poales|Poaceae|Elionurus|royleanus|Elionurus royleanus Nees ex A.Rich.	2
Siderastrea radians	Animalia|Cnidaria|Anthozoa|Scleractinia|Siderastreidae|Siderastrea|Siderastrea radians	2
Oxymeris dillwynii (Deshayes, 1859)	Animalia|Mollusca|Gastropoda|Neogastropoda|Terebridae|Oxymeris|dillwynii|Oxymeris dillwynii (Deshayes, 1859)	2
Diplodus sargus	Animalia|Chordata|Actinopterygii|Perciformes|Sparidae|Diplodus|Diplodus sargus	2
Bursa corrugata (Perry, 1811)	Animalia|Mollusca|Gastropoda|Littorinimorpha|Bursidae|Bursa|corrugata|Bursa corrugata (Perry, 1811)	2
Numida meleagris	Animalia|Chordata|Aves|Galliformes|Numididae|Numida|Numida meleagris	2
Nerita senegalensis Gmelin, 1791	Animalia|Mollusca|Gastropoda|Cycloneritimorpha|Neritidae|Nerita|senegalensis|Nerita senegalensis Gmelin, 1791	2
Hypoglossum Kützing, 1843	Plantae|Rhodophyta|Florideophyceae|Ceramiales|Delesseriaceae|Hypoglossum||Hypoglossum Kützing, 1843	2
Conus ateralbus Kiener, 1845	Animalia|Mollusca|Gastropoda|Neogastropoda|Conidae||ateralbus|Conus ateralbus Kiener, 1845	2
Platalea leucorodia	Animalia|Chordata|Aves|Pelecaniformes|Threskiornithidae|Platalea|Platalea leucorodia	2
Cheiracanthium C.L. Koch, 1839	Animalia|Arthropoda|Arachnida|Araneae|Miturgidae|Cheiracanthium||Cheiracanthium C.L. Koch, 1839	2
Rogeria adenophylla	Plantae|Magnoliophyta|Magnoliopsida|Lamiales|Pedaliaceae|Rogeria|Rogeria adenophylla	2
Cistanche phelypaea	Plantae|Magnoliophyta|Magnoliopsida|Lamiales|Orobanchaceae|Cistanche|Cistanche phelypaea	2
Dichanthium foveolatum (Delile) Roberty	Plantae|Magnoliophyta|Liliopsida|Poales|Poaceae|Dichanthium|foveolatum|Dichanthium foveolatum (Delile) Roberty	2
Tricholaena teneriffae (L.f.) Link	Plantae|Magnoliophyta|Liliopsida|Poales|Poaceae|Tricholaena|teneriffae|Tricholaena teneriffae (L.f.) Link	2
Boerhavia diffusa L.	Plantae|Magnoliophyta|Magnoliopsida|Caryophyllales|Nyctaginaceae|Boerhavia|diffusa|Boerhavia diffusa L.	2
Dictyota ciliolata Sonder ex Kützing	Chromista|Ochrophyta|Phaeophyceae|Dictyotales|Dictyotaceae|Dictyota|ciliolata|Dictyota ciliolata Sonder ex Kützing	2
Cynodon dactylon (L.) Pers.	Plantae|Tracheophyta|Liliopsida|Poales|Poaceae|Cynodon|dactylon|Cynodon dactylon (L.) Pers.	2
Argemone mexicana	Plantae|Magnoliophyta|Magnoliopsida|Ranunculales|Papaveraceae|Argemone|Argemone mexicana	2
Eleusine indica (L.) Gaertn.	Plantae|Magnoliophyta|Liliopsida|Poales|Poaceae|Eleusine|indica|Eleusine indica (L.) Gaertn.	2
Aerva javanica (Burm. f.) Juss. ex Schult.	Plantae|Tracheophyta|Magnoliopsida|Caryophyllales|Amaranthaceae|Aerva|javanica|Aerva javanica (Burm. f.) Juss. ex Schult.	2
Dictyota ciliolata Sonder ex Kützing, 1859	Chromista|Ochrophyta|Phaeophyceae|Dictyotales|Dictyotaceae|Dictyota|ciliolata|Dictyota ciliolata Sonder ex Kützing, 1859	2
Pterodroma feae (Salvadori, 1900)	Animalia|Chordata|Aves|Procellariiformes|Procellariidae|Pterodroma|feae|Pterodroma feae (Salvadori, 1900)	2
Ocypode cursor	Animalia|Arthropoda|Malacostraca|Decapoda|Ocypodidae|Ocypode|Ocypode cursor	2
Ardeola ralloides (Scopoli, 1769)	Animalia|Chordata|Aves|Pelecaniformes|Ardeidae|Ardeola|ralloides|Ardeola ralloides (Scopoli, 1769)	2
Andrachne telephioides L.	Plantae|Tracheophyta|Magnoliopsida|Malpighiales|Phyllanthaceae|Andrachne|telephioides|Andrachne telephioides L.	2
Falco tinnunculus alexandri	Animalia|Chordata|Aves|Falconiformes|Falconidae|Falco|Falco tinnunculus alexandri	2
Sternula albifrons (Pallas, 1764)	Animalia|Chordata|Aves|Charadriiformes|Laridae|Sternula|albifrons|Sternula albifrons (Pallas, 1764)	2
Coturnix coturnix (Linnaeus, 1758)	Animalia|Chordata|Aves|Galliformes|Phasianidae|Coturnix|coturnix|Coturnix coturnix (Linnaeus, 1758)	2
Ulva lactuca Linnaeus, 1753	Plantae|Chlorophyta|Ulvophyceae|Ulvales|Ulvaceae|Ulva|lactuca|Ulva lactuca Linnaeus, 1753	2
Ricardia montagnei Derbès & Solier	Plantae|Rhodophyta|Florideophyceae|Ceramiales|Rhodomelaceae|Erythrocystis|montagnei|Ricardia montagnei Derbès & Solier	2
Eragrostis barrelieri Daveau	Plantae|Tracheophyta|Liliopsida|Poales|Poaceae|Eragrostis|barrelieri|Eragrostis barrelieri Daveau	2
Tyto alba subsp. schmitzi (Hartert, 1900)	Animalia|Chordata|Aves|Strigiformes|Tytonidae|Tyto|alba|Tyto alba subsp. schmitzi (Hartert, 1900)	2
Hyles tithymali Boisduval, 1834	Animalia|Arthropoda|Insecta|Lepidoptera|Sphingidae|Hyles|tithymali|Hyles tithymali Boisduval, 1834	2
Marsilea coromandelina Willd.	Plantae|Pteridophyta|Polypodiopsida|Salviniales|Marsileaceae|Marsilea|coromandelina|Marsilea coromandelina Willd.	2
Pasiphila Meyrick, 1883	Animalia|Arthropoda|Insecta|Lepidoptera|Geometridae|Pasiphila||Pasiphila Meyrick, 1883	2
Chondrophycus perforatus (Bory de Saint-Vincent) K.W.Nam, 1999	Plantae|Rhodophyta|Florideophyceae|Ceramiales|Rhodomelaceae|Palisada|perforatus|Chondrophycus perforatus (Bory de Saint-Vincent) K.W.Nam, 1999	2
Mitrella ocellata (Gmelin, 1791)	Animalia|Mollusca|Gastropoda|Neogastropoda|Columbellidae|Mitrella|ocellata|Mitrella ocellata (Gmelin, 1791)	2
Hypnea flagelliformis Greville ex J. Agardh	Plantae|Rhodophyta|Florideophyceae|Gigartinales|Hypneaceae|Hypnea|flagelliformis|Hypnea flagelliformis Greville ex J. Agardh	2
Echium vulcanorum A.Chev.	Plantae|Magnoliophyta|Magnoliopsida|Boraginales|Boraginaceae|Echium|vulcanorum|Echium vulcanorum A.Chev.	2
Bubulcus ibis	Animalia|Chordata|Aves|Pelecaniformes|Ardeidae|Bubulcus|Bubulcus ibis	2
Alvania corneti Hoenselaar & Goud, 1998	Animalia|Mollusca|Gastropoda|Neotaenioglossa|Rissoidae|Alvania|corneti|Alvania corneti Hoenselaar & Goud, 1998	2
Nicandra physalodes	Plantae|Magnoliophyta|Magnoliopsida|Solanales|Solanaceae|Nicandra|Nicandra physalodes	2
Stenorhynchus lanceolatus (Brullé, 1837)	Animalia|Arthropoda|Malacostraca|Decapoda|Inachidae|Stenorhynchus|lanceolatus|Stenorhynchus lanceolatus (Brullé, 1837)	2
Janczewskia verruciformis Solms-Laubach, 1877	Plantae|Rhodophyta|Florideophyceae|Ceramiales|Rhodomelaceae|Janczewskia|verruciformis|Janczewskia verruciformis Solms-Laubach, 1877	2
Egretta garzetta	Animalia|Chordata|Aves|Pelecaniformes|Ardeidae|Egretta|Egretta garzetta	2
Tellina Linnaeus, 1758	Animalia|Mollusca|Bivalvia|Veneroida|Tellinidae|Tellina||Tellina Linnaeus, 1758	2
Columbella adansoni Menke, 1853	Animalia|Mollusca|Gastropoda|Neogastropoda|Columbellidae|Columbella|adansoni|Columbella adansoni Menke, 1853	2
Conus ateralbus Kiener, 1845	Animalia|Mollusca|Gastropoda|Neogastropoda|Conidae|Conus|ateralbus|Conus ateralbus Kiener, 1845	2
Hypneocolax stellaris Børgesen, 1920	Plantae|Rhodophyta|Florideophyceae|Gigartinales|Cystocloniaceae|Hypneocolax|stellaris|Hypneocolax stellaris Børgesen, 1920	2
Abudefduf vaigiensis (Quoy & Gaimard, 1825)	Animalia|Chordata|Actinopterygii|Perciformes|Pomacentridae|Abudefduf|vaigiensis|Abudefduf vaigiensis (Quoy & Gaimard, 1825)	2
Monomorium boltoni Espadaler & Agosti, 1987	Animalia|Arthropoda|Insecta|Hymenoptera|Formicidae|Monomorium|boltoni|Monomorium boltoni Espadaler & Agosti, 1987	2
Bursa corrugata Perry, 1811	Animalia|Mollusca|Gastropoda|Neotaenioglossa|Bursidae|Bursa|corrugata|Bursa corrugata Perry, 1811	2
Cornulum Carter, 1876	Animalia|Porifera|Demospongiae|Poecilosclerida|Acarnidae|Cornulum||Cornulum Carter, 1876	2
Candelaria concolor (Dicks.) Stein	Fungi|Ascomycota|Lecanoromycetes|Candelariales|Candelariaceae|Candelaria|concolor|Candelaria concolor (Dicks.) Stein	2
Lecanora expallens Ach.	Fungi|Ascomycota|Lecanoromycetes|Lecanorales|Lecanoraceae|Lecanora|expallens|Lecanora expallens Ach.	2
Laevicardium Swainson, 1840	Animalia|Mollusca|Bivalvia|Veneroida|Cardiidae|Laevicardium||Laevicardium Swainson, 1840	2
Cynodon dactylon (L.) Pers.	Plantae|Magnoliophyta|Liliopsida|Poales|Poaceae|Cynodon|dactylon|Cynodon dactylon (L.) Pers.	2
Trigonodes hyppasia Cramer, 1779	Animalia|Arthropoda|Insecta|Lepidoptera|Noctuidae|Trigonodes|hyppasia|Trigonodes hyppasia Cramer, 1779	2
Glycymeris glycymeris (Linnaeus, 1758)	Animalia|Mollusca|Bivalvia|Arcoida|Glycymerididae|Glycymeris|glycymeris|Glycymeris glycymeris (Linnaeus, 1758)	2
Leptochloa panicea (Retz.) Ohwi	Plantae|Magnoliophyta|Liliopsida|Poales|Poaceae|Leptochloa|panicea|Leptochloa panicea (Retz.) Ohwi	2
Virididentex acromegalus (Osório, 1911)	Animalia|Chordata|Actinopterygii|Perciformes|Sparidae|Virididentex|acromegalus|Virididentex acromegalus (Osório, 1911)	2
Favia fragum (Esper, 1795)	Animalia|Cnidaria|Anthozoa|Scleractinia|Faviidae|Favia|fragum|Favia fragum (Esper, 1795)	2
Columba livia domestica	Animalia|Chordata|Aves|Columbiformes|Columbidae|Columba|Columba livia domestica	2
Sylvia atricapilla gularis	Animalia|Chordata|Aves|Passeriformes|Sylviidae|Sylvia|atricapilla|Sylvia atricapilla gularis	2
Phorcus Risso, 1826	Animalia|Mollusca|Gastropoda|Archaeogastropoda|Trochidae|Phorcus||Phorcus Risso, 1826	2
Dasya C.Agardh, 1824	Plantae|Rhodophyta|Florideophyceae|Ceramiales|Dasyaceae|Dasya||Dasya C.Agardh, 1824	2
Dictyota J.V.Lamouroux, 1809	Chromista|Ochrophyta|Phaeophyceae|Dictyotales|Dictyotaceae|Dictyota||Dictyota J.V.Lamouroux, 1809	2
Conus delanoyae Trovão, 1979	Animalia|Mollusca|Gastropoda|Neogastropoda|Conidae||delanoyae|Conus delanoyae Trovão, 1979	2
Porphyrio martinica (Linnaeus, 1766)	Animalia|Chordata|Aves|Gruiformes|Rallidae|Porphyrio|martinica|Porphyrio martinica (Linnaeus, 1766)	2
Ricardia montagnei Derbès & Solier, 1856	Plantae|Rhodophyta|Florideophyceae|Ceramiales|Rhodomelaceae|Erythrocystis|montagnei|Ricardia montagnei Derbès & Solier, 1856	2
Echium vulcanorum A. Chev.	Plantae|Tracheophyta|Magnoliopsida|Boraginales|Boraginaceae|Echium|vulcanorum|Echium vulcanorum A. Chev.	2
Ipomoea cairica	Plantae|Magnoliophyta|Magnoliopsida|Solanales|Convolvulaceae|Ipomoea|Ipomoea cairica	2
Sargocentron hastatus (Cuvier, 1829)	Animalia|Chordata|Actinopterygii|Beryciformes|Holocentridae|Sargocentron|hastatus|Sargocentron hastatus (Cuvier, 1829)	2
Lycopodiella cernua (L.) Pichi-Serm.	Plantae|Tracheophyta|Lycopodiopsida|Lycopodiales|Lycopodiaceae|Palhinhaea|cernua|Lycopodiella cernua (L.) Pichi-Serm.	2
Sargocentron hastatum (Cuvier, 1829)	Animalia|Chordata|Actinopterygii|Beryciformes|Holocentridae|Sargocentron|hastatum|Sargocentron hastatum (Cuvier, 1829)	2
Euphorbia granulata Forssk.	Plantae|Tracheophyta|Magnoliopsida|Malpighiales|Euphorbiaceae|Euphorbia|granulata|Euphorbia granulata Forssk.	2
Acanthogorgia armata Verrill, 1878	Animalia|Cnidaria|Anthozoa|Alcyonacea|Acanthogorgiidae|Acanthogorgia|armata|Acanthogorgia armata Verrill, 1878	2
Rhynchelytrum villosum (Parl.) Chiov.	Plantae|Tracheophyta|Liliopsida|Poales|Poaceae|Melinis|villosum|Rhynchelytrum villosum (Parl.) Chiov.	2
Zygophyllum L.	Plantae|Tracheophyta|Magnoliopsida|Zygophyllales|Zygophyllaceae|Zygophyllum||Zygophyllum L.	2
Zea mays mays	Plantae|Magnoliophyta|Liliopsida|Poales|Poaceae|Zea|Zea mays mays	2
Eretmochelys imbricata	Animalia|Chordata|Reptilia|Testudines|Cheloniidae|Eretmochelys|Eretmochelys imbricata	2
Rhomboidella obesa Ockelmann, 1983	Animalia|Mollusca|Bivalvia|Mytiloida|Mytilidae|Rhomboidella|obesa|Rhomboidella obesa Ockelmann, 1983	2
Ammomanes cinctura	Animalia|Chordata|Aves|Passeriformes|Alaudidae|Ammomanes|Ammomanes cinctura	2
Euphorbia heterophylla	Plantae|Magnoliophyta|Magnoliopsida|Malpighiales|Euphorbiaceae|Euphorbia|Euphorbia heterophylla	2
Lobophora variegata (J.V.Lamouroux) Womersley	Chromista|Ochrophyta|Phaeophyceae|Dictyotales|Dictyotaceae|Lobophora|variegata|Lobophora variegata (J.V.Lamouroux) Womersley	2
Sargassum C.Agardh, 1820	Chromista|Ochrophyta|Phaeophyceae|Fucales|Sargassaceae|Sargassum||Sargassum C.Agardh, 1820	2
Sula leucogaster	Animalia|Chordata|Aves|Suliformes|Sulidae|Sula|Sula leucogaster	2
Ardea cinerea	Animalia|Chordata|Aves|Pelecaniformes|Ardeidae|Ardea|Ardea cinerea	2
Gelidium J.V. Lamour.	Plantae|Rhodophyta|Florideophyceae|Gelidiales|Gelidiaceae|Gelidium||Gelidium J.V. Lamour.	2
Aristida adscensionis L.	Plantae|Tracheophyta|Liliopsida|Poales|Poaceae|Aristida|adscensionis|Aristida adscensionis L.	2
Alaemon alaudipes	Animalia|Chordata|Aves|Passeriformes|Alaudidae|Alaemon|Alaemon alaudipes	2
Conus crotchii Reeve, 1849	Animalia|Mollusca|Gastropoda|Neogastropoda|Conidae|Conus|crotchii|Conus crotchii Reeve, 1849	2
Phyllanthus rotundifolius Klein ex Willd.	Plantae|Magnoliophyta|Magnoliopsida|Malpighiales|Phyllanthaceae|Phyllanthus|rotundifolius|Phyllanthus rotundifolius Klein ex Willd.	2
Decapterus macarellus (Cuvier, 1833)	Animalia|Chordata|Actinopterygii|Perciformes|Carangidae|Decapterus|macarellus|Decapterus macarellus (Cuvier, 1833)	2
Anogramma leptophylla (L.) Link	Plantae|Tracheophyta|Polypodiopsida|Polypodiales|Pteridaceae|Anogramma|leptophylla|Anogramma leptophylla (L.) Link	2
Passer iagoensis	Animalia|Chordata|Aves|Passeriformes|Passeridae|Passer|Passer iagoensis	2
Heterodermia leucomelos subsp. boryi (Fée) Swinscow & Krog	Fungi|Ascomycota|Lecanoromycetes|Teloschistales|Physciaceae|Heterodermia|leucomelos|Heterodermia leucomelos subsp. boryi (Fée) Swinscow & Krog	2
Cyrtophora citricola (Forsskål, 1775)	Animalia|Arthropoda|Arachnida|Araneae|Araneidae|Cyrtophora|citricola|Cyrtophora citricola (Forsskål, 1775)	2
Luria lurida (Linnaeus, 1758)	Animalia|Mollusca|Gastropoda|Neotaenioglossa|Cypraeidae|Luria|lurida|Luria lurida (Linnaeus, 1758)	2
Marsilea coromandelica Burm. fil.	Plantae|Tracheophyta|Polypodiopsida|Salviniales|Marsileaceae|Marsilea|coromandelica|Marsilea coromandelica Burm. fil.	2
Anogramma leptophylla (L.) Link	Plantae|Pteridophyta|Polypodiopsida|Polypodiales|Sinopteridaceae|Anogramma|leptophylla|Anogramma leptophylla (L.) Link	2
Xanthoparmelia tinctina (Maheu & A. Gillet) Hale	Fungi|Ascomycota|Lecanoromycetes|Lecanorales|Parmeliaceae|Xanthoparmelia|tinctina|Xanthoparmelia tinctina (Maheu & A. Gillet) Hale	2
Octopus vulgaris Cuvier, 1797	Animalia|Mollusca|Cephalopoda|Octopoda|Octopodidae|Octopus|vulgaris|Octopus vulgaris Cuvier, 1797	2
Philonotis seriata Mitten, 1859	Plantae|Bryophyta|Bryopsida|Bryales|Bartramiaceae|Philonotis|seriata|Philonotis seriata Mitten, 1859	2
Capra hircus	Animalia|Chordata|Mammalia|Artiodactyla|Bovidae|Capra|Capra hircus	2
Coeliades forestan	Animalia|Arthropoda|Insecta|Lepidoptera|Hesperiidae|Coeliades|Coeliades forestan	2
Falco tinnunculus subsp. canariensis (Koenig, 1890)	Animalia|Chordata|Aves|Falconiformes|Falconidae|Falco|tinnunculus|Falco tinnunculus subsp. canariensis (Koenig, 1890)	2
Himantopus himantopus	Animalia|Chordata|Aves|Charadriiformes|Recurvirostridae|Himantopus|Himantopus himantopus	2
Dosinia exoleta (Linnaeus, 1758)	Animalia|Mollusca|Bivalvia|Veneroida|Veneridae|Dosinia|exoleta|Dosinia exoleta (Linnaeus, 1758)	2
Cassia occidentalis L.	Plantae|Magnoliophyta|Magnoliopsida|Fabales|Fabaceae|Senna|occidentalis|Cassia occidentalis L.	2
Botryocladia (J.Agardh) Kylin, 1931	Plantae|Rhodophyta|Florideophyceae|Rhodymeniales|Rhodymeniaceae|Botryocladia||Botryocladia (J.Agardh) Kylin, 1931	2
Tubastraea coccinea Lesson, 1829	Animalia|Cnidaria|Anthozoa|Scleractinia|Dendrophylliidae|Tubastraea|coccinea|Tubastraea coccinea Lesson, 1829	2
Pelagodroma marina (Latham, 1790)	Animalia|Chordata|Aves|Procellariiformes|Hydrobatidae|Pelagodroma|marina|Pelagodroma marina (Latham, 1790)	2
Orbiculina adunca (Fichtel & Moll, 1798)	Chromista|Foraminifera|Tubothalamea|Miliolida|Soritidae|Archaias|adunca|Orbiculina adunca (Fichtel & Moll, 1798)	2
Chaetomorpha Kützing, 1845	Plantae|Chlorophyta|Ulvophyceae|Cladophorales|Cladophoraceae|Chaetomorpha||Chaetomorpha Kützing, 1845	2
Tringa ochropus Linnaeus, 1758	Animalia|Chordata|Aves|Charadriiformes|Scolopacidae|Tringa|ochropus|Tringa ochropus Linnaeus, 1758	2
Trithemis annulata Palisot de Beauvois, 1807	Animalia|Arthropoda|Insecta|Odonata|Libellulidae|Trithemis|annulata|Trithemis annulata Palisot de Beauvois, 1807	2
Leptogium furfuraceum (Harm.) Sierk	Fungi|Ascomycota|Lecanoromycetes|Peltigerales|Collemataceae|Leptogium|furfuraceum|Leptogium furfuraceum (Harm.) Sierk	2
Cephalopholis taeniops (Valenciennes, 1828)	Animalia|Chordata|Actinopterygii|Perciformes|Serranidae|Cephalopholis|taeniops|Cephalopholis taeniops (Valenciennes, 1828)	2
Crocothemis erythraea Brullé, 1832	Animalia|Arthropoda|Insecta|Odonata|Libellulidae|Crocothemis|erythraea|Crocothemis erythraea Brullé, 1832	2
Dichanthium foveolatum (Delile) Roberty	Plantae|Tracheophyta|Liliopsida|Poales|Poaceae|Dichanthium|foveolatum|Dichanthium foveolatum (Delile) Roberty	2
Digitaria sanguinalis	Plantae|Magnoliophyta|Liliopsida|Poales|Poaceae|Digitaria|Digitaria sanguinalis	2
Conus infinitus Rolán, 1990	Animalia|Mollusca|Gastropoda|Neogastropoda|Conidae||infinitus|Conus infinitus Rolán, 1990	1
Halydictyon mirabile Zanardini, 1843	Plantae|Rhodophyta|Florideophyceae|Ceramiales|Dasyaceae|Halydictyon|mirabile|Halydictyon mirabile Zanardini, 1843	1
Gryllidae Laicharting, 1781	Animalia|Arthropoda|Insecta|Orthoptera|Gryllidae|||Gryllidae Laicharting, 1781	1
Artemisia gorgonum Webb	Plantae|Tracheophyta|Magnoliopsida|Asterales|Asteraceae|Artemisia|gorgonum|Artemisia gorgonum Webb	1
Natica turtoni E. A. Smith, 1890	Animalia|Mollusca|Gastropoda|Littorinimorpha|Naticidae|Natica|turtoni|Natica turtoni E. A. Smith, 1890	1
Trimusculus mammillaris (Linnaeus, 1758)	Animalia|Mollusca|Gastropoda||Trimusculidae|Trimusculus|mammillaris|Trimusculus mammillaris (Linnaeus, 1758)	1
Phacopsis rufa (Müll. Arg.) Triebel	Fungi|Ascomycota|Lecanoromycetes|Lecanorales|Parmeliaceae|Nesolechia|rufa|Phacopsis rufa (Müll. Arg.) Triebel	1
Anotrichium furcellatum (J.Agardh) Baldock, 1976	Plantae|Rhodophyta|Florideophyceae|Ceramiales|Wrangeliaceae|Anotrichium|furcellatum|Anotrichium furcellatum (J.Agardh) Baldock, 1976	1
Tragus racemosus (L.) All.	Plantae|Magnoliophyta|Liliopsida|Poales|Poaceae|Tragus|racemosus|Tragus racemosus (L.) All.	1
Fissurella formosa F. Salvat, 1967	Animalia|Mollusca|Gastropoda||Fissurellidae|Fissurella|formosa|Fissurella formosa F. Salvat, 1967	1
Ardea alba Linnaeus, 1758	Animalia|Chordata|Aves|Pelecaniformes|Ardeidae|Ardea|alba|Ardea alba Linnaeus, 1758	1
Peneroplis carinatus d'Orbigny, 1839	Chromista|Foraminifera|Tubothalamea|Miliolida|Peneroplidae|Peneroplis|carinatus|Peneroplis carinatus d'Orbigny, 1839	1
Sorghum halepense (L.) Pers.	Plantae|Tracheophyta|Liliopsida|Poales|Poaceae|Sorghum|halepense|Sorghum halepense (L.) Pers.	1
Anotrichium furcellatum (J. Agardh) Baldock	Plantae|Rhodophyta|Florideophyceae|Ceramiales|Ceramiaceae|Anotrichium|furcellatum|Anotrichium furcellatum (J. Agardh) Baldock	1
Helminthocladia calvadosii (J.V.Lamouroux ex Duby) Setchell, 1915	Plantae|Rhodophyta|Florideophyceae|Nemaliales|Liagoraceae|Helminthocladia|calvadosii|Helminthocladia calvadosii (J.V.Lamouroux ex Duby) Setchell, 1915	1
Alvania jacquesi Hoenselaar & Goud, 1998	Animalia|Mollusca|Gastropoda|Neotaenioglossa|Rissoidae|Alvania|jacquesi|Alvania jacquesi Hoenselaar & Goud, 1998	1
Volvarina verdensis (E.A. Smith, 1875)	Animalia|Mollusca|Gastropoda|Neogastropoda|Marginellidae|Volvarina|verdensis|Volvarina verdensis (E.A. Smith, 1875)	1
Turbonilla kerstinae Schander, 1994	Animalia|Mollusca|Gastropoda|Heterostropha|Pyramidellidae|Turbonilla|kerstinae|Turbonilla kerstinae Schander, 1994	1
Andrachne telephioides L.	Plantae|Magnoliophyta|Magnoliopsida|Malpighiales|Phyllanthaceae|Andrachne|telephioides|Andrachne telephioides L.	1
Indigofera colutea (Burm. f.) Merr.	Plantae|Magnoliophyta|Magnoliopsida|Fabales|Fabaceae|Indigofera|colutea|Indigofera colutea (Burm. f.) Merr.	1
Chloris virgata Sw.	Plantae|Magnoliophyta|Liliopsida|Poales|Poaceae|Chloris|virgata|Chloris virgata Sw.	1
Conus diminutus Trovão & Rolán, 1986	Animalia|Mollusca|Gastropoda|Neogastropoda|Conidae|Conus|diminutus|Conus diminutus Trovão & Rolán, 1986	1
Brachiaria ramosa (L.) Stapf	Plantae|Tracheophyta|Liliopsida|Poales|Poaceae|Brachiaria|ramosa|Brachiaria ramosa (L.) Stapf	1
Oplismenus burmanni (Retz.) P.Beauv.	Plantae|Tracheophyta|Liliopsida|Poales|Poaceae|Oplismenus|burmanni|Oplismenus burmanni (Retz.) P.Beauv.	1
Eleusine Gaertn.	Plantae|Magnoliophyta|Liliopsida|Poales|Poaceae|Eleusine||Eleusine Gaertn.	1
Enteropogon rupestris (J.A.Schmidt) A.Chev.	Plantae|Magnoliophyta|Liliopsida|Poales|Poaceae|Enteropogon|rupestris|Enteropogon rupestris (J.A.Schmidt) A.Chev.	1
Chaetomorpha pachynema (Montagne) Kützing	Plantae|Chlorophyta|Ulvophyceae|Cladophorales|Cladophoraceae|Chaetomorpha|pachynema|Chaetomorpha pachynema (Montagne) Kützing	1
Crisilla morenoi Templado & Rolán, 1994	Animalia|Mollusca|Gastropoda|Littorinimorpha|Rissoidae|Crisilla|morenoi|Crisilla morenoi Templado & Rolán, 1994	1
Oceanodroma leucorhoa (Vieillot, 1818)	Animalia|Chordata|Aves|Procellariiformes|Hydrobatidae|Oceanodroma|leucorhoa|Oceanodroma leucorhoa (Vieillot, 1818)	1
Lavandula dentata L.	Plantae|Tracheophyta|Magnoliopsida|Lamiales|Lamiaceae|Lavandula|dentata|Lavandula dentata L.	1
Liagora J.V.Lamouroux, 1812	Plantae|Rhodophyta|Florideophyceae|Nemaliales|Liagoraceae|Liagora||Liagora J.V.Lamouroux, 1812	1
Potamogeton pusillus L.	Plantae|Magnoliophyta|Liliopsida|Alismatales|Potamogetonaceae|Potamogeton|pusillus|Potamogeton pusillus L.	1
Gelidium corneum (Hudson) J.V.Lamouroux, 1813	Plantae|Rhodophyta|Florideophyceae|Gelidiales|Gelidiaceae|Gelidium|corneum|Gelidium corneum (Hudson) J.V.Lamouroux, 1813	1
Plocamium J.V.F. Lamouroux, 1813	Plantae|Rhodophyta|Florideophyceae|Plocamiales|Plocamiaceae|Plocamium||Plocamium J.V.F. Lamouroux, 1813	1
Euphorbia forsskalii J.Gay	Plantae|Tracheophyta|Magnoliopsida|Malpighiales|Euphorbiaceae|Euphorbia|forsskalii|Euphorbia forsskalii J.Gay	1
Setaria pumila (Poir.) Roem. & Schult.	Plantae|Magnoliophyta|Liliopsida|Poales|Poaceae|Setaria|pumila|Setaria pumila (Poir.) Roem. & Schult.	1
Nesolechia	Fungi|Ascomycota|Lecanoromycetes|Lecanorales|Parmeliaceae|Nesolechia||Nesolechia	1
Diodora menkeana (Dunker, 1846)	Animalia|Mollusca|Gastropoda||Fissurellidae|Diodora|menkeana|Diodora menkeana (Dunker, 1846)	1
Ulva rigida C.Agardh, 1823	Plantae|Chlorophyta|Ulvophyceae|Ulvales|Ulvaceae|Ulva|rigida|Ulva rigida C.Agardh, 1823	1
Rimelia reticulata (Tayl.) Hale & Fletcher	Fungi|Ascomycota|Lecanoromycetes|Lecanorales|Parmeliaceae|Rimelia|reticulata|Rimelia reticulata (Tayl.) Hale & Fletcher	1
Odostomella africana Schander, 1994	Animalia|Mollusca|Gastropoda||Pyramidellidae|Odostomella|africana|Odostomella africana Schander, 1994	1
Cistanche phelipaea (L.) Coutinho	Plantae|Tracheophyta|Magnoliopsida|Lamiales|Orobanchaceae|Cistanche|phelipaea|Cistanche phelipaea (L.) Coutinho	1
Dictyota adnata Zanardini, 1878	Chromista|Ochrophyta|Phaeophyceae|Dictyotales|Dictyotaceae|Dictyota|adnata|Dictyota adnata Zanardini, 1878	1
Pteridium aquilinum (L.) Kuhn	Plantae|Pteridophyta|Polypodiopsida|Polypodiales|Dennstaedtiaceae|Pteridium|aquilinum|Pteridium aquilinum (L.) Kuhn	1
Forsskaolea procridifolia Webb	Plantae|Tracheophyta|Magnoliopsida|Rosales|Urticaceae|Forsskaolea|procridifolia|Forsskaolea procridifolia Webb	1
Chondrophycus papillosus (C.Agardh) D.J.Garbary & J.T.Harper, 1998	Plantae|Rhodophyta|Florideophyceae|Ceramiales|Rhodomelaceae|Palisada|papillosus|Chondrophycus papillosus (C.Agardh) D.J.Garbary & J.T.Harper, 1998	1
Sorghum bicolor (L.) Moench	Plantae|Tracheophyta|Liliopsida|Poales|Poaceae|Sorghum|bicolor|Sorghum bicolor (L.) Moench	1
Heteropogon contortus (L.) P.Beauv. ex Roem. & Schult.	Plantae|Tracheophyta|Liliopsida|Poales|Poaceae|Heteropogon|contortus|Heteropogon contortus (L.) P.Beauv. ex Roem. & Schult.	1
Anacardium occidentale L.	Plantae|Tracheophyta|Magnoliopsida|Sapindales|Anacardiaceae|Anacardium|occidentale|Anacardium occidentale L.	1
Ricinus communis L.	Plantae|Magnoliophyta|Magnoliopsida|Malpighiales|Euphorbiaceae|Ricinus|communis|Ricinus communis L.	1
Euphorbia L.	Plantae|Magnoliophyta|Magnoliopsida|Malpighiales|Euphorbiaceae|Euphorbia||Euphorbia L.	1
Pennisetum pedicellatum subsp. unispiculum Brunken	Plantae|Tracheophyta|Liliopsida|Poales|Poaceae|Pennisetum|pedicellatum|Pennisetum pedicellatum subsp. unispiculum Brunken	1
Hypnea arbuscula P.J.L.Dangeard, 1952	Plantae|Rhodophyta|Florideophyceae|Gigartinales|Cystocloniaceae|Hypnea|arbuscula|Hypnea arbuscula P.J.L.Dangeard, 1952	1
Tolpis farinulosa (Webb) Walp.	Plantae|Tracheophyta|Magnoliopsida|Asterales|Asteraceae|Tolpis|farinulosa|Tolpis farinulosa (Webb) Walp.	1
Chaetomorpha Kuetzing, 1845	Plantae|Chlorophyta|Ulvophyceae|Cladophorales|Cladophoraceae|Chaetomorpha||Chaetomorpha Kuetzing, 1845	1
Asteriscus vogelii Walp.	Plantae|Magnoliophyta|Magnoliopsida|Asterales|Asteraceae||vogelii|Asteriscus vogelii Walp.	1
Apus unicolor (Jardine, 1830)	Animalia|Chordata|Aves|Apodiformes|Apodidae|Apus|unicolor|Apus unicolor (Jardine, 1830)	1
Crisilla morenoi Templado & Rolán, 1994	Animalia|Mollusca|Gastropoda|Neotaenioglossa|Rissoidae|Crisilla|morenoi|Crisilla morenoi Templado & Rolán, 1994	1
Aristida funiculata Trin. & Rupr.	Plantae|Tracheophyta|Liliopsida|Poales|Poaceae|Aristida|funiculata|Aristida funiculata Trin. & Rupr.	1
Christella dentata (Forssk.) Brownsey & Jermy	Plantae|Pteridophyta|Polypodiopsida|Polypodiales|Thelypteridaceae|Cyclosorus|dentata|Christella dentata (Forssk.) Brownsey & Jermy	1
Enteromorpha Link, 1820	Plantae|Chlorophyta|Ulvophyceae|Ulvales|Ulvaceae|Ulva||Enteromorpha Link, 1820	1
Arthrocnemum macrostachyum (Moric.) K. Koch	Plantae|Magnoliophyta|Magnoliopsida|Caryophyllales|Chenopodiaceae|Arthrocnemum|macrostachyum|Arthrocnemum macrostachyum (Moric.) K. Koch	1
Balanus tintinnabulum	Animalia|Arthropoda|Maxillopoda|Sessilia|Balanidae|Balanus|tintinnabulum|Balanus tintinnabulum	1
Chnoospora minima (K. Hering) Papenfuss	Chromista|Ochrophyta|Phaeophyceae|Ectocarpales|Chordariaceae|Chnoospora|minima|Chnoospora minima (K. Hering) Papenfuss	1
Heterosiphonia crispella (C.Agardh) M.J.Wynne, 1985	Plantae|Rhodophyta|Florideophyceae|Ceramiales|Dasyaceae|Heterosiphonia|crispella|Heterosiphonia crispella (C.Agardh) M.J.Wynne, 1985	1
Rimelia reticulata (Taylor) Hale & A. Fletcher	Fungi|Ascomycota|Lecanoromycetes|Lecanorales|Parmeliaceae|Parmotrema|reticulata|Rimelia reticulata (Taylor) Hale & A. Fletcher	1
Platybelone argalus subsp. lovii (Günther, 1866)	Animalia|Chordata|Actinopterygii|Beloniformes|Belonidae|Platybelone|argalus|Platybelone argalus subsp. lovii (Günther, 1866)	1
Hipponix subrufus (Lamarck, 1819)	Animalia|Mollusca|Gastropoda|Neotaenioglossa|Hipponicidae|Hipponix|subrufus|Hipponix subrufus (Lamarck, 1819)	1
Phyllanthus rotundifolius J.G.Klein ex Willd.	Plantae|Tracheophyta|Magnoliopsida|Malpighiales|Phyllanthaceae|Phyllanthus|rotundifolius|Phyllanthus rotundifolius J.G.Klein ex Willd.	1
Asphodelus tenuifolius Cav.	Plantae|Magnoliophyta|Liliopsida|Asparagales|Xanthorrhoeaceae|Asphodelus|tenuifolius|Asphodelus tenuifolius Cav.	1
Chloris virgata Sw.	Plantae|Tracheophyta|Liliopsida|Poales|Poaceae|Chloris|virgata|Chloris virgata Sw.	1
Leucandra Haeckel, 1872	Animalia|Porifera|Calcarea|Leucosolenida|Grantiidae|Leucandra||Leucandra Haeckel, 1872	1
Leptochelia affinis Hansen, 1895	Animalia|Arthropoda|Malacostraca|Tanaidacea|Leptocheliidae|Leptochelia|affinis|Leptochelia affinis Hansen, 1895	1
Schwartziella sulcostriata Rolán & Luque, 2000	Animalia|Mollusca|Gastropoda|Neotaenioglossa|Rissoidae|Schwartziella|sulcostriata|Schwartziella sulcostriata Rolán & Luque, 2000	1
Gelidium corneum (Hudson) J.V. Lamouroux	Plantae|Rhodophyta|Florideophyceae|Gelidiales|Gelidiaceae|Gelidium|corneum|Gelidium corneum (Hudson) J.V. Lamouroux	1
Lagena Walker & Jacob, 1798	Protozoa||Granuloreticulosea|Foraminiferida|Nodosariidae|Lagena||Lagena Walker & Jacob, 1798	1
Launaea picridioides B.L.Rob.	Plantae|Magnoliophyta|Magnoliopsida|Asterales|Asteraceae||picridioides|Launaea picridioides B.L.Rob.	1
Usnea baileyi (Stirt.) Zahlbr., 1909	Fungi|Ascomycota|Lecanoromycetes|Lecanorales|Parmeliaceae|Usnea|baileyi|Usnea baileyi (Stirt.) Zahlbr., 1909	1
Chondrophycus perforatus (Bory de Saint-Vincent) K.W. Nam	Plantae|Rhodophyta|Florideophyceae|Ceramiales|Rhodomelaceae|Chondrophycus|perforatus|Chondrophycus perforatus (Bory de Saint-Vincent) K.W. Nam	1
Launaea picridioides (Webb) Engl.	Plantae|Tracheophyta|Magnoliopsida|Asterales|Asteraceae|Launaea|picridioides|Launaea picridioides (Webb) Engl.	1
Acinetospora crinita (Carmichael) Kornmann	Chromista|Ochrophyta|Phaeophyceae|Ectocarpales|Acinetosporaceae|Acinetospora|crinita|Acinetospora crinita (Carmichael) Kornmann	1
Conidae Rafinesque, 1815	Animalia|Mollusca|Gastropoda|Neogastropoda|Conidae|||Conidae Rafinesque, 1815	1
Euphorbia milii var. splendens (Bojer ex Hook.) Ursch & Leandri	Plantae|Tracheophyta|Magnoliopsida|Malpighiales|Euphorbiaceae|Euphorbia|milii|Euphorbia milii var. splendens (Bojer ex Hook.) Ursch & Leandri	1
Solanum L.	Plantae|Magnoliophyta|Magnoliopsida|Solanales|Solanaceae|Solanum||Solanum L.	1
Cinnamomum camphora (L.) J. Presl	Plantae|Magnoliophyta|Magnoliopsida|Laurales|Lauraceae|Cinnamomum|camphora|Cinnamomum camphora (L.) J. Presl	1
Asplenium trichomanes L.	Plantae|Tracheophyta|Polypodiopsida|Polypodiales|Aspleniaceae|Asplenium|trichomanes|Asplenium trichomanes L.	1
Launaea arborescens (Batt.) Murb.	Plantae|Tracheophyta|Magnoliopsida|Asterales|Asteraceae|Launaea|arborescens|Launaea arborescens (Batt.) Murb.	1
Cenchrus ciliaris L.	Plantae|Tracheophyta|Liliopsida|Poales|Poaceae|Cenchrus|ciliaris|Cenchrus ciliaris L.	1
Tectarius striatus (King, 1832)	Animalia|Mollusca|Gastropoda|Littorinimorpha|Littorinidae|Tectarius|striatus|Tectarius striatus (King, 1832)	1
Cosmotriphora melanura (C. B. Adams, 1850)	Animalia|Mollusca|Gastropoda|Neotaenioglossa|Triphoridae|Cosmotriphora|melanura|Cosmotriphora melanura (C. B. Adams, 1850)	1
Calyptraea helicoidea Sowerby, 1883	Animalia|Mollusca|Gastropoda|Littorinimorpha|Calyptraeidae|Calyptraea|helicoidea|Calyptraea helicoidea Sowerby, 1883	1
Odostomella africana Schander, 1994	Animalia|Mollusca|Gastropoda|Heterostropha|Pyramidellidae|Odostomella|africana|Odostomella africana Schander, 1994	1
Setaria viridis (L.) P.Beauv.	Plantae|Magnoliophyta|Liliopsida|Poales|Poaceae|Setaria|viridis|Setaria viridis (L.) P.Beauv.	1
Adiantum incisum Forssk.	Plantae|Tracheophyta|Polypodiopsida|Polypodiales|Pteridaceae|Adiantum|incisum|Adiantum incisum Forssk.	1
Wrangelia argus (Montagne) Montagne	Plantae|Rhodophyta|Florideophyceae|Ceramiales|Ceramiaceae|Wrangelia|argus|Wrangelia argus (Montagne) Montagne	1
Ceramium Wiggers, 1780	Plantae|Rhodophyta||||Ceramium||Ceramium Wiggers, 1780	1
Euphorbia milii var. splendens	Plantae|Magnoliophyta|Magnoliopsida|Malpighiales|Euphorbiaceae|Euphorbia|milii|Euphorbia milii var. splendens	1
Cheilanthes catanensis (Cosent.) H. P. Fuchs	Plantae|Tracheophyta|Polypodiopsida|Polypodiales|Pteridaceae|Cosentinia|catanensis|Cheilanthes catanensis (Cosent.) H. P. Fuchs	1
Lycopodiella cernua (L.) Pic. Serm.	Plantae|Lycopodiophyta|Lycopodiopsida|Lycopodiales|Lycopodiaceae|Lycopodiella|cernua|Lycopodiella cernua (L.) Pic. Serm.	1
Rottboellia exaltata L.f.	Plantae|Magnoliophyta|Liliopsida|Poales|Poaceae|Rottboellia|exaltata|Rottboellia exaltata L.f.	1
Levringia brasiliensis (Montagne) A.B.Joly, 1953	Chromista|Ochrophyta|Phaeophyceae|Ectocarpales|Chordariaceae|Levringia|brasiliensis|Levringia brasiliensis (Montagne) A.B.Joly, 1953	1
Enneapogon brachystachyus (Jaub. & Spach) Stapf	Plantae|Tracheophyta|Liliopsida|Poales|Poaceae|Enneapogon|brachystachyus|Enneapogon brachystachyus (Jaub. & Spach) Stapf	1
Andropogon gayanus var. tridentatus	Plantae|Magnoliophyta|Liliopsida|Poales|Poaceae|Andropogon|gayanus|Andropogon gayanus var. tridentatus	1
Phyllanthus L.	Plantae|Tracheophyta|Magnoliopsida|Malpighiales|Phyllanthaceae|Phyllanthus||Phyllanthus L.	1
Cenchrus ciliaris L.	Plantae|Magnoliophyta|Liliopsida|Poales|Poaceae|Cenchrus|ciliaris|Cenchrus ciliaris L.	1
Cheilopogon Lowe, 1841	Animalia|Chordata|Actinopterygii|Beloniformes|Exocoetidae|Cheilopogon||Cheilopogon Lowe, 1841	1
Setaria viridis (L.) P.Beauv.	Plantae|Tracheophyta|Liliopsida|Poales|Poaceae|Setaria|viridis|Setaria viridis (L.) P.Beauv.	1
Lucina goreensis (Jaeckel, 1927)	Animalia|Mollusca|Bivalvia|Lucinoida|Lucinidae|Lucina|goreensis|Lucina goreensis (Jaeckel, 1927)	1
Grateloupia dichotoma J.Agardh, 1842	Plantae|Rhodophyta|Florideophyceae|Halymeniales|Halymeniaceae|Grateloupia|dichotoma|Grateloupia dichotoma J.Agardh, 1842	1
Fagonia latifolia Delile	Plantae|Magnoliophyta|Magnoliopsida|Zygophyllales|Zygophyllaceae|Fagonia|latifolia|Fagonia latifolia Delile	1
Euphorbia tuckeyana Steud. ex Webb	Plantae|Tracheophyta|Magnoliopsida|Malpighiales|Euphorbiaceae|Euphorbia|tuckeyana|Euphorbia tuckeyana Steud. ex Webb	1
Calotropis procera (Ait.) Ait. fil.	Plantae|Tracheophyta|Magnoliopsida|Gentianales|Apocynaceae|Calotropis|procera|Calotropis procera (Ait.) Ait. fil.	1
Gryllidae	Animalia|Arthropoda|Insecta|Orthoptera|Gryllidae|||Gryllidae	1
Ischaemum laxum R.Br.	Plantae|Tracheophyta|Liliopsida|Poales|Poaceae|Sehima|laxum|Ischaemum laxum R.Br.	1
Turritella bicingulata Lamarck, 1822	Animalia|Mollusca|Gastropoda||Turritellidae|Turritella|bicingulata|Turritella bicingulata Lamarck, 1822	1
Fagonia latifolia Del.	Plantae|Tracheophyta|Magnoliopsida|Zygophyllales|Zygophyllaceae|Fagonia|latifolia|Fagonia latifolia Del.	1
Donax verdensis Cosel, 1995	Animalia|Mollusca|Bivalvia|Veneroida|Donacidae|Donax|verdensis|Donax verdensis Cosel, 1995	1
Fimbristylis ferruginea (L.) Vahl	Plantae|Tracheophyta|Liliopsida|Poales|Cyperaceae|Fimbristylis|ferruginea|Fimbristylis ferruginea (L.) Vahl	1
Wrangelia penicillata (C. Agardh) C. Agardh	Plantae|Rhodophyta|Florideophyceae|Ceramiales|Ceramiaceae|Wrangelia|penicillata|Wrangelia penicillata (C. Agardh) C. Agardh	1
Leptochelia affinis Norman, 1886	Animalia|Arthropoda|Malacostraca|Tanaidacea|Neotanaidae|Neotanais|affinis|Leptochelia affinis Norman, 1886	1
Chnoospora fastigiata J. Agardh	Chromista|Ochrophyta|Phaeophyceae|Ectocarpales|Chordariaceae|Chnoospora|fastigiata|Chnoospora fastigiata J. Agardh	1
Elasmobranchii	Animalia|Chordata|Elasmobranchii|||||Elasmobranchii	1
Sehima ischaemoides Forssk.	Plantae|Magnoliophyta|Liliopsida|Poales|Poaceae|Sehima|ischaemoides|Sehima ischaemoides Forssk.	1
Cerithium atratum (Born, 1778)	Animalia|Mollusca|Gastropoda|Neotaenioglossa|Cerithiidae|Cerithium|atratum|Cerithium atratum (Born, 1778)	1
Dictyota adnata Zanardini	Chromista|Ochrophyta|Phaeophyceae|Dictyotales|Dictyotaceae|Dictyota|adnata|Dictyota adnata Zanardini	1
Tripogon multiflorus Miré & H.Gillet	Plantae|Tracheophyta|Liliopsida|Poales|Poaceae|Tripogon|multiflorus|Tripogon multiflorus Miré & H.Gillet	1
Venus verrucosa Linnaeus, 1758	Animalia|Mollusca|Bivalvia|Veneroida|Veneridae|Venus|verrucosa|Venus verrucosa Linnaeus, 1758	1
Blutaparon vermiculare (L.) Mears	Plantae|Tracheophyta|Magnoliopsida|Caryophyllales|Amaranthaceae|Blutaparon|vermiculare|Blutaparon vermiculare (L.) Mears	1
Tamarix gallica L.	Plantae|Tracheophyta|Magnoliopsida|Caryophyllales|Tamaricaceae|Tamarix|gallica|Tamarix gallica L.	1
Boerhavia diffusa L.	Plantae|Tracheophyta|Magnoliopsida|Caryophyllales|Nyctaginaceae|Boerhavia|diffusa|Boerhavia diffusa L.	1
Botryphallus tuber (Rolán, 1991)	Animalia|Mollusca|Gastropoda|Littorinimorpha|Rissoidae|Botryphallus|tuber|Botryphallus tuber (Rolán, 1991)	1
Turdus merula Linnaeus, 1758	Animalia|Chordata|Aves|Passeriformes|Turdidae|Turdus|merula|Turdus merula Linnaeus, 1758	1
Digitaria horizontalis Willd.	Plantae|Magnoliophyta|Liliopsida|Poales|Poaceae|Digitaria|horizontalis|Digitaria horizontalis Willd.	1
Zornia diphylla (L.) Pers.	Plantae|Tracheophyta|Magnoliopsida|Fabales|Fabaceae|Zornia|diphylla|Zornia diphylla (L.) Pers.	1
Falco tinnunculus subsp. neglectus Schlegel, 1873	Animalia|Chordata|Aves|Falconiformes|Falconidae|Falco|tinnunculus|Falco tinnunculus subsp. neglectus Schlegel, 1873	1
Animalia	Animalia|||||||Animalia	1
Dictyopteris delicatula J.V.Lamouroux, 1809	Chromista|Ochrophyta|Phaeophyceae|Dictyotales|Dictyotaceae|Dictyopteris|delicatula|Dictyopteris delicatula J.V.Lamouroux, 1809	1
Conus saragasae Rolán, 1986	Animalia|Mollusca|Gastropoda|Neogastropoda|Conidae||saragasae|Conus saragasae Rolán, 1986	1
Hypneocolax stellaris Børgesen	Plantae|Rhodophyta|Florideophyceae|Gigartinales|Hypneaceae|Hypneocolax|stellaris|Hypneocolax stellaris Børgesen	1
Cyperus jeminicus Rottb.	Plantae|Tracheophyta|Liliopsida|Poales|Cyperaceae|Cyperus|jeminicus|Cyperus jeminicus Rottb.	1
Conus evorai Monteiro, Fernandes & Rolán, 1995	Animalia|Mollusca|Gastropoda|Neogastropoda|Conidae|Conus|evorai|Conus evorai Monteiro, Fernandes & Rolán, 1995	1
Sinapidendron vogelii Webb	Plantae|Tracheophyta|Magnoliopsida|Brassicales|Brassicaceae|Diplotaxis|vogelii|Sinapidendron vogelii Webb	1
Amphiroa beauvoisii J.V. Lamouroux	Plantae|Rhodophyta|Florideophyceae|Corallinales|Corallinaceae|Amphiroa|beauvoisii|Amphiroa beauvoisii J.V. Lamouroux	1
Pennisetum polystachyon Schult.	Plantae|Tracheophyta|Liliopsida|Poales|Poaceae|Pennisetum|polystachyon|Pennisetum polystachyon Schult.	1
Halcyon leucocephala acteon (Lesson, 1830)	Animalia|Chordata|Aves|Coraciiformes|Alcedinidae|Halcyon|leucocephala|Halcyon leucocephala acteon (Lesson, 1830)	1
Colubraria obscura (Reeve, 1844)	Animalia|Mollusca|Gastropoda|Neogastropoda|Colubrariidae|Colubraria|obscura|Colubraria obscura (Reeve, 1844)	1
Asparagopsis taxiformis (Delile) Trevisan de Saint-Léon, 1845	Plantae|Rhodophyta|Florideophyceae|Bonnemaisoniales|Bonnemaisoniaceae|Asparagopsis|taxiformis|Asparagopsis taxiformis (Delile) Trevisan de Saint-Léon, 1845	1
Luria lurida pulchroides Alvarado & Alvarez, 1964	Animalia|Mollusca|Gastropoda|Neotaenioglossa|Cypraeidae|Luria|lurida|Luria lurida pulchroides Alvarado & Alvarez, 1964	1
Conus calhetae Rolán, 1990	Animalia|Mollusca|Gastropoda|Neogastropoda|Conidae|Conus|calhetae|Conus calhetae Rolán, 1990	1
Cypraea picta Gray, 1824	Animalia|Mollusca|Gastropoda|Littorinimorpha|Cypraeidae|Zonaria|picta|Cypraea picta Gray, 1824	1
Diodora menkeana (Dunker, 1846)	Animalia|Mollusca|Gastropoda|Archaeogastropoda|Fissurellidae|Diodora|menkeana|Diodora menkeana (Dunker, 1846)	1
Colubraria obscura (Reeve, 1844)	Animalia|Mollusca|Gastropoda|Neogastropoda|Buccinidae|Colubraria|obscura|Colubraria obscura (Reeve, 1844)	1
Vanessa cardui (Linnaeus, 1758)	Animalia|Arthropoda|Insecta|Lepidoptera|Nymphalidae|Cynthia|cardui|Vanessa cardui (Linnaeus, 1758)	1
Subulinidae Thiele, 1931	Animalia|Mollusca|Gastropoda|Stylommatophora|Subulinidae|||Subulinidae Thiele, 1931	1
Egretta ardesiaca (Wagler, 1827)	Animalia|Chordata|Aves|Pelecaniformes|Ardeidae|Egretta|ardesiaca|Egretta ardesiaca (Wagler, 1827)	1
Diplodus sargus (Linnaeus, 1758)	Animalia|Chordata|Actinopterygii|Perciformes|Sparidae|Diplodus|sargus|Diplodus sargus (Linnaeus, 1758)	1
Dacelo Leach, 1815	Animalia|Chordata|Aves|Coraciiformes|Alcedinidae|Dacelo||Dacelo Leach, 1815	1
Dichanthium annulatum (Forssk.) Stapf	Plantae|Magnoliophyta|Liliopsida|Poales|Poaceae|Dichanthium|annulatum|Dichanthium annulatum (Forssk.) Stapf	1
Setaria pumila (Poir.) Roem. & Schult.	Plantae|Tracheophyta|Liliopsida|Poales|Poaceae|Setaria|pumila|Setaria pumila (Poir.) Roem. & Schult.	1
Sorghum bicolor (L.) Moench	Plantae|Magnoliophyta|Liliopsida|Poales|Poaceae|Sorghum|bicolor|Sorghum bicolor (L.) Moench	1
Gyroscala lamellosa (Lamarck, 1822)	Animalia|Mollusca|Gastropoda|Neotaenioglossa|Epitoniidae|Gyroscala|lamellosa|Gyroscala lamellosa (Lamarck, 1822)	1
Thais nodosa (Linnaeus, 1758)	Animalia|Mollusca|Gastropoda|Neogastropoda|Muricidae|Thais|nodosa|Thais nodosa (Linnaeus, 1758)	1
Alvania lavaleyei Hoenselaar & Goud, 1998	Animalia|Mollusca|Gastropoda|Neotaenioglossa|Rissoidae|Alvania|lavaleyei|Alvania lavaleyei Hoenselaar & Goud, 1998	1
Glycymeris formosus (Reeve, 1843)	Animalia|Mollusca|Bivalvia|Arcoida|Glycymerididae|Glycymeris|formosus|Glycymeris formosus (Reeve, 1843)	1
Conus raulsilvai Rolán, Monteiro & Fernandes, 1998	Animalia|Mollusca|Gastropoda|Neogastropoda|Conidae|Conus|raulsilvai|Conus raulsilvai Rolán, Monteiro & Fernandes, 1998	1
Dictyopteris delicatula J.V. Lamouroux	Chromista|Ochrophyta|Phaeophyceae|Dictyotales|Dictyotaceae|Dictyopteris|delicatula|Dictyopteris delicatula J.V. Lamouroux	1
Nemastome	Plantae|||||Nemastome||Nemastome	1
Herposiphonia tenella (C. Agardh) Ambronn	Plantae|Rhodophyta|Florideophyceae|Ceramiales|Rhodomelaceae|Herposiphonia|tenella|Herposiphonia tenella (C. Agardh) Ambronn	1
Bostrycapulus tegulicius (Rochebrune, 1883)	Animalia|Mollusca|Gastropoda|Littorinimorpha|Calyptraeidae|Bostrycapulus|tegulicius|Bostrycapulus tegulicius (Rochebrune, 1883)	1
Euphorbia L.	Plantae|Tracheophyta|Magnoliopsida|Malpighiales|Euphorbiaceae|Euphorbia||Euphorbia L.	1
Griffithsia C.Agardh, 1817	Plantae|Rhodophyta|Florideophyceae|Ceramiales|Wrangeliaceae|Griffithsia||Griffithsia C.Agardh, 1817	1
Davallia canariensis (L.) Sm.	Plantae|Tracheophyta|Polypodiopsida|Polypodiales|Davalliaceae|Davallia|canariensis|Davallia canariensis (L.) Sm.	1
Conus mercator Linnaeus, 1758	Animalia|Mollusca|Gastropoda|Neogastropoda|Conidae|Conus|mercator|Conus mercator Linnaeus, 1758	1
Brachiaria deflexa (Schumach.) C.E.Hubb. ex Robyns	Plantae|Tracheophyta|Liliopsida|Poales|Poaceae|Brachiaria|deflexa|Brachiaria deflexa (Schumach.) C.E.Hubb. ex Robyns	1
Caulerpella ambigua	Plantae|Chlorophyta|Ulvophyceae|Bryopsidales|Caulerpaceae|Caulerpa|ambigua|Caulerpella ambigua	1
Lycopodium cernuum L.	Plantae|Lycopodiophyta|Lycopodiopsida|Lycopodiales|Lycopodiaceae|Lycopodiella|cernuum|Lycopodium cernuum L.	1
Ralfsia expansa (J.Agardh) J.Agardh, 1848	Chromista|Ochrophyta|Phaeophyceae|Ralfsiales|Neoralfsiaceae|Neoralfsia|expansa|Ralfsia expansa (J.Agardh) J.Agardh, 1848	1
Conus mercator Linnaeus, 1758	Animalia|Mollusca|Gastropoda|Neogastropoda|Conidae||mercator|Conus mercator Linnaeus, 1758	1
Muricopsis gofasi Houart, 1993	Animalia|Mollusca|Gastropoda|Neogastropoda|Muricidae|Muricopsis|gofasi|Muricopsis gofasi Houart, 1993	1
Cyperus maritimus (Lam.) P.Silva	Plantae|Magnoliophyta|Liliopsida|Poales|Cyperaceae|Cyperus|maritimus|Cyperus maritimus (Lam.) P.Silva	1
Alaba culliereti (Dautzenberg, 1890)	Animalia|Mollusca|Gastropoda|Neotaenioglossa|Litiopidae|Alaba|culliereti|Alaba culliereti (Dautzenberg, 1890)	1
Fimbristylis sieberiana Kunth	Plantae|Magnoliophyta|Liliopsida|Poales|Cyperaceae|Fimbristylis|sieberiana|Fimbristylis sieberiana Kunth	1
Polyphysa parvula (Solms-Laubach) Schnetter & Bula Meyer, 1982	Plantae|Chlorophyta|Ulvophyceae|Dasycladales|Polyphysaceae|Parvocaulis|parvula|Polyphysa parvula (Solms-Laubach) Schnetter & Bula Meyer, 1982	1
Tolpis farinulosa Walp.	Plantae|Magnoliophyta|Magnoliopsida|Asterales|Asteraceae||farinulosa|Tolpis farinulosa Walp.	1
Echinolittorina punctata (Gmelin, 1791)	Animalia|Mollusca|Gastropoda|Littorinimorpha|Littorinidae|Echinolittorina|punctata|Echinolittorina punctata (Gmelin, 1791)	1
Cajanus cajan	Plantae|Magnoliophyta|Magnoliopsida|Fabales|Fabaceae|Cajanus|Cajanus cajan	1
Bothriochloa Kuntze	Plantae|Tracheophyta|Liliopsida|Poales|Poaceae|Bothriochloa||Bothriochloa Kuntze	1
Barleeia chefiae Gofas, 1995	Animalia|Mollusca|Gastropoda|Neotaenioglossa|Barleeiidae|Barleeia|chefiae|Barleeia chefiae Gofas, 1995	1
Eleusine Gaertn.	Plantae|Tracheophyta|Liliopsida|Poales|Poaceae|Eleusine||Eleusine Gaertn.	1
Pennisetum pedicellatum Trin.	Plantae|Tracheophyta|Liliopsida|Poales|Poaceae|Pennisetum|pedicellatum|Pennisetum pedicellatum Trin.	1
Christella dentata (Forsk.) Brownsey & Jermy	Plantae|Tracheophyta|Polypodiopsida|Polypodiales|Thelypteridaceae|Christella|dentata|Christella dentata (Forsk.) Brownsey & Jermy	1
Schmidtia pappophoroides Steud.	Plantae|Tracheophyta|Liliopsida|Poales|Poaceae|Schmidtia|pappophoroides|Schmidtia pappophoroides Steud.	1
Lecanora Ach., 1809	Fungi|Ascomycota|Lecanoromycetes|Lecanorales|Lecanoraceae|Lecanora||Lecanora Ach., 1809	1
Cyperus esculentus L.	Plantae|Magnoliophyta|Liliopsida|Poales|Cyperaceae|Cyperus|esculentus|Cyperus esculentus L.	1
Fimbristylis ferruginea (L.) Vahl	Plantae|Magnoliophyta|Liliopsida|Poales|Cyperaceae|Fimbristylis|ferruginea|Fimbristylis ferruginea (L.) Vahl	1
Conus infinitus Rolán, 1990	Animalia|Mollusca|Gastropoda|Neogastropoda|Conidae|Conus|infinitus|Conus infinitus Rolán, 1990	1
Asteriscus vogelii (Webb) Walp.	Plantae|Tracheophyta|Magnoliopsida|Asterales|Asteraceae|Nauplius|vogelii|Asteriscus vogelii (Webb) Walp.	1
Laevicardium oblongum senegalense (Dautzenberg, 1891)	Animalia|Mollusca|Bivalvia|Veneroida|Cardiidae|Laevicardium|oblongum|Laevicardium oblongum senegalense (Dautzenberg, 1891)	1
Rhizoclonium Kützing, 1843	Plantae|Chlorophyta|Ulvophyceae|Cladophorales|Cladophoraceae|Rhizoclonium||Rhizoclonium Kützing, 1843	1
Bostrycapulus tegulicius (Rochebrune, 1883)	Animalia|Mollusca|Gastropoda|Neotaenioglossa|Calyptraeidae|Bostrycapulus|tegulicius|Bostrycapulus tegulicius (Rochebrune, 1883)	1
Tricholaena teneriffae Parl.	Plantae|Tracheophyta|Liliopsida|Poales|Poaceae|Tricholaena|teneriffae|Tricholaena teneriffae Parl.	1
Conus taslei Kiener, 1850	Animalia|Mollusca|Gastropoda|Neogastropoda|Conidae|Conus|taslei|Conus taslei Kiener, 1850	1
Eleusine indica (L.) Gaertn.	Plantae|Tracheophyta|Liliopsida|Poales|Poaceae|Eleusine|indica|Eleusine indica (L.) Gaertn.	1
Wrangelia argus (Montagne) Montagne, 1856	Plantae|Rhodophyta|Florideophyceae|Ceramiales|Wrangeliaceae|Wrangelia|argus|Wrangelia argus (Montagne) Montagne, 1856	1
Conus calhetae Rolán, 1990	Animalia|Mollusca|Gastropoda|Neogastropoda|Conidae||calhetae|Conus calhetae Rolán, 1990	1
Arthraxon lancifolius (Trin.) Hochst.	Plantae|Tracheophyta|Liliopsida|Poales|Poaceae|Arthraxon|lancifolius|Arthraxon lancifolius (Trin.) Hochst.	1
Asparagopsis taxiformis (Delile) Trevisan de Saint-Léon	Plantae|Rhodophyta|Florideophyceae|Bonnemaisoniales|Bonnemaisoniaceae|Asparagopsis|taxiformis|Asparagopsis taxiformis (Delile) Trevisan de Saint-Léon	1
Codium taylorii P.C. Silva	Plantae|Chlorophyta|Bryopsidophyceae|Bryopsidales|Codiaceae|Codium|taylorii|Codium taylorii P.C. Silva	1
Alvania hoeksemai Hoenselaar & Goud, 1998	Animalia|Mollusca|Gastropoda|Neotaenioglossa|Rissoidae|Alvania|hoeksemai|Alvania hoeksemai Hoenselaar & Goud, 1998	1
Monophorus verdensis Fernandes & Rolán, 1988	Animalia|Mollusca|Gastropoda||Triphoridae|Monophorus|verdensis|Monophorus verdensis Fernandes & Rolán, 1988	1
Peneroplis de Montfort, 1808	Protozoa||Granuloreticulosea|Foraminiferida|Soritidae|Peneroplis||Peneroplis de Montfort, 1808	1
Caulerpella ambigua (Okamura) Prud'homme van Reine & Lokhorst	Plantae|Chlorophyta|Bryopsidophyceae|Bryopsidales|Caulerpaceae|Caulerpella|ambigua|Caulerpella ambigua (Okamura) Prud'homme van Reine & Lokhorst	1
Adansonia digitata L.	Plantae|Tracheophyta|Magnoliopsida|Malvales|Malvaceae|Adansonia|digitata|Adansonia digitata L.	1
Conus hybridus Kiener, 1845	Animalia|Mollusca|Gastropoda|Neogastropoda|Conidae||hybridus|Conus hybridus Kiener, 1845	1
Conus messiasi Rolán & Fernandes, 1990	Animalia|Mollusca|Gastropoda|Neogastropoda|Conidae|Conus|messiasi|Conus messiasi Rolán & Fernandes, 1990	1
Cheilanthes marantae Domin	Plantae|Pteridophyta|Polypodiopsida|Polypodiales|Hemionitidaceae|Paragymnopteris|marantae|Cheilanthes marantae Domin	1
Cypraea pulchra Gray, 1824	Animalia|Mollusca|Gastropoda|Neotaenioglossa|Cypraeidae|Luria|pulchra|Cypraea pulchra Gray, 1824	1
Tamarix senegalensis DC.	Plantae|Magnoliophyta|Magnoliopsida|Caryophyllales|Tamaricaceae|Tamarix|senegalensis|Tamarix senegalensis DC.	1
Phaethon aethereus Linnaeus, 1758	Animalia|Chordata|Aves|Phaethontiformes|Phaethontidae|Phaethon|aethereus|Phaethon aethereus Linnaeus, 1758	1
Melanagromyza nicolaudis Spencer, 1959	Animalia|Arthropoda|Insecta|Diptera|Agromyzidae|Melanagromyza|nicolaudis|Melanagromyza nicolaudis Spencer, 1959	1
Lecanora Ach.	Fungi|Ascomycota|Lecanoromycetes|Lecanorales|Lecanoraceae|Lecanora||Lecanora Ach.	1
Hemidactylus angulatus Hallowell, 1854	Animalia|Chordata|Reptilia|Squamata|Gekkonidae|Hemidactylus|angulatus|Hemidactylus angulatus Hallowell, 1854	1
Pseudogloiophloea Levring, 1956	Plantae|Rhodophyta|Florideophyceae|Nemaliales|Scinaiaceae|Scinaia||Pseudogloiophloea Levring, 1956	1
Adiantum incisum C.Presl	Plantae|Pteridophyta|Polypodiopsida|Polypodiales|Pteridaceae|Adiantum|incisum|Adiantum incisum C.Presl	1
Roccella phycopsis Ach.	Fungi|Ascomycota|Arthoniomycetes|Arthoniales|Roccellaceae|Rocella|phycopsis|Roccella phycopsis Ach.	1
Calyptraea helicoidea Sowerby, 1883	Animalia|Mollusca|Gastropoda|Neotaenioglossa|Calyptraeidae|Calyptraea|helicoidea|Calyptraea helicoidea Sowerby, 1883	1
Roccella phycopsis Ach.	Fungi|Ascomycota|Arthoniomycetes|Arthoniales|Roccellaceae|Roccella|phycopsis|Roccella phycopsis Ach.	1
Sehima ischaemoides Forssk.	Plantae|Tracheophyta|Liliopsida|Poales|Poaceae|Sehima|ischaemoides|Sehima ischaemoides Forssk.	1
Schwartziella sulcostriata Rolán & Luque, 2000	Animalia|Mollusca|Gastropoda|Littorinimorpha|Rissoidae|Schwartziella|sulcostriata|Schwartziella sulcostriata Rolán & Luque, 2000	1
Amphiroa beauvoisii J.V.Lamouroux, 1816	Plantae|Rhodophyta|Florideophyceae|Corallinales|Corallinaceae|Amphiroa|beauvoisii|Amphiroa beauvoisii J.V.Lamouroux, 1816	1
Phoenix Linnaeus, 1753	Plantae|Magnoliophyta|Liliopsida|Arecales|Arecaceae|Phoenix||Phoenix Linnaeus, 1753	1
Botryphallus tuber (Rolán, 1991)	Animalia|Mollusca|Gastropoda|Neotaenioglossa|Rissoidae|Botryphallus|tuber|Botryphallus tuber (Rolán, 1991)	1
Tephromela atra (Huds.) Hafellner, 1983	Fungi|Ascomycota|Lecanoromycetes|Lecanorales|Mycoblastaceae|Tephromela|atra|Tephromela atra (Huds.) Hafellner, 1983	1
Elionurus royleanus Nees ex A.Rich.	Plantae|Magnoliophyta|Liliopsida|Poales|Poaceae|Elionurus|royleanus|Elionurus royleanus Nees ex A.Rich.	1
Ixobrychus minutus (Linnaeus, 1766)	Animalia|Chordata|Aves|Pelecaniformes|Ardeidae|Ixobrychus|minutus|Ixobrychus minutus (Linnaeus, 1766)	1
Tamarix gallica L.	Plantae|Magnoliophyta|Magnoliopsida|Caryophyllales|Tamaricaceae|Tamarix|gallica|Tamarix gallica L.	1
Davallia canariensis (L.) Sm.	Plantae|Pteridophyta|Polypodiopsida|Polypodiales|Davalliaceae|Davallia|canariensis|Davallia canariensis (L.) Sm.	1
Spyridia hypnoides (Bory de Saint-Vincent) Papenfuss	Plantae|Rhodophyta|Florideophyceae|Ceramiales|Ceramiaceae|Spyridia|hypnoides|Spyridia hypnoides (Bory de Saint-Vincent) Papenfuss	1
Anas querquedula Linnaeus, 1758	Animalia|Chordata|Aves|Anseriformes|Anatidae|Anas|querquedula|Anas querquedula Linnaeus, 1758	1
Coleoptera	Animalia|Arthropoda|Insecta|Coleoptera||||Coleoptera	1
Schwartziella robusta Rolán & Luque, 2000	Animalia|Mollusca|Gastropoda|Neotaenioglossa|Rissoidae|Schwartziella|robusta|Schwartziella robusta Rolán & Luque, 2000	1
Enteropogon rupestris (J.A.Schmidt) A.Chev.	Plantae|Tracheophyta|Liliopsida|Poales|Poaceae|Enteropogon|rupestris|Enteropogon rupestris (J.A.Schmidt) A.Chev.	1
Frankenia ericifolia C.Sm. ex DC.	Plantae|Tracheophyta|Magnoliopsida|Caryophyllales|Frankeniaceae|Frankenia|ericifolia|Frankenia ericifolia C.Sm. ex DC.	1
Conus saragasae Rolán, 1986	Animalia|Mollusca|Gastropoda|Neogastropoda|Conidae|Conus|saragasae|Conus saragasae Rolán, 1986	1
Tyto alba subsp. detorta Hartert, 1913	Animalia|Chordata|Aves|Strigiformes|Tytonidae|Tyto|alba|Tyto alba subsp. detorta Hartert, 1913	1
Discorbina turbo (d'Orbigny, 1826)	Chromista|Foraminifera|Globothalamea|Rotaliida|Discorbidae|Trochulina|turbo|Discorbina turbo (d'Orbigny, 1826)	1
Dactyloctenium aegyptium (L.) Willd.	Plantae|Tracheophyta|Liliopsida|Poales|Poaceae|Dactyloctenium|aegyptium|Dactyloctenium aegyptium (L.) Willd.	1
Digitaria ciliaris (Retz.) Koeler	Plantae|Tracheophyta|Liliopsida|Poales|Poaceae|Digitaria|ciliaris|Digitaria ciliaris (Retz.) Koeler	1
Enneapogon brachystachyus (Jaub. & Spach) Stapf	Plantae|Magnoliophyta|Liliopsida|Poales|Poaceae|Enneapogon|brachystachyus|Enneapogon brachystachyus (Jaub. & Spach) Stapf	1
Euphorbia heterophylla L.	Plantae|Tracheophyta|Magnoliopsida|Malpighiales|Euphorbiaceae|Euphorbia|heterophylla|Euphorbia heterophylla L.	1
Rottboellia L. f.	Plantae|Tracheophyta|Liliopsida|Poales|Poaceae|Rottboellia||Rottboellia L. f.	1
Panicum maximum Jacq.	Plantae|Magnoliophyta|Liliopsida|Poales|Poaceae|Panicum|maximum|Panicum maximum Jacq.	1
Asplenium trichomanes L.	Plantae|Pteridophyta|Polypodiopsida|Polypodiales|Aspleniaceae|Asplenium|trichomanes|Asplenium trichomanes L.	1
Solanum L.	Plantae|Tracheophyta|Magnoliopsida|Solanales|Solanaceae|Solanum||Solanum L.	1
Herposiphonia tenella (C.Agardh) Ambronn, 1880	Plantae|Rhodophyta|Florideophyceae|Ceramiales|Rhodomelaceae|Herposiphonia|tenella|Herposiphonia tenella (C.Agardh) Ambronn, 1880	1
Caulerpa webbiana Montagne, 1837	Plantae|Chlorophyta|Ulvophyceae|Bryopsidales|Caulerpaceae|Caulerpa|webbiana|Caulerpa webbiana Montagne, 1837	1
Helminthocladia calvadosii (J.V. Lamouroux ex Duby) Setchell	Plantae|Rhodophyta|Florideophyceae|Nemaliales|Liagoraceae|Helminthocladia|calvadosii|Helminthocladia calvadosii (J.V. Lamouroux ex Duby) Setchell	1
Chnoospora fastigiata J.Agardh, 1848	Chromista|Ochrophyta|Phaeophyceae|Scytosiphonales|Scytosiphonaceae|Chnoospora|fastigiata|Chnoospora fastigiata J.Agardh, 1848	1
Lucina adansoni (d'Orbigny, 1839)	Animalia|Mollusca|Bivalvia|Veneroida|Lucinidae|Lucina|adansoni|Lucina adansoni (d'Orbigny, 1839)	1
Rhodophyceae	Plantae|Rhodophyta|Rhodophyceae|||||Rhodophyceae	1
Pennisetum polystachyon (L.) J.A. Schultes	Plantae|Magnoliophyta|Liliopsida|Poales|Poaceae|Cenchrus|polystachyon|Pennisetum polystachyon (L.) J.A. Schultes	1
Phaiogramma faustinata vermiculata (Warren, 1897)	Animalia|Arthropoda|Insecta|Lepidoptera|Geometridae|Phaiogramma|faustinata|Phaiogramma faustinata vermiculata (Warren, 1897)	1
Natica turtoni E.A. Smith, 1890	Animalia|Mollusca|Gastropoda|Neotaenioglossa|Naticidae|Natica|turtoni|Natica turtoni E.A. Smith, 1890	1
Agaronia acuminata subsp. boavistensis (Burnay & Conceicao, 1986)	Animalia|Mollusca|Gastropoda|Neogastropoda|Olividae|Agaronia|acuminata|Agaronia acuminata subsp. boavistensis (Burnay & Conceicao, 1986)	1
Salicornia Linnaeus, 1753	Plantae|Magnoliophyta|Magnoliopsida|Caryophyllales|Chenopodiaceae|Salicornia||Salicornia Linnaeus, 1753	1
Halydictyon mirabile Zanardini	Plantae|Rhodophyta|Florideophyceae|Ceramiales|Dasyaceae|Halydictyon|mirabile|Halydictyon mirabile Zanardini	1
Cyathus Persoon, 1801	Fungi|Basidiomycota|Agaricomycetes|Agaricales|Agaricaceae|Cyathus||Cyathus Persoon, 1801	1
Cyathus Haller	Fungi|Basidiomycota|Agaricomycetes|Agaricales|Agaricaceae|Cyathus||Cyathus Haller	1
Volvarina verdensis (E. A. Smith, 1875)	Animalia|Mollusca|Gastropoda|Neogastropoda|Marginellidae|Volvarina|verdensis|Volvarina verdensis (E. A. Smith, 1875)	1
Tripogon multiflorus Mire & H.Gillet	Plantae|Magnoliophyta|Liliopsida|Poales|Poaceae|Tripogon|multiflorus|Tripogon multiflorus Mire & H.Gillet	1
Charadrius dubius Scopoli, 1786	Animalia|Chordata|Aves|Charadriiformes|Charadriidae|Charadrius|dubius|Charadrius dubius Scopoli, 1786	1
Launaea arborescens (Batt.) Murb.	Plantae|Magnoliophyta|Magnoliopsida|Asterales|Asteraceae|Launaea|arborescens|Launaea arborescens (Batt.) Murb.	1
Schwartziella luisi Rolán & Luque, 2000	Animalia|Mollusca|Gastropoda|Littorinimorpha|Rissoidae|Schwartziella|luisi|Schwartziella luisi Rolán & Luque, 2000	1
Bactrocera invadens Drew, Tsuruta & White, 2005	Animalia|Arthropoda|Insecta|Diptera|Tephritidae|Bactrocera|invadens|Bactrocera invadens Drew, Tsuruta & White, 2005	1
Cyperus maritimus Poir.	Plantae|Tracheophyta|Liliopsida|Poales|Cyperaceae|Cyperus|maritimus|Cyperus maritimus Poir.	1
Lycopodium cernuum L.	Plantae|Tracheophyta|Lycopodiopsida|Lycopodiales|Lycopodiaceae|Palhinhaea|cernuum|Lycopodium cernuum L.	1
Triphoridae	Animalia|Mollusca|Gastropoda||Triphoridae|||Triphoridae	1
Cypraea spurca Linnaeus, 1758	Animalia|Mollusca|Gastropoda|Littorinimorpha|Cypraeidae|Erosaria|spurca|Cypraea spurca Linnaeus, 1758	1
Cosmotriphora melanura (C. B. Adams, 1850)	Animalia|Mollusca|Gastropoda||Triphoridae|Cosmotriphora|melanura|Cosmotriphora melanura (C. B. Adams, 1850)	1
Tephromela atra (Huds.) Hafellner	Fungi|Ascomycota|Lecanoromycetes|Lecanorales|Mycoblastaceae|Tephromela|atra|Tephromela atra (Huds.) Hafellner	1
Schmidtia pappophoroides Steud. ex J.A.Schmidt	Plantae|Magnoliophyta|Liliopsida|Poales|Poaceae|Schmidtia|pappophoroides|Schmidtia pappophoroides Steud. ex J.A.Schmidt	1
Isturgia catalaunaria (Guenee, 1858)	Animalia|Arthropoda|Insecta|Lepidoptera|Geometridae|Isturgia|catalaunaria|Isturgia catalaunaria (Guenee, 1858)	1
Conus raulsilvai Rolán, Monteiro & Fernandes, 1998	Animalia|Mollusca|Gastropoda|Neogastropoda|Conidae||raulsilvai|Conus raulsilvai Rolán, Monteiro & Fernandes, 1998	1
Dictyota J.V.F. Lamouroux, 1809	Chromista|Ochrophyta|Phaeophyceae|Dictyotales|Dictyotaceae|Dictyota||Dictyota J.V.F. Lamouroux, 1809	1
Rhizoclonium Kuetzing, 1843	Plantae|Chlorophyta|Ulvophyceae|Cladophorales|Cladophoraceae|Rhizoclonium||Rhizoclonium Kuetzing, 1843	1
Turdus merula subsp. cabrerae	Animalia|Chordata|Aves|Passeriformes|Turdidae|Turdus|merula|Turdus merula subsp. cabrerae	1
Arthrocnemum macrostachyum (Moric.) Moris	Plantae|Tracheophyta|Magnoliopsida|Caryophyllales|Amaranthaceae|Arthrocnemum|macrostachyum|Arthrocnemum macrostachyum (Moric.) Moris	1
Monophorus verdensis Fernandes & Rolán, 1988	Animalia|Mollusca|Gastropoda|Neotaenioglossa|Triphoridae|Monophorus|verdensis|Monophorus verdensis Fernandes & Rolán, 1988	1
Stramonita haemastoma (Linnaeus, 1758)	Animalia|Mollusca|Gastropoda|Neogastropoda||Stramonita|haemastoma|Stramonita haemastoma (Linnaeus, 1758)	1
Tephritidae Newman, 1834	Animalia|Arthropoda|Insecta|Diptera|Tephritidae|||Tephritidae Newman, 1834	1
Sorghum halepense (L.) Pers.	Plantae|Magnoliophyta|Liliopsida|Poales|Poaceae|Sorghum|halepense|Sorghum halepense (L.) Pers.	1
Leptochloa panicea (Retz.) Ohwi	Plantae|Tracheophyta|Liliopsida|Poales|Poaceae|Leptochloa|panicea|Leptochloa panicea (Retz.) Ohwi	1
Eretmochelys imbricata (Linnaeus, 1766)	Animalia|Chordata|Reptilia|Testudines|Cheloniidae|Eretmochelys|imbricata|Eretmochelys imbricata (Linnaeus, 1766)	1
Platybelone argalus lovii (Günther, 1866)	Animalia|Chordata|Actinopterygii|Beloniformes|Belonidae|Platybelone|argalus|Platybelone argalus lovii (Günther, 1866)	1
Panicum maximum Jacq.	Plantae|Tracheophyta|Liliopsida|Poales|Poaceae|Panicum|maximum|Panicum maximum Jacq.	1
Laevicardium oblongum subsp. senegalense (Dautzenberg, 1891)	Animalia|Mollusca|Bivalvia|Veneroida|Cardiidae|Laevicardium|oblongum|Laevicardium oblongum subsp. senegalense (Dautzenberg, 1891)	1
Portulaca oleracea L.	Plantae|Magnoliophyta|Magnoliopsida|Caryophyllales|Portulacaceae|Portulaca|oleracea|Portulaca oleracea L.	1
Conus tabidus Reeve, 1844	Animalia|Mollusca|Gastropoda|Neogastropoda|Conidae||tabidus|Conus tabidus Reeve, 1844	1
Biloculina depressa (d'Orbigny, 1826)	Protozoa||Granuloreticulosea|Foraminiferida|Miliolidae|Pyrgo|depressa|Biloculina depressa (d'Orbigny, 1826)	1
Forsskaolea procridifolia Webb	Plantae|Magnoliophyta|Magnoliopsida|Rosales|Urticaceae|Forsskaolea|procridifolia|Forsskaolea procridifolia Webb	1
Oplismenus burmannii (Retz.) P.Beauv.	Plantae|Magnoliophyta|Liliopsida|Poales|Poaceae|Oplismenus|burmannii|Oplismenus burmannii (Retz.) P.Beauv.	1
Nemastoma J.Agardh, 1842	Plantae|Rhodophyta|Florideophyceae|Nemastomatales|Nemastomataceae|Nemastoma||Nemastoma J.Agardh, 1842	1
Asplenium adiantum-nigrum L.	Plantae|Pteridophyta|Polypodiopsida|Polypodiales|Aspleniaceae|Asplenium|adiantum-nigrum|Asplenium adiantum-nigrum L.	1
Phacopsis rufa (Müll. Arg.) Triebel	Fungi|Ascomycota|Lecanoromycetes|Lecanorales|Parmeliaceae|Phacopsis|rufa|Phacopsis rufa (Müll. Arg.) Triebel	1
Myrica faya (Dryand.) Ait.	Plantae|Tracheophyta|Magnoliopsida|Fagales|Myricaceae|Morella|faya|Myrica faya (Dryand.) Ait.	1
Cypraea spurca Linnaeus, 1758	Animalia|Mollusca|Gastropoda|Neotaenioglossa|Cypraeidae|Cypraea|spurca|Cypraea spurca Linnaeus, 1758	1
Cypraecassis testiculus senegalica (Gmelin, 1791)	Animalia|Mollusca|Gastropoda|Neotaenioglossa|Cassidae|Cypraecassis|testiculus|Cypraecassis testiculus senegalica (Gmelin, 1791)	1
Laurencia viridis Gil-Rodríguez & Haroun, 1992	Plantae|Rhodophyta|Florideophyceae|Ceramiales|Rhodomelaceae|Laurencia|viridis|Laurencia viridis Gil-Rodríguez & Haroun, 1992	1
Barleeia aemilii Gofas, 1995	Animalia|Mollusca|Gastropoda|Littorinimorpha|Barleeiidae|Barleeia|aemilii|Barleeia aemilii Gofas, 1995	1
Codium taylorii P.C.Silva, 1960	Plantae|Chlorophyta|Ulvophyceae|Bryopsidales|Codiaceae|Codium|taylorii|Codium taylorii P.C.Silva, 1960	1
Gossypium hirsutum L.	Plantae|Magnoliophyta|Magnoliopsida|Malvales|Malvaceae|Gossypium|hirsutum|Gossypium hirsutum L.	1
Cypraea Linnaeus, 1758	Animalia|Mollusca|Gastropoda|Neotaenioglossa|Cypraeidae|Cypraea||Cypraea Linnaeus, 1758	1
Euphorbia tuckeyana Steud. ex Webb	Plantae|Magnoliophyta|Magnoliopsida|Malpighiales|Euphorbiaceae|Euphorbia|tuckeyana|Euphorbia tuckeyana Steud. ex Webb	1
Lagena botelliformis Brady, 1881	Chromista|Foraminifera||Lagenida|Ellipsolagenidae|Parafissurina|botelliformis|Lagena botelliformis Brady, 1881	1
Hemiptera	Animalia|Arthropoda|Insecta|Hemiptera||||Hemiptera	1
Platybelone argalus (Lesueur, 1821)	Animalia|Chordata|Actinopterygii|Beloniformes|Belonidae|Platybelone|argalus|Platybelone argalus (Lesueur, 1821)	1
Digitaria ciliaris (Retz.) Koeler	Plantae|Magnoliophyta|Liliopsida|Poales|Poaceae|Digitaria|ciliaris|Digitaria ciliaris (Retz.) Koeler	1
Anas crecca Linnaeus, 1758	Animalia|Chordata|Aves|Anseriformes|Anatidae|Anas|crecca|Anas crecca Linnaeus, 1758	1
Strumigenys Smith, 1860	Animalia|Arthropoda|Insecta|Hymenoptera|Formicidae|Strumigenys||Strumigenys Smith, 1860	1
Turbonilla kerstinae Schander, 1994	Animalia|Mollusca|Gastropoda||Pyramidellidae|Turbonilla|kerstinae|Turbonilla kerstinae Schander, 1994	1
Coleoptera Linnaeus, 1758	Animalia|Arthropoda|Insecta|Coleoptera||||Coleoptera Linnaeus, 1758	1
Amaranthus graecizans subsp. sylvestris (Vill.) Brenan	Plantae|Tracheophyta|Magnoliopsida|Caryophyllales|Amaranthaceae|Amaranthus|graecizans|Amaranthus graecizans subsp. sylvestris (Vill.) Brenan	1
Dichanthium annulatum (Forssk.) Stapf	Plantae|Tracheophyta|Liliopsida|Poales|Poaceae|Dichanthium|annulatum|Dichanthium annulatum (Forssk.) Stapf	1
Wrangelia penicillata (C.Agardh) C.Agardh, 1828	Plantae|Rhodophyta|Florideophyceae|Ceramiales|Wrangeliaceae|Wrangelia|penicillata|Wrangelia penicillata (C.Agardh) C.Agardh, 1828	1
Puffinus lherminieri Lesson, 1839	Animalia|Chordata|Aves|Procellariiformes|Procellariidae|Puffinus|lherminieri|Puffinus lherminieri Lesson, 1839	1
Subulinidae P. Fischer & Crosse, 1877	Animalia|Mollusca|Gastropoda|Stylommatophora|Subulinidae|||Subulinidae P. Fischer & Crosse, 1877	1
Thais nodosa Linnaeus, 1758	Animalia|Mollusca|Gastropoda|Neogastropoda||Thais|nodosa|Thais nodosa Linnaeus, 1758	1
Asphodelus tenuifolius Cav.	Plantae|Tracheophyta|Liliopsida|Asparagales|Xanthorrhoeaceae|Asphodelus|tenuifolius|Asphodelus tenuifolius Cav.	1
Africonus borgesi (Trovão, 1979)	Animalia|Mollusca|Gastropoda|Neogastropoda|Conidae||borgesi|Africonus borgesi (Trovão, 1979)	1
Fimbristylis sieberiana Kunth	Plantae|Tracheophyta|Liliopsida|Poales|Cyperaceae|Fimbristylis|sieberiana|Fimbristylis sieberiana Kunth	1
Cyperus esculentus L.	Plantae|Tracheophyta|Liliopsida|Poales|Cyperaceae|Cyperus|esculentus|Cyperus esculentus L.	1
Prosopis juliflora (Sw.) DC.	Plantae|Magnoliophyta|Magnoliopsida|Fabales|Fabaceae|Prosopis|juliflora|Prosopis juliflora (Sw.) DC.	1
Peyssonnelia Decaisne, 1841	Plantae|Rhodophyta|Florideophyceae|Peyssonneliales|Peyssonneliaceae|Peyssonnelia||Peyssonnelia Decaisne, 1841	1
Alvania tenhovei Hoenselaar & Goud, 1998	Animalia|Mollusca|Gastropoda|Neotaenioglossa|Rissoidae|Alvania|tenhovei|Alvania tenhovei Hoenselaar & Goud, 1998	1
Bothriochloa pertusa (L.) A.Camus	Plantae|Magnoliophyta|Liliopsida|Poales|Poaceae|Bothriochloa|pertusa|Bothriochloa pertusa (L.) A.Camus	1
Milvus migrans (Boddaert, 1783)	Animalia|Chordata|Aves|Accipitriformes|Accipitridae|Milvus|migrans|Milvus migrans (Boddaert, 1783)	1
Strumigenys membranifera Emery, 1869	Animalia|Arthropoda|Insecta|Hymenoptera|Formicidae|Pyramica|membranifera|Strumigenys membranifera Emery, 1869	1
Diplodus sargus lineatus (Valenciennes, 1830)	Animalia|Chordata|Actinopterygii|Perciformes|Sparidae|Diplodus|sargus|Diplodus sargus lineatus (Valenciennes, 1830)	1
Barleeia chefiae Gofas, 1995	Animalia|Mollusca|Gastropoda|Littorinimorpha|Barleeiidae|Barleeia|chefiae|Barleeia chefiae Gofas, 1995	1
Lycopersicon esculentum Mill.	Plantae|Magnoliophyta|Magnoliopsida|Solanales|Solanaceae|Solanum|esculentum|Lycopersicon esculentum Mill.	1
Diplodus sargus subsp. lineatus (Valenciennes, 1830)	Animalia|Chordata|Actinopterygii|Perciformes|Sparidae|Diplodus|sargus|Diplodus sargus subsp. lineatus (Valenciennes, 1830)	1
Frankenia ericifolia Salisb.	Plantae|Magnoliophyta|Magnoliopsida|Caryophyllales|Frankeniaceae|Frankenia|ericifolia|Frankenia ericifolia Salisb.	1
Artemisia gorgonum Webb	Plantae|Magnoliophyta|Magnoliopsida|Asterales|Asteraceae|Artemisia|gorgonum|Artemisia gorgonum Webb	1
Scopalina Schmidt, 1862	Animalia|Porifera|Demospongiae|Scopalinida|Scopalinidae|Scopalina||Scopalina Schmidt, 1862	1
Setaria barbata (Lam.) Kunth	Plantae|Tracheophyta|Liliopsida|Poales|Poaceae|Setaria|barbata|Setaria barbata (Lam.) Kunth	1
Cheilopogon pinnatibarbatus subsp. pinnatibarbatus	Animalia|Chordata|Actinopterygii|Beloniformes|Exocoetidae|Cheilopogon|pinnatibarbatus|Cheilopogon pinnatibarbatus subsp. pinnatibarbatus	1
Crisilla orteai Templado & Rolán, 1994	Animalia|Mollusca|Gastropoda|Neotaenioglossa|Rissoidae|Crisilla|orteai|Crisilla orteai Templado & Rolán, 1994	1
Glycymeris formosa (Reeve, 1843)	Animalia|Mollusca|Bivalvia|Arcoida|Glycymerididae|Glycymeris|formosa|Glycymeris formosa (Reeve, 1843)	1
Tyto alba schmitzi (Hartert, 1900)	Animalia|Chordata|Aves|Strigiformes|Tytonidae|Tyto|alba|Tyto alba schmitzi (Hartert, 1900)	1
Lycopersicon esculentum Mill.	Plantae|Tracheophyta|Magnoliopsida|Solanales|Solanaceae|Solanum|esculentum|Lycopersicon esculentum Mill.	1
Ralfsia expansa (J. Agardh) J. Agardh	Chromista|Ochrophyta|Phaeophyceae|Ectocarpales|Ralfsiaceae|Ralfsia|expansa|Ralfsia expansa (J. Agardh) J. Agardh	1
Pennisetum polystachion (L.) Schult.	Plantae|Tracheophyta|Liliopsida|Poales|Poaceae|Pennisetum|polystachion|Pennisetum polystachion (L.) Schult.	1
Falco tinnunculus canariensis (Koenig, 1890)	Animalia|Chordata|Aves|Falconiformes|Falconidae|Falco|tinnunculus|Falco tinnunculus canariensis (Koenig, 1890)	1
Vanessa cardui (Linnaeus, 1758)	Animalia|Arthropoda|Insecta|Lepidoptera|Nymphalidae|Vanessa|cardui|Vanessa cardui (Linnaeus, 1758)	1
Pennisetum pedicellatum subsp. unispiculum	Plantae|Magnoliophyta|Liliopsida|Poales|Poaceae|Pennisetum|pedicellatum|Pennisetum pedicellatum subsp. unispiculum	1
Sinapidendron vogelii Webb	Plantae|Magnoliophyta|Magnoliopsida|Brassicales|Brassicaceae|Diplotaxis|vogelii|Sinapidendron vogelii Webb	1
Tragus racemosus (L.) All.	Plantae|Tracheophyta|Liliopsida|Poales|Poaceae|Tragus|racemosus|Tragus racemosus (L.) All.	1
Scopalina Schmidt, 1862	Animalia|Porifera|Demospongiae|Halichondrida|Scopalinidae|Scopalina||Scopalina Schmidt, 1862	1
Ischnochiton cessaci (Rochebrune, 1881)	Animalia|Mollusca|Polyplacophora|Chitonida|Ischnochitonidae|Ischnochiton|cessaci|Ischnochiton cessaci (Rochebrune, 1881)	1
Ernodesmis verticillata (Kützing) Børgesen, 1912	Plantae|Chlorophyta|Ulvophyceae|Siphonocladales|Siphonocladaceae|Ernodesmis|verticillata|Ernodesmis verticillata (Kützing) Børgesen, 1912	1
Stramonita haemastoma (Linnaeus, 1767)	Animalia|Mollusca|Gastropoda|Neogastropoda|Muricidae|Stramonita|haemastoma|Stramonita haemastoma (Linnaeus, 1767)	1
Biloculina depressa d'Orbigny, 1826	Chromista|Foraminifera|Tubothalamea|Miliolida|Hauerinidae|Pyrgo|depressa|Biloculina depressa d'Orbigny, 1826	1
Lampides boeticus (Linnaeus, 1767)	Animalia|Arthropoda|Insecta|Lepidoptera|Lycaenidae|Lampides|boeticus|Lampides boeticus (Linnaeus, 1767)	1
Calidris fuscicollis (Vieillot, 1819)	Animalia|Chordata|Aves|Charadriiformes|Scolopacidae|Calidris|fuscicollis|Calidris fuscicollis (Vieillot, 1819)	1
Barleeia aemilii Gofas, 1995	Animalia|Mollusca|Gastropoda|Neotaenioglossa|Barleeiidae|Barleeia|aemilii|Barleeia aemilii Gofas, 1995	1
Eragrostis cilianensis (All.) Janch.	Plantae|Magnoliophyta|Liliopsida|Poales|Poaceae|Eragrostis|cilianensis|Eragrostis cilianensis (All.) Janch.	1
Digitaria nuda Schumach.	Plantae|Magnoliophyta|Liliopsida|Poales|Poaceae|Digitaria|nuda|Digitaria nuda Schumach.	1
Tricholaena teneriffae (L.f.) Link	Plantae|Tracheophyta|Liliopsida|Poales|Poaceae|Tricholaena|teneriffae|Tricholaena teneriffae (L.f.) Link	1
Laurencia viridis Gil-Rodríguez & Haroun	Plantae|Rhodophyta|Florideophyceae|Ceramiales|Rhodomelaceae|Laurencia|viridis|Laurencia viridis Gil-Rodríguez & Haroun	1
Gibbula verdensis Rolán & Templado, 2001	Animalia|Mollusca|Gastropoda|Archaeogastropoda|Trochidae|Gibbula|verdensis|Gibbula verdensis Rolán & Templado, 2001	1
Siphonaria pectinata (Linnaeus, 1758)	Animalia|Mollusca|Gastropoda||Siphonariidae|Siphonaria|pectinata|Siphonaria pectinata (Linnaeus, 1758)	1
Discorbina turbo (d'Orbigny, 1826)	Protozoa||Granuloreticulosea|Foraminiferida|Discorbidae|Discorbina|turbo|Discorbina turbo (d'Orbigny, 1826)	1
Eragrostis cilianensis (All.) Janch.	Plantae|Tracheophyta|Liliopsida|Poales|Poaceae|Poa|cilianensis|Eragrostis cilianensis (All.) Janch.	1
Eatonina vermeuleni Moolenbeek, 1986	Animalia|Mollusca|Gastropoda|Mesogastropoda|Cingulopsidae|Eatonina|vermeuleni|Eatonina vermeuleni Moolenbeek, 1986	1
Andrachne telephioides var. rotundifolia	Plantae|Magnoliophyta|Magnoliopsida|Malpighiales|Phyllanthaceae|Andrachne|telephioides|Andrachne telephioides var. rotundifolia	1
Cheilanthes marantae (L.) Domin	Plantae|Tracheophyta|Polypodiopsida|Polypodiales|Pteridaceae|Paragymnopteris|marantae|Cheilanthes marantae (L.) Domin	1
Cardisoma armatum Herklots, 1851	Animalia|Arthropoda|Malacostraca|Decapoda|Gecarcinidae|Cardisoma|armatum|Cardisoma armatum Herklots, 1851	1
Peneroplis lituus (Gmelin, 1791)	Chromista|Foraminifera|Tubothalamea|Miliolida|Peneroplidae|Monalysidium|lituus|Peneroplis lituus (Gmelin, 1791)	1
Pteridium aquilinum subsp. aquilinum	Plantae|Tracheophyta|Polypodiopsida|Polypodiales|Dennstaedtiaceae|Pteridium|aquilinum|Pteridium aquilinum subsp. aquilinum	1
Arthraxon lancifolius (Trin.) Hochst.	Plantae|Magnoliophyta|Liliopsida|Poales|Poaceae|Arthraxon|lancifolius|Arthraxon lancifolius (Trin.) Hochst.	1
Cinnamomum camphora (L.) J. Presl	Plantae|Tracheophyta|Magnoliopsida|Laurales|Lauraceae|Cinnamomum|camphora|Cinnamomum camphora (L.) J. Presl	1
Caretta caretta (Linnaeus, 1758)	Animalia|Chordata|Reptilia|Testudines|Cheloniidae|Caretta|caretta|Caretta caretta (Linnaeus, 1758)	1
Nassarius caboverdensis (Rolán, 1984)	Animalia|Mollusca|Gastropoda|Neogastropoda|Nassariidae|Tritia|caboverdensis|Nassarius caboverdensis (Rolán, 1984)	1
Gibbula verdensis Rolán & Templado, 2001	Animalia|Mollusca|Gastropoda||Trochidae|Gibbula|verdensis|Gibbula verdensis Rolán & Templado, 2001	1
Muricopsis (Muricopsis) gofasi Houart, 1993	Animalia|Mollusca|Gastropoda|Neogastropoda||Muricopsis|gofasi|Muricopsis (Muricopsis) gofasi Houart, 1993	1
Melanagromyza albisquama (Malloch, 1927)	Animalia|Arthropoda|Insecta|Diptera|Agromyzidae|Melanagromyza|albisquama|Melanagromyza albisquama (Malloch, 1927)	1
Cheilanthes catanensis (Cosent.) H.P.Fuchs	Plantae|Pteridophyta|Polypodiopsida|Polypodiales|Pteridaceae|Cheilanthes|catanensis|Cheilanthes catanensis (Cosent.) H.P.Fuchs	1
Pyrgomorpha conica (Olivier, G.A., 1791)	Animalia|Arthropoda|Insecta|Orthoptera|Pyrgomorphidae|Pyrgomorpha|conica|Pyrgomorpha conica (Olivier, G.A., 1791)	1
Digitaria horizontalis Willd.	Plantae|Tracheophyta|Liliopsida|Poales|Poaceae|Digitaria|horizontalis|Digitaria horizontalis Willd.	1
Adansonia digitata L.	Plantae|Magnoliophyta|Magnoliopsida|Malvales|Malvaceae|Adansonia|digitata|Adansonia digitata L.	1
Zornia diphylla (L.) Pers.	Plantae|Magnoliophyta|Magnoliopsida|Fabales|Fabaceae|Zornia|diphylla|Zornia diphylla (L.) Pers.	1
Potamogeton pusillus L.	Plantae|Tracheophyta|Liliopsida|Alismatales|Potamogetonaceae|Potamogeton|pusillus|Potamogeton pusillus L.	1
Acinetospora crinita (Carmichael) Sauvageau, 1899	Chromista|Ochrophyta|Phaeophyceae|Ectocarpales|Acinetosporaceae|Acinetospora|crinita|Acinetospora crinita (Carmichael) Sauvageau, 1899	1
Tidarren cuneolatum (Tullgren, 1910)	Animalia|Arthropoda|Arachnida|Araneae|Theridiidae|Tidarren|cuneolatum|Tidarren cuneolatum (Tullgren, 1910)	1
Africonus borgesi (Trovão, 1979)	Animalia|Mollusca|Gastropoda|Neogastropoda|Conidae|Conus|borgesi|Africonus borgesi (Trovão, 1979)	1
Conus ambiguus Reeve, 1844	Animalia|Mollusca|Gastropoda|Neogastropoda|Conidae|Conus|ambiguus|Conus ambiguus Reeve, 1844	1
Laurencia majuscula (Harvey) A.H.S. Lucas	Plantae|Rhodophyta|Florideophyceae|Ceramiales|Rhodomelaceae|Laurencia|majuscula|Laurencia majuscula (Harvey) A.H.S. Lucas	1
Andropogon gayanus var. tridentatus Hack.	Plantae|Tracheophyta|Liliopsida|Poales|Poaceae|Andropogon|gayanus|Andropogon gayanus var. tridentatus Hack.	1
Venus verrucosa Linnaeus	Animalia|Mollusca|Bivalvia|Veneroida|Veneridae|Venus|verrucosa|Venus verrucosa Linnaeus	1
Ernodesmis verticillata (Kützing) Børgesen	Plantae|Chlorophyta|Ulvophyceae|Siphonocladales|Valoniaceae|Ernodesmis|verticillata|Ernodesmis verticillata (Kützing) Børgesen	1
Sideroxylon marginatum (Decne. ex Webb) Cout.	Plantae|Tracheophyta|Magnoliopsida|Ericales|Sapotaceae|Sideroxylon|marginatum|Sideroxylon marginatum (Decne. ex Webb) Cout.	1
Heteropogon contortus (L.) P.Beauv. ex Roem. & Schult.	Plantae|Magnoliophyta|Liliopsida|Poales|Poaceae|Heteropogon|contortus|Heteropogon contortus (L.) P.Beauv. ex Roem. & Schult.	1
Convolvulus prostratus F.W.Schmidt	Plantae|Magnoliophyta|Magnoliopsida|Solanales|Convolvulaceae|Convolvulus|prostratus|Convolvulus prostratus F.W.Schmidt	1
Polyphysa parvula (Solms-Laubach) Schnetter & Bula Meyer	Plantae|Chlorophyta|Ulvophyceae|Dasycladales|Polyphysaceae|Parvocaulis|parvula|Polyphysa parvula (Solms-Laubach) Schnetter & Bula Meyer	1
Lampides boeticus Linnaeus, 1767	Animalia|Arthropoda|Insecta|Lepidoptera|Lycaenidae|Lampides|boeticus|Lampides boeticus Linnaeus, 1767	1
Alvania hoeksemai Hoenselaar & Goud, 1998	Animalia|Mollusca|Gastropoda|Littorinimorpha|Rissoidae|Alvania|hoeksemai|Alvania hoeksemai Hoenselaar & Goud, 1998	1
Pennisetum polystachion (L.) Schult.	Plantae|Magnoliophyta|Liliopsida|Poales|Poaceae|Pennisetum|polystachion|Pennisetum polystachion (L.) Schult.	1
Portulaca oleracea L.	Plantae|Tracheophyta|Magnoliopsida|Caryophyllales|Portulacaceae|Portulaca|oleracea|Portulaca oleracea L.	1
Cypraecassis testiculus subsp. senegalica (Gmelin, 1791)	Animalia|Mollusca|Gastropoda|Littorinimorpha|Cassidae|Cypraecassis|testiculus|Cypraecassis testiculus subsp. senegalica (Gmelin, 1791)	1
Diabolocatantops axillaris (Thunberg, 1815)	Animalia|Arthropoda|Insecta|Orthoptera|Acrididae|Diabolocatantops|axillaris|Diabolocatantops axillaris (Thunberg, 1815)	1
Calidris alpina (Linnaeus, 1758)	Animalia|Chordata|Aves|Charadriiformes|Scolopacidae|Calidris|alpina|Calidris alpina (Linnaeus, 1758)	1
Hypnea musciformis (Wulfen) J.V.Lamouroux, 1813	Plantae|Rhodophyta|Florideophyceae|Gigartinales|Cystocloniaceae|Hypnea|musciformis|Hypnea musciformis (Wulfen) J.V.Lamouroux, 1813	1
Amaranthus graecizans subsp. silvestris	Plantae|Magnoliophyta|Magnoliopsida|Caryophyllales|Amaranthaceae|Amaranthus|graecizans|Amaranthus graecizans subsp. silvestris	1
Milvus milvus subsp. fasciicauda Hartert, 1914	Animalia|Chordata|Aves|Accipitriformes|Accipitridae|Milvus|milvus|Milvus milvus subsp. fasciicauda Hartert, 1914	1
Indigofera colutea (Burm. f.) Merr.	Plantae|Tracheophyta|Magnoliopsida|Fabales|Fabaceae|Indigofera|colutea|Indigofera colutea (Burm. f.) Merr.	1
Gyroscala lamellosa (Lamarck, 1822)	Animalia|Mollusca|Gastropoda||Epitoniidae|Epitonium|lamellosa|Gyroscala lamellosa (Lamarck, 1822)	1
Phaiogramma von Gumppenberg, 1887	Animalia|Arthropoda|Insecta|Lepidoptera||Phaiogramma||Phaiogramma von Gumppenberg, 1887	1
Brachiaria ramosa (L.) Stapf	Plantae|Magnoliophyta|Liliopsida|Poales|Poaceae|Brachiaria|ramosa|Brachiaria ramosa (L.) Stapf	1
Asplenium adiantum-nigrum subsp. adiantum-nigrum	Plantae|Tracheophyta|Polypodiopsida|Polypodiales|Aspleniaceae|Asplenium|adiantum-nigrum|Asplenium adiantum-nigrum subsp. adiantum-nigrum	1
Trimusculus mammillaris (Linnaeus, 1758)	Animalia|Mollusca|Gastropoda|Basommatophora|Trimusculidae|Trimusculus|mammillaris|Trimusculus mammillaris (Linnaeus, 1758)	1
Digitaria nuda Schumach.	Plantae|Tracheophyta|Liliopsida|Poales|Poaceae|Digitaria|nuda|Digitaria nuda Schumach.	1
Triphoridae Gray, 1847	Animalia|Mollusca|Gastropoda|Neotaenioglossa|Triphoridae|||Triphoridae Gray, 1847	1
Gossypium hirsutum L.	Plantae|Tracheophyta|Magnoliopsida|Malvales|Malvaceae|Gossypium|hirsutum|Gossypium hirsutum L.	1
Euphorbiaceae Juss.	Plantae|Magnoliophyta|Magnoliopsida|Malpighiales|Euphorbiaceae|||Euphorbiaceae Juss.	1
Nassarius caboverdensis (Rolán, 1984)	Animalia|Mollusca|Gastropoda|Neogastropoda|Nassariidae|Nassarius|caboverdensis|Nassarius caboverdensis (Rolán, 1984)	1
Ricinus communis L.	Plantae|Tracheophyta|Magnoliopsida|Malpighiales|Euphorbiaceae|Ricinus|communis|Ricinus communis L.	1
Euphorbia forsskalii J.Gay	Plantae|Magnoliophyta|Magnoliopsida|Malpighiales|Euphorbiaceae|Euphorbia|forsskalii|Euphorbia forsskalii J.Gay	1
Anacardium occidentale L.	Plantae|Magnoliophyta|Magnoliopsida|Sapindales|Anacardiaceae|Anacardium|occidentale|Anacardium occidentale L.	1
Heterosiphonia crispella (C. Agardh) M.J. Wynne	Plantae|Rhodophyta|Florideophyceae|Ceramiales|Dasyaceae|Heterosiphonia|crispella|Heterosiphonia crispella (C. Agardh) M.J. Wynne	1
Schwartziella robusta Rolán & Luque, 2000	Animalia|Mollusca|Gastropoda|Littorinimorpha|Rissoidae|Schwartziella|robusta|Schwartziella robusta Rolán & Luque, 2000	1
Crisilla orteai Templado & Rolán, 1994	Animalia|Mollusca|Gastropoda|Littorinimorpha|Rissoidae|Crisilla|orteai|Crisilla orteai Templado & Rolán, 1994	1
Setaria barbata (Lam.) Kunth	Plantae|Magnoliophyta|Liliopsida|Poales|Poaceae|Setaria|barbata|Setaria barbata (Lam.) Kunth	1
Hemiptera Linnaeus, 1758	Animalia|Arthropoda|Insecta|Hemiptera||||Hemiptera Linnaeus, 1758	1
Laurencia majuscula (Harvey) A.H.S.Lucas, 1935	Plantae|Rhodophyta|Florideophyceae|Ceramiales|Rhodomelaceae|Laurencia|majuscula|Laurencia majuscula (Harvey) A.H.S.Lucas, 1935	1
Xylocopa calens Lepeletier, 1841	Animalia|Arthropoda|Insecta|Hymenoptera|Apidae|Xylocopa|calens|Xylocopa calens Lepeletier, 1841	1
Agaronia acuminata boavistensis Burnay & Conceicao, 1986	Animalia|Mollusca|Gastropoda|Neogastropoda|Olividae|Agaronia|acuminata|Agaronia acuminata boavistensis Burnay & Conceicao, 1986	1
Aristida funiculata Trin. & Rupr.	Plantae|Magnoliophyta|Liliopsida|Poales|Poaceae|Aristida|funiculata|Aristida funiculata Trin. & Rupr.	1
Larus fuscus Linnaeus, 1758	Animalia|Chordata|Aves|Charadriiformes|Laridae|Larus|fuscus|Larus fuscus Linnaeus, 1758	1
Nycticorax nycticorax (Linnaeus, 1758)	Animalia|Chordata|Aves|Pelecaniformes|Ardeidae|Nycticorax|nycticorax|Nycticorax nycticorax (Linnaeus, 1758)	1
Plocamium J.V.Lamouroux, 1813	Plantae|Rhodophyta|Florideophyceae|Plocamiales|Plocamiaceae|Plocamium||Plocamium J.V.Lamouroux, 1813	1
Tamarix senegalensis DC.	Plantae|Tracheophyta|Magnoliopsida|Caryophyllales|Tamaricaceae|Tamarix|senegalensis|Tamarix senegalensis DC.	1
Peneroplis carinatus	Protozoa||Granuloreticulosea|Foraminiferida|Soritidae|Peneroplis|carinatus|Peneroplis carinatus	1
Schwartziella luisi Rolán & Luque, 2000	Animalia|Mollusca|Gastropoda|Neotaenioglossa|Rissoidae|Schwartziella|luisi|Schwartziella luisi Rolán & Luque, 2000	1
Turdus merula cabrerae	Animalia|Chordata|Aves|Passeriformes|Turdidae|Turdus|merula|Turdus merula cabrerae	1
Usnea baileyi (Stirton) Zahlbr.	Fungi|Ascomycota|Lecanoromycetes|Lecanorales|Parmeliaceae|Usnea|baileyi|Usnea baileyi (Stirton) Zahlbr.	1
Phacopsis oxyspora var. fusca Triebel & Rambold	Fungi|Ascomycota|Lecanoromycetes|Lecanorales|Parmeliaceae|Phacopsis|oxyspora|Phacopsis oxyspora var. fusca Triebel & Rambold	1
Hipponix subrufus (Lamarck, 1822)	Animalia|Mollusca|Gastropoda|Littorinimorpha|Hipponicidae|Hipponix|subrufus|Hipponix subrufus (Lamarck, 1822)	1
Alaba culliereti (Dautzenberg, 1890)	Animalia|Mollusca|Gastropoda||Litiopidae|Alaba|culliereti|Alaba culliereti (Dautzenberg, 1890)	1
Convolvulus prostratus Forsk.	Plantae|Tracheophyta|Magnoliopsida|Solanales|Convolvulaceae|Convolvulus|prostratus|Convolvulus prostratus Forsk.	1
Sporobolus virginicus (L.) Kunth	Plantae|Tracheophyta|Liliopsida|Poales|Poaceae|Sporobolus|virginicus|Sporobolus virginicus (L.) Kunth	1
Fissurella formosa Salvat, 1967	Animalia|Mollusca|Gastropoda|Archaeogastropoda|Fissurellidae|Fissurella|formosa|Fissurella formosa Salvat, 1967	1