taxonName	taxonPath	recordCount
Mollusca	Animalia|Mollusca||||||Mollusca	80
Pristurus flavipunctatus Rüppell, 1835	Animalia|Chordata|Reptilia|Squamata|Sphaerodactylidae|Pristurus|flavipunctatus|Pristurus flavipunctatus Rüppell, 1835	49
	|||||||	23
Ptychadena anchietae (Bocage, 1868)	Animalia|Chordata|Amphibia|Anura|Ptychadenidae|Ptychadena|anchietae|Ptychadena anchietae (Bocage, 1868)	21
Ophiothrix Müller & Troschel, 1840	Animalia|Echinodermata|Ophiuroidea|Ophiurida|Ophiotrichidae|Ophiothrix||Ophiothrix Müller & Troschel, 1840	15
Ptychadena mascareniensis (Duméril & Bibron, 1841)	Animalia|Chordata|Amphibia|Anura|Ptychadenidae|Ptychadena|mascareniensis|Ptychadena mascareniensis (Duméril & Bibron, 1841)	14
Rhincodon typus Smith, 1828	Animalia|Chordata|Elasmobranchii|Orectolobiformes|Rhincodontidae|Rhincodon|typus|Rhincodon typus Smith, 1828	11
Conus locumtenens Blumenbach, 1791	Animalia|Mollusca|Gastropoda|Neogastropoda|Conidae||locumtenens|Conus locumtenens Blumenbach, 1791	11
Agama spinosa Gray, 1831	Animalia|Chordata|Reptilia|Squamata|Agamidae|Agama|spinosa|Agama spinosa Gray, 1831	11
Latastia boscai Bedriaga, 1884	Animalia|Chordata|Reptilia|Squamata|Lacertidae|Latastia|boscai|Latastia boscai Bedriaga, 1884	10
Ptyodactylus ragazzii Anderson, 1898	Animalia|Chordata|Reptilia|Squamata|Phyllodactylidae|Ptyodactylus|ragazzii|Ptyodactylus ragazzii Anderson, 1898	9
Pyrgomatidae Gray, 1825	Animalia|Arthropoda|Maxillopoda|Sessilia|Pyrgomatidae|||Pyrgomatidae Gray, 1825	8
Equus Linnaeus, 1758	Animalia|Chordata|Mammalia|Perissodactyla|Equidae|Equus||Equus Linnaeus, 1758	8
Calcinus rosaceus Heller, 1861	Animalia|Arthropoda|Malacostraca|Decapoda|Diogenidae|Calcinus|rosaceus|Calcinus rosaceus Heller, 1861	8
Euphorbia granulata Forssk.	Plantae|Tracheophyta|Magnoliopsida|Malpighiales|Euphorbiaceae|Euphorbia|granulata|Euphorbia granulata Forssk.	7
Pycnonotus barbatus (Desfontaines, 1789)	Animalia|Chordata|Aves|Passeriformes|Pycnonotidae|Pycnonotus|barbatus|Pycnonotus barbatus (Desfontaines, 1789)	7
Calcinus Dana, 1851	Animalia|Arthropoda|Malacostraca|Decapoda|Diogenidae|Calcinus||Calcinus Dana, 1851	7
Euphorbia granulata Forssk.	Plantae|Magnoliophyta|Magnoliopsida|Malpighiales|Euphorbiaceae|Euphorbia|granulata|Euphorbia granulata Forssk.	7
Echinometra Gray, 1825	Animalia|Echinodermata|Echinoidea|Camarodonta|Echinometridae|Echinometra||Echinometra Gray, 1825	6
Aphanius dispar (Rüppell, 1829)	Animalia|Chordata|Actinopterygii|Cyprinodontiformes|Cyprinodontidae|Aphanius|dispar|Aphanius dispar (Rüppell, 1829)	6
Alpheus Fabricius, 1798	Animalia|Arthropoda|Malacostraca|Decapoda|Alpheidae|Alpheus||Alpheus Fabricius, 1798	6
Hippopotamus amphibius Linnaeus, 1758	Animalia|Chordata|Mammalia|Artiodactyla|Hippopotamidae|Hippopotamus|amphibius|Hippopotamus amphibius Linnaeus, 1758	6
Apus affinis (J. E. Gray, 1830)	Animalia|Chordata|Aves|Apodiformes|Apodidae|Apus|affinis|Apus affinis (J. E. Gray, 1830)	6
Bryozoa	Animalia|Bryozoa||||||Bryozoa	6
Culcita coriacea Müller & Troschel, 1842	Animalia|Echinodermata|Asteroidea|Valvatida|Oreasteridae|Culcita|coriacea|Culcita coriacea Müller & Troschel, 1842	6
Clerodendrum inerme (L.) Gaertn.	Plantae|Magnoliophyta|Magnoliopsida|Lamiales|Lamiaceae|Volkameria|inerme|Clerodendrum inerme (L.) Gaertn.	6
Conus jickelii Weinkauff, 1873	Animalia|Mollusca|Gastropoda|Neogastropoda|Conidae||jickelii|Conus jickelii Weinkauff, 1873	6
Trapezia cymodoce (Herbst, 1801)	Animalia|Arthropoda|Malacostraca|Decapoda|Trapeziidae|Trapezia|cymodoce|Trapezia cymodoce (Herbst, 1801)	6
Dicrurus adsimilis (Bechstein, 1794)	Animalia|Chordata|Aves|Passeriformes|Dicruridae|Dicrurus|adsimilis|Dicrurus adsimilis (Bechstein, 1794)	6
Streptopelia senegalensis (Linnaeus, 1766)	Animalia|Chordata|Aves|Columbiformes|Columbidae|Streptopelia|senegalensis|Streptopelia senegalensis (Linnaeus, 1766)	6
Chalcides ragazzii Boulenger, 1890	Animalia|Chordata|Reptilia|Squamata|Scincidae|Chalcides|ragazzii|Chalcides ragazzii Boulenger, 1890	6
Sinularia May, 1898	Animalia|Cnidaria|Anthozoa|Alcyonacea|Alcyoniidae|Sinularia||Sinularia May, 1898	6
Alpheus lottini Guérin-Méneville, 1829	Animalia|Arthropoda|Malacostraca|Decapoda|Alpheidae|Alpheus|lottini|Alpheus lottini Guérin-Méneville, 1829	6
Francolinus ochropectus Dorst & Jouanin, 1952	Animalia|Chordata|Aves|Galliformes|Phasianidae|Francolinus|ochropectus|Francolinus ochropectus Dorst & Jouanin, 1952	6
Scorpaena porcus Linnaeus, 1758	Animalia|Chordata|Actinopterygii|Scorpaeniformes|Scorpaenidae|Scorpaena|porcus|Scorpaena porcus Linnaeus, 1758	6
Polyonyx pedalis Nobili, 1905	Animalia|Arthropoda|Malacostraca|Decapoda|Porcellanidae|Polyonyx|pedalis|Polyonyx pedalis Nobili, 1905	6
Trimma flavicaudatum (Goren, 1982)	Animalia|Chordata|Actinopterygii|Perciformes|Gobiidae|Trimma|flavicaudatum|Trimma flavicaudatum (Goren, 1982)	6
Saron Thallwitz, 1891	Animalia|Arthropoda|Malacostraca|Decapoda|Hippolytidae|Saron||Saron Thallwitz, 1891	6
Latastia longicaudata (Reuss, 1834)	Animalia|Chordata|Reptilia|Squamata|Lacertidae|Latastia|longicaudata|Latastia longicaudata (Reuss, 1834)	5
Pilodius spinipes Heller, 1861	Animalia|Arthropoda|Malacostraca|Decapoda|Xanthidae|Pilodius|spinipes|Pilodius spinipes Heller, 1861	5
Galatheidae Samouelle, 1819	Animalia|Arthropoda|Malacostraca|Decapoda|Galatheidae|||Galatheidae Samouelle, 1819	5
Eremopterix nigriceps (Gould, 1839)	Animalia|Chordata|Aves|Passeriformes|Alaudidae|Eremopterix|nigriceps|Eremopterix nigriceps (Gould, 1839)	5
Acokanthera schimperi Oliv.	Plantae|Magnoliophyta|Magnoliopsida|Gentianales|Apocynaceae|Acokanthera|schimperi|Acokanthera schimperi Oliv.	5
Tchagra senegalus (Linnaeus, 1766)	Animalia|Chordata|Aves|Passeriformes|Malaconotidae|Tchagra|senegalus|Tchagra senegalus (Linnaeus, 1766)	5
Charadrius hiaticula Linnaeus, 1758	Animalia|Chordata|Aves|Charadriiformes|Charadriidae|Charadrius|hiaticula|Charadrius hiaticula Linnaeus, 1758	5
Zosterops abyssinicus Guerin-Meneville, 1843	Animalia|Chordata|Aves|Passeriformes|Zosteropidae|Zosterops|abyssinicus|Zosterops abyssinicus Guerin-Meneville, 1843	5
Elephas recki	Animalia|Chordata|Mammalia|Proboscidea|Elephantidae|Elephas|recki|Elephas recki	5
Muscicapa striata (Pallas, 1764)	Animalia|Chordata|Aves|Passeriformes|Muscicapidae|Muscicapa|striata|Muscicapa striata (Pallas, 1764)	5
Conus terebra Born, 1778	Animalia|Mollusca|Gastropoda|Neogastropoda|Conidae||terebra|Conus terebra Born, 1778	5
Lanius meridionalis Temminck, 1820	Animalia|Chordata|Aves|Passeriformes|Laniidae|Lanius|meridionalis|Lanius meridionalis Temminck, 1820	5
Lithoscaptus A. Milne-Edwards, 1862	Animalia|Arthropoda|Malacostraca|Decapoda|Cryptochiridae|Lithoscaptus||Lithoscaptus A. Milne-Edwards, 1862	5
Conus cuvieri Crosse, 1858	Animalia|Mollusca|Gastropoda|Neogastropoda|Conidae||cuvieri|Conus cuvieri Crosse, 1858	5
Ophiocoma schoenleinii Müller & Troschel, 1842	Animalia|Echinodermata|Ophiuroidea|Ophiurida|Ophiocomidae|Ophiocoma|schoenleinii|Ophiocoma schoenleinii Müller & Troschel, 1842	5
Homalocantha fauroti Jousseaume, 1888	Animalia|Mollusca|Gastropoda|Neogastropoda|Muricidae|Homalocantha|fauroti|Homalocantha fauroti Jousseaume, 1888	4
Cassia senna L.	Plantae|Tracheophyta|Magnoliopsida|Fabales|Fabaceae|Senna|senna|Cassia senna L.	4
Lethrinus borbonicus Valenciennes, 1830	Animalia|Chordata|Actinopterygii|Perciformes|Lethrinidae|Lethrinus|borbonicus|Lethrinus borbonicus Valenciennes, 1830	4
Treron waalia (F. A. A. Meyer, 1793)	Animalia|Chordata|Aves|Columbiformes|Columbidae|Treron|waalia|Treron waalia (F. A. A. Meyer, 1793)	4
Alpheidae Rafinesque, 1815	Animalia|Arthropoda|Malacostraca|Decapoda|Alpheidae|||Alpheidae Rafinesque, 1815	4
Oplopomus oplopomus (Valenciennes, 1837)	Animalia|Chordata|Actinopterygii|Perciformes|Gobiidae|Oplopomus|oplopomus|Oplopomus oplopomus (Valenciennes, 1837)	4
Chordata	Animalia|Chordata||||||Chordata	4
Chaetodon larvatus Cuvier, 1831	Animalia|Chordata|Actinopterygii|Perciformes|Chaetodontidae|Chaetodon|larvatus|Chaetodon larvatus Cuvier, 1831	4
Columba guinea Linnaeus, 1758	Animalia|Chordata|Aves|Columbiformes|Columbidae|Columba|guinea|Columba guinea Linnaeus, 1758	4
Pyrgomatidae	Animalia|Arthropoda|Maxillopoda|Sessilia|Pyrgomatidae|||Pyrgomatidae	4
Cyclodius granulatus (Targioni-Tozzetti, 1877)	Animalia|Arthropoda|Malacostraca|Decapoda|Xanthidae|Cyclodius|granulatus|Cyclodius granulatus (Targioni-Tozzetti, 1877)	4
Haliclona Grant, 1836	Animalia|Porifera|Demospongiae|Haplosclerida|Chalinidae|Haliclona||Haliclona Grant, 1836	4
Acomys cahirinus (E. Geoffroy, 1803)	Animalia|Chordata|Mammalia|Rodentia|Muridae|Acomys|cahirinus|Acomys cahirinus (E. Geoffroy, 1803)	4
Aepyceros Sundevall, 1847	Animalia|Chordata|Mammalia|Artiodactyla|Bovidae|Aepyceros||Aepyceros Sundevall, 1847	4
Phyllanthus fraternus G.L.Webster	Plantae|Magnoliophyta|Magnoliopsida|Malpighiales|Phyllanthaceae|Phyllanthus|fraternus|Phyllanthus fraternus G.L.Webster	4
Uranotaenia balfouri Theobald, 1904	Animalia|Arthropoda|Insecta|Diptera|Culicidae|Uranotaenia|balfouri|Uranotaenia balfouri Theobald, 1904	4
Acabaria Gray, 1859	Animalia|Cnidaria|Anthozoa|Alcyonacea|Melithaeidae|Acabaria||Acabaria Gray, 1859	4
Balanidae Leach, 1817	Animalia|Arthropoda|Maxillopoda|Sessilia|Balanidae|||Balanidae Leach, 1817	4
Canthigaster margaritata (Rüppell, 1829)	Animalia|Chordata|Actinopterygii|Tetraodontiformes|Tetraodontidae|Canthigaster|margaritata|Canthigaster margaritata (Rüppell, 1829)	4
Crocodylus niloticus Laurenti, 1768	Animalia|Chordata|Reptilia|Crocodylia|Crocodylidae|Crocodylus|niloticus|Crocodylus niloticus Laurenti, 1768	4
Lavandula coronopifolia Poir.	Plantae|Tracheophyta|Magnoliopsida|Lamiales|Lamiaceae|Lavandula|coronopifolia|Lavandula coronopifolia Poir.	4
Pterocles lichtensteinii Temminck, 1825	Animalia|Chordata|Aves|Pteroclidiformes|Pteroclididae|Pterocles|lichtensteinii|Pterocles lichtensteinii Temminck, 1825	4
Merops apiaster Linnaeus, 1758	Animalia|Chordata|Aves|Coraciiformes|Meropidae|Merops|apiaster|Merops apiaster Linnaeus, 1758	4
Larus fuscus Linnaeus, 1758	Animalia|Chordata|Aves|Charadriiformes|Laridae|Larus|fuscus|Larus fuscus Linnaeus, 1758	4
Dendropicos fuscescens (Vieillot, 1818)	Animalia|Chordata|Aves|Piciformes|Picidae|Dendropicos|fuscescens|Dendropicos fuscescens (Vieillot, 1818)	4
Gonodactylidae Giesbrecht, 1910	Animalia|Arthropoda|Malacostraca|Stomatopoda|Gonodactylidae|||Gonodactylidae Giesbrecht, 1910	4
Periclimenes soror Nobili, 1904	Animalia|Arthropoda|Malacostraca|Decapoda|Palaemonidae|Periclimenes|soror|Periclimenes soror Nobili, 1904	3
Actaeodes hirsutissimus (Rüppell, 1830)	Animalia|Arthropoda|Malacostraca|Decapoda|Xanthidae|Actaeodes|hirsutissimus|Actaeodes hirsutissimus (Rüppell, 1830)	3
Hippopotamus gorgops	Animalia|Chordata|Mammalia|Artiodactyla|Hippopotamidae|Hippopotamus|gorgops|Hippopotamus gorgops	3
Istigobius spence (Smith, 1947)	Animalia|Chordata|Actinopterygii|Perciformes|Gobiidae|Istigobius|spence|Istigobius spence (Smith, 1947)	3
Euphorbia arabica Hochst. & Steud. ex T.Anderson	Plantae|Tracheophyta|Magnoliopsida|Malpighiales|Euphorbiaceae|Euphorbia|arabica|Euphorbia arabica Hochst. & Steud. ex T.Anderson	3
Charadrius mongolus Pallas, 1776	Animalia|Chordata|Aves|Charadriiformes|Charadriidae|Charadrius|mongolus|Charadrius mongolus Pallas, 1776	3
Xenus cinereus (Guldenstadt, 1775)	Animalia|Chordata|Aves|Charadriiformes|Scolopacidae|Xenus|cinereus|Xenus cinereus (Guldenstadt, 1775)	3
Hawaiarca rectangula Dall, Bartsch & Rehder, 1938	Animalia|Mollusca|Bivalvia|Arcoida|Arcidae|Hawaiarca|rectangula|Hawaiarca rectangula Dall, Bartsch & Rehder, 1938	3
Terebra felina (Dillwyn, 1817)	Animalia|Mollusca|Gastropoda|Neogastropoda|Terebridae|Oxymeris|felina|Terebra felina (Dillwyn, 1817)	3
Cyperus conglomeratus Rottb.	Plantae|Magnoliophyta|Liliopsida|Poales|Cyperaceae|Cyperus|conglomeratus|Cyperus conglomeratus Rottb.	3
Ophiochaeta Lütken, 1869	Animalia|Echinodermata|Ophiuroidea|Ophiurida|Ophiodermatidae|Ophiochaeta||Ophiochaeta Lütken, 1869	3
Egretta gularis (Bosc, 1792)	Animalia|Chordata|Aves|Pelecaniformes|Ardeidae|Egretta|gularis|Egretta gularis (Bosc, 1792)	3
Pomacentrus trichourus Günther, 1867	Animalia|Chordata|Actinopterygii|Perciformes|Pomacentridae|Pomacentrus|trichourus|Pomacentrus trichourus Günther, 1867	3
Vanellus spinosus (Linnaeus, 1758)	Animalia|Chordata|Aves|Charadriiformes|Charadriidae|Vanellus|spinosus|Vanellus spinosus (Linnaeus, 1758)	3
Phyllidiella annulata (Gray, 1853)	Animalia|Mollusca|Gastropoda|Nudibranchia|Phyllidiidae|Phyllidiella|annulata|Phyllidiella annulata (Gray, 1853)	3
Chromodoris quadricolor (Rüppell & Leuckart, 1828)	Animalia|Mollusca|Gastropoda|Nudibranchia|Chromodorididae|Chromodoris|quadricolor|Chromodoris quadricolor (Rüppell & Leuckart, 1828)	3
Pearsonothuria graeffei (Semper, 1868)	Animalia|Echinodermata|Holothuroidea|Aspidochirotida|Holothuriidae|Pearsonothuria|graeffei|Pearsonothuria graeffei (Semper, 1868)	3
Charadrius alexandrinus Linnaeus, 1758	Animalia|Chordata|Aves|Charadriiformes|Charadriidae|Charadrius|alexandrinus|Charadrius alexandrinus Linnaeus, 1758	3
Periglypta crispata (Deshayes, 1853)	Animalia|Mollusca|Bivalvia|Veneroida|Veneridae|Antigona|crispata|Periglypta crispata (Deshayes, 1853)	3
Menaethius monoceros (Latreille, 1825)	Animalia|Arthropoda|Malacostraca|Decapoda|Epialtidae|Menaethius|monoceros|Menaethius monoceros (Latreille, 1825)	3
Alpheus Weber, 1795	Animalia|Arthropoda|Malacostraca|Decapoda|Alpheidae|Alpheus||Alpheus Weber, 1795	3
Echinothrix calamaris (Pallas, 1774)	Animalia|Echinodermata|Echinoidea|Diadematoida|Diadematidae|Echinothrix|calamaris|Echinothrix calamaris (Pallas, 1774)	3
Onychognathus blythii (Hartlaub, 1859)	Animalia|Chordata|Aves|Passeriformes|Sturnidae|Onychognathus|blythii|Onychognathus blythii (Hartlaub, 1859)	3
Galathea aegyptiaca Paul’son, 1875	Animalia|Arthropoda|Malacostraca|Decapoda|Galatheidae|Galathea|aegyptiaca|Galathea aegyptiaca Paul’son, 1875	3
Sylvietta brachyura Lafresnaye, 1839	Animalia|Chordata|Aves|Passeriformes|Sylviidae|Sylvietta|brachyura|Sylvietta brachyura Lafresnaye, 1839	3
Cinnyris habessinicus	Animalia|Chordata|Aves|Passeriformes|Nectariniidae|Cinnyris|habessinicus|Cinnyris habessinicus	3
Ophionereis porrecta Lyman, 1860	Animalia|Echinodermata|Ophiuroidea|Ophiurida|Ophionereididae|Ophionereis|porrecta|Ophionereis porrecta Lyman, 1860	3
Tarentola annularis	Animalia|Chordata|Reptilia|Squamata|Phyllodactylidae|Tarentola|annularis|Tarentola annularis	3
Galathea aegiptiaca Paulson, 1875	Animalia|Arthropoda|Malacostraca|Decapoda|Galatheidae|Galathea|aegiptiaca|Galathea aegiptiaca Paulson, 1875	3
Camaroptera brachyura (Vieillot, 1821)	Animalia|Chordata|Aves|Passeriformes|Cisticolidae|Camaroptera|brachyura|Camaroptera brachyura (Vieillot, 1821)	3
Acokanthera schimperi (A. DC.) Schweinf.	Plantae|Tracheophyta|Magnoliopsida|Gentianales|Apocynaceae|Acokanthera|schimperi|Acokanthera schimperi (A. DC.) Schweinf.	3
Chlorodiella cytherea (Dana, 1852)	Animalia|Arthropoda|Malacostraca|Decapoda|Xanthidae|Chlorodiella|cytherea|Chlorodiella cytherea (Dana, 1852)	3
Tetralia Dana, 1851	Animalia|Arthropoda|Malacostraca|Decapoda|Tetraliidae|Tetralia||Tetralia Dana, 1851	3
Kobus A. Smith, 1840	Animalia|Chordata|Mammalia|Artiodactyla|Bovidae|Kobus||Kobus A. Smith, 1840	3
Linckia Nardo, 1834	Animalia|Echinodermata|Asteroidea|Valvatida|Ophidiasteridae|Linckia||Linckia Nardo, 1834	3
Xanthodes Dana, 1852	Animalia|Arthropoda|Malacostraca|Decapoda|Xanthidae|Xanthias||Xanthodes Dana, 1852	3
Trapezia Latreille, 1828	Animalia|Arthropoda|Malacostraca|Decapoda|Trapeziidae|Trapezia||Trapezia Latreille, 1828	3
Clivipollia Iredale, 1929	Animalia|Mollusca|Gastropoda|Neogastropoda|Buccinidae|Clivipollia||Clivipollia Iredale, 1929	3
Trachyphonus margaritatus (Cretzschmar, 1828)	Animalia|Chordata|Aves|Piciformes|Ramphastidae|Trachyphonus|margaritatus|Trachyphonus margaritatus (Cretzschmar, 1828)	3
Pomacentrus leptus Allen & Randall, 1980	Animalia|Chordata|Actinopterygii|Perciformes|Pomacentridae|Pomacentrus|leptus|Pomacentrus leptus Allen & Randall, 1980	3
Laniarius aethiopicus (J. F. Gmelin, 1788)	Animalia|Chordata|Aves|Passeriformes|Malaconotidae|Laniarius|aethiopicus|Laniarius aethiopicus (J. F. Gmelin, 1788)	3
Iduna pallida	Animalia|Chordata|Aves|Passeriformes|Acrocephalidae|Iduna|pallida|Iduna pallida	3
Petrolisthes carinipes (Heller, 1861)	Animalia|Arthropoda|Malacostraca|Decapoda|Porcellanidae|Petrolisthes|carinipes|Petrolisthes carinipes (Heller, 1861)	3
Tringa totanus (Linnaeus, 1758)	Animalia|Chordata|Aves|Charadriiformes|Scolopacidae|Tringa|totanus|Tringa totanus (Linnaeus, 1758)	3
Dardanus lagopodes (Forskål, 1775)	Animalia|Arthropoda|Malacostraca|Decapoda|Diogenidae|Dardanus|lagopodes|Dardanus lagopodes (Forskål, 1775)	3
Hedydipna metallica (Lichtenstein, 1823)	Animalia|Chordata|Aves|Passeriformes|Nectariniidae|Hedydipna|metallica|Hedydipna metallica (Lichtenstein, 1823)	3
Acanthaster planci (Linnaeus, 1758)	Animalia|Echinodermata|Asteroidea|Valvatida|Acanthasteridae|Acanthaster|planci|Acanthaster planci (Linnaeus, 1758)	3
Vasticardium Iredale, 1927	Animalia|Mollusca|Bivalvia|Veneroida|Cardiidae|Vasticardium||Vasticardium Iredale, 1927	3
Phyllidiopsis sinaiensis (Yonow, 1988)	Animalia|Mollusca|Gastropoda|Nudibranchia|Phyllidiidae|Phyllidiopsis|sinaiensis|Phyllidiopsis sinaiensis (Yonow, 1988)	3
Macrophiothrix propinqua (Lyman, 1861)	Animalia|Echinodermata|Ophiuroidea|Ophiurida|Ophiotrichidae|Macrophiothrix|propinqua|Macrophiothrix propinqua (Lyman, 1861)	3
Ophiothela danae Verrill, 1869	Animalia|Echinodermata|Ophiuroidea|Ophiurida|Ophiotrichidae|Ophiothela|danae|Ophiothela danae Verrill, 1869	3
Dromas ardeola Paykull, 1805	Animalia|Chordata|Aves|Charadriiformes|Dromadidae|Dromas|ardeola|Dromas ardeola Paykull, 1805	3
Canthidermis maculata (Bloch, 1786)	Animalia|Chordata|Actinopterygii|Tetraodontiformes|Balistidae|Canthidermis|maculata|Canthidermis maculata (Bloch, 1786)	3
Stenopus hispidus (Olivier, 1811)	Animalia|Arthropoda|Malacostraca|Decapoda|Stenopodidae|Stenopus|hispidus|Stenopus hispidus (Olivier, 1811)	3
Heterocentrotus Brandt, 1835	Animalia|Echinodermata|Echinoidea|Camarodonta|Echinometridae|Heterocentrotus||Heterocentrotus Brandt, 1835	3
Phyllidiella pustulosa (Cuvier, 1804)	Animalia|Mollusca|Gastropoda|Nudibranchia|Phyllidiidae|Phyllidiella|pustulosa|Phyllidiella pustulosa (Cuvier, 1804)	3
Haematopus ostralegus Linnaeus, 1758	Animalia|Chordata|Aves|Charadriiformes|Haematopodidae|Haematopus|ostralegus|Haematopus ostralegus Linnaeus, 1758	3
Conus fumigatus Hwass in Bruguière, 1792	Animalia|Mollusca|Gastropoda|Neogastropoda|Conidae||fumigatus|Conus fumigatus Hwass in Bruguière, 1792	3
Actitis hypoleucos (Linnaeus, 1758)	Animalia|Chordata|Aves|Charadriiformes|Scolopacidae|Actitis|hypoleucos|Actitis hypoleucos (Linnaeus, 1758)	3
Pomacentrus trilineatus Cuvier, 1830	Animalia|Chordata|Actinopterygii|Perciformes|Pomacentridae|Pomacentrus|trilineatus|Pomacentrus trilineatus Cuvier, 1830	3
Calidris ferruginea (Pontoppidan, 1763)	Animalia|Chordata|Aves|Charadriiformes|Scolopacidae|Calidris|ferruginea|Calidris ferruginea (Pontoppidan, 1763)	3
Ephippodonta Tate, 1889	Animalia|Mollusca|Bivalvia|Veneroida|Galeommatidae|Ephippodonta||Ephippodonta Tate, 1889	3
Cassia senna L.	Plantae|Magnoliophyta|Magnoliopsida|Fabales|Fabaceae|Senna|senna|Cassia senna L.	3
Pomacentrus sulfureus Klunzinger, 1871	Animalia|Chordata|Actinopterygii|Perciformes|Pomacentridae|Pomacentrus|sulfureus|Pomacentrus sulfureus Klunzinger, 1871	3
Pleuroploca P. Fischer, 1884	Animalia|Mollusca|Gastropoda|Neogastropoda|Fasciolariidae|Pleuroploca||Pleuroploca P. Fischer, 1884	3
Laniarius aethiopicus (Gmelin, 1789)	Animalia|Chordata|Aves|Passeriformes|Malaconotidae|Laniarius|aethiopicus|Laniarius aethiopicus (Gmelin, 1789)	3
Zoanthus Lamarck, 1801	Animalia|Cnidaria|Anthozoa|Zoantharia|Zoanthidae|Zoanthus||Zoanthus Lamarck, 1801	3
Amblygobius albimaculatus (Rüppell, 1830)	Animalia|Chordata|Actinopterygii|Perciformes|Gobiidae|Amblygobius|albimaculatus|Amblygobius albimaculatus (Rüppell, 1830)	3
Neophron percnopterus (Linnaeus, 1758)	Animalia|Chordata|Aves|Accipitriformes|Accipitridae|Neophron|percnopterus|Neophron percnopterus (Linnaeus, 1758)	3
Peristernia nassatula (Lamarck, 1822)	Animalia|Mollusca|Gastropoda|Neogastropoda|Fasciolariidae|Peristernia|nassatula|Peristernia nassatula (Lamarck, 1822)	3
Sterna repressa Hartert, 1916	Animalia|Chordata|Aves|Charadriiformes|Laridae|Sterna|repressa|Sterna repressa Hartert, 1916	3
Threskiornis aethiopicus (Latham, 1790)	Animalia|Chordata|Aves|Pelecaniformes|Threskiornithidae|Threskiornis|aethiopicus|Threskiornis aethiopicus (Latham, 1790)	3
Numenius arquata (Linnaeus, 1758)	Animalia|Chordata|Aves|Charadriiformes|Scolopacidae|Numenius|arquata|Numenius arquata (Linnaeus, 1758)	3
Palythoa Lamouroux, 1816	Animalia|Cnidaria|Anthozoa|Zoantharia|Zoanthidae|Palythoa||Palythoa Lamouroux, 1816	3
Heliotropium pterocarpum Hockst. & Steud. ex Bunge	Plantae|Magnoliophyta|Magnoliopsida|Boraginales|Boraginaceae|Heliotropium|pterocarpum|Heliotropium pterocarpum Hockst. & Steud. ex Bunge	3
Camaroptera brachyura (Vieillot, 1820)	Animalia|Chordata|Aves|Passeriformes|Cisticolidae|Camaroptera|brachyura|Camaroptera brachyura (Vieillot, 1820)	3
Porites Link, 1807	Animalia|Cnidaria|Anthozoa|Scleractinia|Poritidae|Porites||Porites Link, 1807	3
Phyllidia ocellata Cuvier, 1804	Animalia|Mollusca|Gastropoda|Nudibranchia|Phyllidiidae|Phyllidia|ocellata|Phyllidia ocellata Cuvier, 1804	3
Upupa epops Linnaeus, 1758	Animalia|Chordata|Aves|Upupiformes|Upupidae|Upupa|epops|Upupa epops Linnaeus, 1758	3
Tubipora Linnaeus, 1758	Animalia|Cnidaria|Anthozoa|Alcyonacea|Tubiporidae|Tubipora||Tubipora Linnaeus, 1758	3
Ardea goliath Cretzschmar, 1829	Animalia|Chordata|Aves|Pelecaniformes|Ardeidae|Ardea|goliath|Ardea goliath Cretzschmar, 1829	3
Panulirus ornatus (Fabricius, 1798)	Animalia|Arthropoda|Malacostraca|Decapoda|Palinuridae|Panulirus|ornatus|Panulirus ornatus (Fabricius, 1798)	3
Ploceus galbula Ruppell, 1837	Animalia|Chordata|Aves|Passeriformes|Ploceidae|Ploceus|galbula|Ploceus galbula Ruppell, 1837	3
Conus taeniatus Hwass in Bruguière, 1792	Animalia|Mollusca|Gastropoda|Neogastropoda|Conidae||taeniatus|Conus taeniatus Hwass in Bruguière, 1792	3
Porifera	Animalia|Porifera||||||Porifera	3
Amblygobius hectori (Smith, 1957)	Animalia|Chordata|Actinopterygii|Perciformes|Gobiidae|Koumansetta|hectori|Amblygobius hectori (Smith, 1957)	3
Gymnodoris Stimpson, 1855	Animalia|Mollusca|Gastropoda|Nudibranchia|Gymnodorididae|Gymnodoris||Gymnodoris Stimpson, 1855	3
Calcinus latens (J. W. Randall, 1840)	Animalia|Arthropoda|Malacostraca|Decapoda|Diogenidae|Calcinus|latens|Calcinus latens (J. W. Randall, 1840)	3
Acanthocercus annectens (Blanford, 1870)	Animalia|Chordata|Reptilia|Squamata|Agamidae|Acanthocercus|annectens|Acanthocercus annectens (Blanford, 1870)	3
Cercomela melanura (Temminck, 1824)	Animalia|Chordata|Aves|Passeriformes|Muscicapidae|Oenanthe|melanura|Cercomela melanura (Temminck, 1824)	3
Hedydipna metallica	Animalia|Chordata|Aves|Passeriformes|Nectariniidae|Hedydipna|metallica|Hedydipna metallica	3
Petrolisthes moluccensis (De Man, 1888)	Animalia|Arthropoda|Malacostraca|Decapoda|Porcellanidae|Petrolisthes|moluccensis|Petrolisthes moluccensis (De Man, 1888)	3
Euphorbia arabica Hochst. & Steud. ex T.Anderson	Plantae|Magnoliophyta|Magnoliopsida|Malpighiales|Euphorbiaceae|Euphorbia|arabica|Euphorbia arabica Hochst. & Steud. ex T.Anderson	3
Arenaria interpres (Linnaeus, 1758)	Animalia|Chordata|Aves|Charadriiformes|Scolopacidae|Arenaria|interpres|Arenaria interpres (Linnaeus, 1758)	3
Hippopotamus gorgops Dietrich, 1928	Animalia|Chordata|Mammalia|Artiodactyla|Hippopotamidae|Hippopotamus|gorgops|Hippopotamus gorgops Dietrich, 1928	3
Diadema setosum (Leske, 1778)	Animalia|Echinodermata|Echinoidea|Diadematoida|Diadematidae|Diadema|setosum|Diadema setosum (Leske, 1778)	3
Holothuria atra Jaeger, 1833	Animalia|Echinodermata|Holothuroidea|Aspidochirotida|Holothuriidae|Holothuria|atra|Holothuria atra Jaeger, 1833	3
Pluvialis squatarola (Linnaeus, 1758)	Animalia|Chordata|Aves|Charadriiformes|Charadriidae|Pluvialis|squatarola|Pluvialis squatarola (Linnaeus, 1758)	3
Cyphostemma serpens (Hochst. ex A.Rich.) Desc.	Plantae|Magnoliophyta|Magnoliopsida|Vitales|Vitaceae|Cyphostemma|serpens|Cyphostemma serpens (Hochst. ex A.Rich.) Desc.	3
Trimma avidori (Goren, 1978)	Animalia|Chordata|Actinopterygii|Perciformes|Gobiidae|Trimma|avidori|Trimma avidori (Goren, 1978)	3
Lutjanus coeruleolineatus (Rüppell, 1838)	Animalia|Chordata|Actinopterygii|Perciformes|Lutjanidae|Lutjanus|coeruleolineatus|Lutjanus coeruleolineatus (Rüppell, 1838)	2
Heterobranchus Geoffroy St. Hilaire, 1809	Animalia|Chordata|Actinopterygii|Siluriformes|Clariidae|Heterobranchus||Heterobranchus Geoffroy St. Hilaire, 1809	2
Pterois volitans (Linnaeus, 1758)	Animalia|Chordata|Actinopterygii|Scorpaeniformes|Scorpaenidae|Pterois|volitans|Pterois volitans (Linnaeus, 1758)	2
Zebrasoma xanthurum (Blyth, 1852)	Animalia|Chordata|Actinopterygii|Perciformes|Acanthuridae|Zebrasoma|xanthurum|Zebrasoma xanthurum (Blyth, 1852)	2
Lethrinus microdon Valenciennes, 1830	Animalia|Chordata|Actinopterygii|Perciformes|Lethrinidae|Lethrinus|microdon|Lethrinus microdon Valenciennes, 1830	2
Trochidae Rafinesque, 1815	Animalia|Mollusca|Gastropoda|Archaeogastropoda||||Trochidae Rafinesque, 1815	2
Sylvia leucomelaena (Hemprich & Ehrenberg, 1833)	Animalia|Chordata|Aves|Passeriformes|Sylviidae|Sylvia|leucomelaena|Sylvia leucomelaena (Hemprich & Ehrenberg, 1833)	2
Tanaocheles Kropp, 1984	Animalia|Arthropoda|Malacostraca|Decapoda|Tanaochelidae|Tanaocheles||Tanaocheles Kropp, 1984	2
Corythoichthys flavofasciatus (Rüppell, 1838)	Animalia|Chordata|Actinopterygii|Syngnathiformes|Syngnathidae|Corythoichthys|flavofasciatus|Corythoichthys flavofasciatus (Rüppell, 1838)	2
Hemigymnus melapterus (Bloch, 1791)	Animalia|Chordata|Actinopterygii|Perciformes|Labridae|Hemigymnus|melapterus|Hemigymnus melapterus (Bloch, 1791)	2
Sufflamen chrysopterum (Bloch & Schneider, 1801)	Animalia|Chordata|Actinopterygii|Tetraodontiformes|Balistidae|Sufflamen|chrysopterum|Sufflamen chrysopterum (Bloch & Schneider, 1801)	2
Hippolais languida (Ehrenberg, 1833)	Animalia|Chordata|Aves|Passeriformes|Sylviidae|Hippolais|languida|Hippolais languida (Ehrenberg, 1833)	2
Ergalatax obscura Houart, 1996	Animalia|Mollusca|Gastropoda|Neogastropoda|Muricidae|Ergalatax|obscura|Ergalatax obscura Houart, 1996	2
Columbellidae Swainson, 1840	Animalia|Mollusca|Gastropoda|Neogastropoda|Columbellidae|||Columbellidae Swainson, 1840	2
Valamugil seheli (Forsskål, 1775)	Animalia|Chordata|Actinopterygii|Mugiliformes|Mugilidae|Moolgarda|seheli|Valamugil seheli (Forsskål, 1775)	2
Saurida gracilis (Quoy & Gaimard, 1824)	Animalia|Chordata|Actinopterygii|Aulopiformes|Synodontidae|Saurida|gracilis|Saurida gracilis (Quoy & Gaimard, 1824)	2
Sylviidae	Animalia|Chordata|Aves|Passeriformes|Sylviidae|||Sylviidae	2
Asterropteryx semipunctata Rüppell, 1830	Animalia|Chordata|Actinopterygii|Perciformes|Gobiidae|Asterropteryx|semipunctata|Asterropteryx semipunctata Rüppell, 1830	2
Platyceps afarensis Schätti & Ineich, 2004	Animalia|Chordata|Reptilia|Squamata|Colubridae|Platyceps|afarensis|Platyceps afarensis Schätti & Ineich, 2004	2
Hystrix cristata Linnaeus, 1758	Animalia|Chordata|Mammalia|Rodentia|Hystricidae|Hystrix|cristata|Hystrix cristata Linnaeus, 1758	2
Asclepiadaceae	Plantae|Magnoliophyta|Magnoliopsida|Gentianales|Asclepiadaceae|||Asclepiadaceae	2
Hapalocarcinus Stimpson, 1859	Animalia|Arthropoda|Malacostraca|Decapoda|Cryptochiridae|Hapalocarcinus||Hapalocarcinus Stimpson, 1859	2
Ephedra foliata Boiss. ex C.A.Mey.	Plantae|Tracheophyta|Gnetopsida|Ephedrales|Ephedraceae|Ephedra|foliata|Ephedra foliata Boiss. ex C.A.Mey.	2
Cinachyra Sollas, 1886	Animalia|Porifera|Demospongiae|Spirophorida|Tetillidae|Cinachyra||Cinachyra Sollas, 1886	2
Conus arenatus Hwass in Bruguière, 1792	Animalia|Mollusca|Gastropoda|Neogastropoda|Conidae||arenatus|Conus arenatus Hwass in Bruguière, 1792	2
Sylvia atricapilla (Linnaeus, 1758)	Animalia|Chordata|Aves|Passeriformes|Sylviidae|Sylvia|atricapilla|Sylvia atricapilla (Linnaeus, 1758)	2
Kolpochoerus van Hoepen, 1932	Animalia|Chordata|Mammalia|Artiodactyla|Suidae|Kolpochoerus||Kolpochoerus van Hoepen, 1932	2
Lethrinus olivaceus Valenciennes, 1830	Animalia|Chordata|Actinopterygii|Perciformes|Lethrinidae|Lethrinus|olivaceus|Lethrinus olivaceus Valenciennes, 1830	2
Lantana camara L.	Plantae|Magnoliophyta|Magnoliopsida|Lamiales|Verbenaceae|Lantana|camara|Lantana camara L.	2
Lethrinus nebulosus (Forsskål, 1775)	Animalia|Chordata|Actinopterygii|Perciformes|Lethrinidae|Lethrinus|nebulosus|Lethrinus nebulosus (Forsskål, 1775)	2
Ephedra foliata Boiss. ex C.A.Mey.	Plantae|Gnetophyta|Gnetopsida|Ephedrales|Ephedraceae|Ephedra|foliata|Ephedra foliata Boiss. ex C.A.Mey.	2
Vasum Roding, 1798	Animalia|Mollusca|Gastropoda|Neogastropoda||Vasum||Vasum Roding, 1798	2
Sylvietta brachyura Lafresnaye, 1839	Animalia|Chordata|Aves|Passeriformes|Macrosphenidae|Sylvietta|brachyura|Sylvietta brachyura Lafresnaye, 1839	2
Dendropicos namaquus subsp. schoensis (Ruppell, 1842)	Animalia|Chordata|Aves|Piciformes|Picidae|Dendropicos|namaquus|Dendropicos namaquus subsp. schoensis (Ruppell, 1842)	2
Lactophrys Swainson, 1839	Animalia|Chordata|Actinopterygii|Tetraodontiformes|Ostraciidae|Lactophrys||Lactophrys Swainson, 1839	2
Commiphora Jacq.	Plantae|Magnoliophyta|Magnoliopsida|Sapindales|Burseraceae|Commiphora||Commiphora Jacq.	2
Homo Linnaeus, 1758	Animalia|Chordata|Mammalia|Primates|Hominidae|Homo||Homo Linnaeus, 1758	2
Uromastyx ocellata Lichtenstein, 1823	Animalia|Chordata|Reptilia|Squamata|Agamidae|Uromastyx|ocellata|Uromastyx ocellata Lichtenstein, 1823	2
Crocuta crocuta (Erxleben, 1777)	Animalia|Chordata|Mammalia|Carnivora|Hyaenidae|Crocuta|crocuta|Crocuta crocuta (Erxleben, 1777)	2
Uranoscopus Linnaeus, 1758	Animalia|Chordata|Actinopterygii|Perciformes|Uranoscopidae|Uranoscopus||Uranoscopus Linnaeus, 1758	2
Oenanthe leucopyga (C. L. Brehm, 1855)	Animalia|Chordata|Aves|Passeriformes|Muscicapidae|Oenanthe|leucopyga|Oenanthe leucopyga (C. L. Brehm, 1855)	2
Petrolisthes boscii (Audouin, 1826)	Animalia|Arthropoda|Malacostraca|Decapoda|Porcellanidae|Petrolisthes|boscii|Petrolisthes boscii (Audouin, 1826)	2
Aquila nipalensis Hodgson, 1833	Animalia|Chordata|Aves|Accipitriformes|Accipitridae|Aquila|nipalensis|Aquila nipalensis Hodgson, 1833	2
Anomala obscuripes Fairmaire, 1892	Animalia|Arthropoda|Insecta|Coleoptera|Rutelidae|Anomala|obscuripes|Anomala obscuripes Fairmaire, 1892	2
Parupeneus forsskali (Fourmanoir & Guézé, 1976)	Animalia|Chordata|Actinopterygii|Perciformes|Mullidae|Parupeneus|forsskali|Parupeneus forsskali (Fourmanoir & Guézé, 1976)	2
Carapidae	Animalia|Chordata|Actinopterygii|Ophidiiformes|Carapidae|||Carapidae	2
Kobus Smith, 1840	Animalia|Chordata|Mammalia|Artiodactyla|Bovidae|Kobus||Kobus Smith, 1840	2
Tarentola annularis Geoffroy DE ST-Hilaire, 1827	Animalia|Chordata|Reptilia|Squamata|Gekkonidae|Tarentola|annularis|Tarentola annularis Geoffroy DE ST-Hilaire, 1827	2
Gastrochaenidae Gray, 1840	Animalia|Mollusca|Bivalvia|Myoida|Gastrochaenidae|||Gastrochaenidae Gray, 1840	2
Pinctada Roding, 1798	Animalia|Mollusca|Bivalvia|Pterioida|Pteriidae|Pinctada||Pinctada Roding, 1798	2
Sylvia leucomelaena (Ehrenberg, 1833)	Animalia|Chordata|Aves|Passeriformes|Sylviidae|Sylvia|leucomelaena|Sylvia leucomelaena (Ehrenberg, 1833)	2
Prinia gracilis (Lichtenstein, 1823)	Animalia|Chordata|Aves|Passeriformes|Cisticolidae|Prinia|gracilis|Prinia gracilis (Lichtenstein, 1823)	2
Buccinidae Rafinesque, 1815	Animalia|Mollusca|Gastropoda|Neogastropoda|Buccinidae|||Buccinidae Rafinesque, 1815	2
Chaetodon melapterus Guichenot, 1863	Animalia|Chordata|Actinopterygii|Perciformes|Chaetodontidae|Chaetodon|melapterus|Chaetodon melapterus Guichenot, 1863	2
Cerithium echinatum Lamarck, 1822	Animalia|Mollusca|Gastropoda|Neotaenioglossa|Cerithiidae|Cerithium|echinatum|Cerithium echinatum Lamarck, 1822	2
Laevichlamys lemniscata (Reeve, 1853)	Animalia|Mollusca|Bivalvia|Ostreoida|Pectinidae|Scaeochlamys|lemniscata|Laevichlamys lemniscata (Reeve, 1853)	2
Lethrinus mahsena (Forsskål, 1775)	Animalia|Chordata|Actinopterygii|Perciformes|Lethrinidae|Lethrinus|mahsena|Lethrinus mahsena (Forsskål, 1775)	2
Cercotrichas podobe (Müller, 1776)	Animalia|Chordata|Aves|Passeriformes|Muscicapidae|Cercotrichas|podobe|Cercotrichas podobe (Müller, 1776)	2
Scomberoides lysan (Forsskål, 1775)	Animalia|Chordata|Actinopterygii|Perciformes|Carangidae|Scomberoides|lysan|Scomberoides lysan (Forsskål, 1775)	2
Geochelone Fitzinger, 1835	Animalia|Chordata|Reptilia|Testudines|Testudinidae|Geochelone||Geochelone Fitzinger, 1835	2
Tabebuia Gomes ex DC.	Plantae|Magnoliophyta|Magnoliopsida|Lamiales|Bignoniaceae|Tabebuia||Tabebuia Gomes ex DC.	2
Ipomoea pes-caprae (L.) R. Br.	Plantae|Magnoliophyta|Magnoliopsida|Solanales|Convolvulaceae|Ipomoea|pes-caprae|Ipomoea pes-caprae (L.) R. Br.	2
Upupa epops Linnaeus, 1758	Animalia|Chordata|Aves|Bucerotiformes|Upupidae|Upupa|epops|Upupa epops Linnaeus, 1758	2
Acanthopagrus bifasciatus (Forsskål, 1775)	Animalia|Chordata|Actinopterygii|Perciformes|Sparidae|Acanthopagrus|bifasciatus|Acanthopagrus bifasciatus (Forsskål, 1775)	2
Muricidae Rafinesque, 1815	Animalia|Mollusca|Gastropoda|Neogastropoda||||Muricidae Rafinesque, 1815	2
Thryssa baelama (Forsskål, 1775)	Animalia|Chordata|Actinopterygii|Clupeiformes|Engraulidae|Thryssa|baelama|Thryssa baelama (Forsskål, 1775)	2
Antipatharia Milne-Edwards & Haime, 1857	Animalia|Cnidaria|Anthozoa|Antipatharia||||Antipatharia Milne-Edwards & Haime, 1857	2
Irania gutturalis (Guerin-Meneville, 1843)	Animalia|Chordata|Aves|Passeriformes|Muscicapidae|Irania|gutturalis|Irania gutturalis (Guerin-Meneville, 1843)	2
Acacia laeta Benth.	Plantae|Magnoliophyta|Magnoliopsida|Fabales|Fabaceae|Acacia|laeta|Acacia laeta Benth.	2
Gloripallium maculosum (Forsskål, 1775)	Animalia|Mollusca|Bivalvia|Ostreoida|Pectinidae|Gloripallium|maculosum|Gloripallium maculosum (Forsskål, 1775)	2
Gelochelidon nilotica (Gmelin, 1789)	Animalia|Chordata|Aves|Charadriiformes|Laridae|Gelochelidon|nilotica|Gelochelidon nilotica (Gmelin, 1789)	2
Scomberoides tol (Cuvier, 1832)	Animalia|Chordata|Actinopterygii|Perciformes|Carangidae|Scomberoides|tol|Scomberoides tol (Cuvier, 1832)	2
Calotropis procera (Aiton) W.T. Aiton	Plantae|Magnoliophyta|Magnoliopsida|Gentianales|Apocynaceae|Calotropis|procera|Calotropis procera (Aiton) W.T. Aiton	2
Ploceus galbula Ruppell, 1840	Animalia|Chordata|Aves|Passeriformes|Ploceidae|Ploceus|galbula|Ploceus galbula Ruppell, 1840	2
Chlorodiella Rathbun, 1897	Animalia|Arthropoda|Malacostraca|Decapoda|Xanthidae|Chlorodiella||Chlorodiella Rathbun, 1897	2
Falco biarmicus Temminck, 1825	Animalia|Chordata|Aves|Falconiformes|Falconidae|Falco|biarmicus|Falco biarmicus Temminck, 1825	2
Laridae Vigors, 1825	Animalia|Chordata|Aves|Charadriiformes|Laridae|||Laridae Vigors, 1825	2
Phylloscopus umbrovirens (Rüppell, 1840)	Animalia|Chordata|Aves|Passeriformes|Phylloscopidae|Phylloscopus|umbrovirens|Phylloscopus umbrovirens (Rüppell, 1840)	2
Corvus rhipidurus Hartert, 1918	Animalia|Chordata|Aves|Passeriformes|Corvidae|Corvus|rhipidurus|Corvus rhipidurus Hartert, 1918	2
Amblyomma gemma Dönitz, 1909	Animalia|Arthropoda|Arachnida|Ixodida|Ixodidae|Amblyomma|gemma|Amblyomma gemma Dönitz, 1909	2
Cinnyris habessinicus (Hemprich & Ehrenberg, 1828)	Animalia|Chordata|Aves|Passeriformes|Nectariniidae|Cinnyris|habessinicus|Cinnyris habessinicus (Hemprich & Ehrenberg, 1828)	2
Gerres oblongus Cuvier, 1830	Animalia|Chordata|Actinopterygii|Perciformes|Gerreidae|Gerres|oblongus|Gerres oblongus Cuvier, 1830	2
Bignoniaceae Juss.	Plantae|Magnoliophyta|Magnoliopsida|Lamiales|Bignoniaceae|||Bignoniaceae Juss.	2
Trachinotus blochii (Lacepède, 1801)	Animalia|Chordata|Actinopterygii|Perciformes|Carangidae|Trachinotus|blochii|Trachinotus blochii (Lacepède, 1801)	2
Bothus pantherinus (Rüppell, 1830)	Animalia|Chordata|Actinopterygii|Pleuronectiformes|Bothidae|Bothus|pantherinus|Bothus pantherinus (Rüppell, 1830)	2
Scolopsis ghanam (Forsskål, 1775)	Animalia|Chordata|Actinopterygii|Perciformes|Nemipteridae|Scolopsis|ghanam|Scolopsis ghanam (Forsskål, 1775)	2
Antidorcas Sundevall, 1847	Animalia|Chordata|Mammalia|Artiodactyla|Bovidae|Antidorcas||Antidorcas Sundevall, 1847	2
Halichoeres scapularis (Bennett, 1832)	Animalia|Chordata|Actinopterygii|Perciformes|Labridae|Halichoeres|scapularis|Halichoeres scapularis (Bennett, 1832)	2
Wanella Anderson, 1993	Animalia|Arthropoda|Maxillopoda|Sessilia|Pyrgomatidae|Wanella||Wanella Anderson, 1993	2
Phyllidia varicosa Lamarck, 1801	Animalia|Mollusca|Gastropoda|Nudibranchia|Phyllidiidae|Phyllidia|varicosa|Phyllidia varicosa Lamarck, 1801	2
Istiblennius edentulus (Forster & Schneider, 1801)	Animalia|Chordata|Actinopterygii|Perciformes|Blenniidae|Istiblennius|edentulus|Istiblennius edentulus (Forster & Schneider, 1801)	2
Lutjanus argentimaculatus (Forsskål, 1775)	Animalia|Chordata|Actinopterygii|Perciformes|Lutjanidae|Lutjanus|argentimaculatus|Lutjanus argentimaculatus (Forsskål, 1775)	2
Lutjanus fulviflamma (Forsskål, 1775)	Animalia|Chordata|Actinopterygii|Perciformes|Lutjanidae|Lutjanus|fulviflamma|Lutjanus fulviflamma (Forsskål, 1775)	2
Micrognathus brevirostris (Rüppell, 1838)	Animalia|Chordata|Actinopterygii|Syngnathiformes|Syngnathidae|Micrognathus|brevirostris|Micrognathus brevirostris (Rüppell, 1838)	2
Julodis Eschscholtz, 1829	Animalia|Arthropoda|Insecta|Coleoptera|Buprestidae|Julodis||Julodis Eschscholtz, 1829	2
Cheilinus abudjubbe Rüppell, 1835	Animalia|Chordata|Actinopterygii|Perciformes|Labridae|Cheilinus|abudjubbe|Cheilinus abudjubbe Rüppell, 1835	2
Hipparion Christol, 1832	Animalia|Chordata|Mammalia|Perissodactyla|Equidae|Hipparion||Hipparion Christol, 1832	2
Oenanthe pleschanka (Lepechin, 1770)	Animalia|Chordata|Aves|Passeriformes|Muscicapidae|Oenanthe|pleschanka|Oenanthe pleschanka (Lepechin, 1770)	2
Siderea picta (Ahl, 1789)	Animalia|Chordata|Actinopterygii|Anguilliformes|Muraenidae|Gymnothorax|picta|Siderea picta (Ahl, 1789)	2
Lopha cristagalli (Linnaeus)	Animalia|Mollusca|Bivalvia|Ostreoida|Ostreidae|Lopha|cristagalli|Lopha cristagalli (Linnaeus)	2
Tridacna squamosa Lamarck, 1819	Animalia|Mollusca|Bivalvia|Veneroida|Tridacnidae|Tridacna|squamosa|Tridacna squamosa Lamarck, 1819	2
Onychoprion anaethetus (Scopoli, 1786)	Animalia|Chordata|Aves|Charadriiformes|Laridae|Onychoprion|anaethetus|Onychoprion anaethetus (Scopoli, 1786)	2
Chaetopteridae Audouin & Milne-Edwards, 1833	Animalia|Annelida|Polychaeta|Spionida|Chaetopteridae|||Chaetopteridae Audouin & Milne-Edwards, 1833	2
Paguridae Latreille, 1802	Animalia|Arthropoda|Malacostraca|Decapoda|Paguridae|||Paguridae Latreille, 1802	2
Pseudochromis flavivertex Rüppell, 1835	Animalia|Chordata|Actinopterygii|Perciformes|Pseudochromidae|Pseudochromis|flavivertex|Pseudochromis flavivertex Rüppell, 1835	2
Sufflamen fraenatum (Latreille, 1804)	Animalia|Chordata|Actinopterygii|Tetraodontiformes|Balistidae|Sufflamen|fraenatum|Sufflamen fraenatum (Latreille, 1804)	2
Uropterygius marmoratus (Lacepède, 1803)	Animalia|Chordata|Actinopterygii|Anguilliformes|Muraenidae|Uropterygius|marmoratus|Uropterygius marmoratus (Lacepède, 1803)	2
Istiblennius pox Springer & Williams, 1994	Animalia|Chordata|Actinopterygii|Perciformes|Blenniidae|Istiblennius|pox|Istiblennius pox Springer & Williams, 1994	2
Cyclodius Dana, 1851	Animalia|Arthropoda|Malacostraca|Decapoda|Xanthidae|Cyclodius||Cyclodius Dana, 1851	2
Carangoides caeruleopinnatus (Rüppell, 1830)	Animalia|Chordata|Actinopterygii|Perciformes|Carangidae|Carangoides|caeruleopinnatus|Carangoides caeruleopinnatus (Rüppell, 1830)	2
Mabuya Fitzinger, 1826	Animalia|Chordata|Reptilia|Squamata|Scincidae|Mabuya||Mabuya Fitzinger, 1826	2
Terpsiphone viridis (Statius Muller, 1776)	Animalia|Chordata|Aves|Passeriformes|Monarchidae|Terpsiphone|viridis|Terpsiphone viridis (Statius Muller, 1776)	2
Decapoda Latreille, 1802	Animalia|Arthropoda|Malacostraca|Decapoda||||Decapoda Latreille, 1802	2
Tockus flavirostris (Rüppell, 1835)	Animalia|Chordata|Aves|Bucerotiformes|Bucerotidae|Tockus|flavirostris|Tockus flavirostris (Rüppell, 1835)	2
Lithophaga Roding, 1798	Animalia|Mollusca|Bivalvia|Mytiloida|Mytilidae|Lithophaga||Lithophaga Roding, 1798	2
Parapercis hexophtalma (Cuvier, 1829)	Animalia|Chordata|Actinopterygii|Perciformes|Pinguipedidae|Parapercis|hexophtalma|Parapercis hexophtalma (Cuvier, 1829)	2
Rhodophoneus cruentus (Ehrenberg, 1828)	Animalia|Chordata|Aves|Passeriformes|Malaconotidae|Rhodophoneus|cruentus|Rhodophoneus cruentus (Ehrenberg, 1828)	2
Turbo radiatus Gmelin, 1791	Animalia|Mollusca|Gastropoda|Archaeogastropoda|Turbinidae|Turbo|radiatus|Turbo radiatus Gmelin, 1791	2
Delonix elata (L.) Gamble	Plantae|Tracheophyta|Magnoliopsida|Fabales|Fabaceae|Delonix|elata|Delonix elata (L.) Gamble	2
Loxodonta Anonymous, 1827	Animalia|Chordata|Mammalia|Proboscidea|Elephantidae|Loxodonta||Loxodonta Anonymous, 1827	2
Lutjanus gibbus (Forsskål, 1775)	Animalia|Chordata|Actinopterygii|Perciformes|Lutjanidae|Lutjanus|gibbus|Lutjanus gibbus (Forsskål, 1775)	2
Caesio lunaris Cuvier, 1830	Animalia|Chordata|Actinopterygii|Perciformes|Caesionidae|Caesio|lunaris|Caesio lunaris Cuvier, 1830	2
Pilodius Dana, 1852	Animalia|Arthropoda|Malacostraca|Decapoda|Xanthidae|Pilodius||Pilodius Dana, 1852	2
Euphorbia nigrispina N.E.Br.	Plantae|Tracheophyta|Magnoliopsida|Malpighiales|Euphorbiaceae|Euphorbia|nigrispina|Euphorbia nigrispina N.E.Br.	2
Ichthyaetus leucophthalmus (Temminck, 1825)	Animalia|Chordata|Aves|Charadriiformes|Laridae|Ichthyaetus|leucophthalmus|Ichthyaetus leucophthalmus (Temminck, 1825)	2
Chrysididae	Animalia|Arthropoda|Insecta|Hymenoptera|Chrysididae|||Chrysididae	2
Heterocentrotus mammillatus (Linnaeus, 1758)	Animalia|Echinodermata|Echinoidea|Camarodonta|Echinometridae|Heterocentrotus|mammillatus|Heterocentrotus mammillatus (Linnaeus, 1758)	2
Thespesiopsis Exell & Hillc.	Plantae|Magnoliophyta|Magnoliopsida|Malvales|Malvaceae|Thespesiopsis||Thespesiopsis Exell & Hillc.	2
Campethera nubica (Boddaert, 1783)	Animalia|Chordata|Aves|Piciformes|Picidae|Campethera|nubica|Campethera nubica (Boddaert, 1783)	2
Urorhipis rufifrons	Animalia|Chordata|Aves|Passeriformes|Cisticolidae|Urorhipis|rufifrons|Urorhipis rufifrons	2
Echeneis naucrates Linnaeus, 1758	Animalia|Chordata|Actinopterygii|Perciformes|Echeneidae|Echeneis|naucrates|Echeneis naucrates Linnaeus, 1758	2
Thorectidae Bergquist, 1978	Animalia|Porifera|Demospongiae|Dictyoceratida|Thorectidae|||Thorectidae Bergquist, 1978	2
Sylvia communis Latham, 1787	Animalia|Chordata|Aves|Passeriformes|Sylviidae|Sylvia|communis|Sylvia communis Latham, 1787	2
Pectinidae Rafinesque, 1815	Animalia|Mollusca|Bivalvia|Ostreoida|Pectinidae|||Pectinidae Rafinesque, 1815	2
Delonix elata (L.) Gamble	Plantae|Magnoliophyta|Magnoliopsida|Fabales|Fabaceae|Delonix|elata|Delonix elata (L.) Gamble	2
Epinephelus tauvina (Forsskål, 1775)	Animalia|Chordata|Actinopterygii|Perciformes|Serranidae|Epinephelus|tauvina|Epinephelus tauvina (Forsskål, 1775)	2
Acmaeodera Eschscholtz, 1829	Animalia|Arthropoda|Insecta|Coleoptera|Buprestidae|Acmaeodera||Acmaeodera Eschscholtz, 1829	2
Millepora dichotoma Forsskål, 1775	Animalia|Cnidaria|Hydrozoa|Anthoathecata|Milleporidae|Millepora|dichotoma|Millepora dichotoma Forsskål, 1775	2
Cephalopholis hemistiktos (Rüppell, 1830)	Animalia|Chordata|Actinopterygii|Perciformes|Serranidae|Cephalopholis|hemistiktos|Cephalopholis hemistiktos (Rüppell, 1830)	2
Cephalopholis argus Schneider, 1801	Animalia|Chordata|Actinopterygii|Perciformes|Serranidae|Cephalopholis|argus|Cephalopholis argus Schneider, 1801	2
Phylloscopus umbrovirens (Ruppell, 1840)	Animalia|Chordata|Aves|Passeriformes|Sylviidae|Phylloscopus|umbrovirens|Phylloscopus umbrovirens (Ruppell, 1840)	2
Corvus splendens Vieillot, 1817	Animalia|Chordata|Aves|Passeriformes|Corvidae|Corvus|splendens|Corvus splendens Vieillot, 1817	2
Sphyraena forsteri Cuvier, 1829	Animalia|Chordata|Actinopterygii|Perciformes|Sphyraenidae|Sphyraena|forsteri|Sphyraena forsteri Cuvier, 1829	2
Sternocera Eschscholtz, 1829	Animalia|Arthropoda|Insecta|Coleoptera|Buprestidae|Sternocera||Sternocera Eschscholtz, 1829	2
Ceratotherium Gray, 1868	Animalia|Chordata|Mammalia|Perissodactyla|Rhinocerotidae|Ceratotherium||Ceratotherium Gray, 1868	2
Solanum somalense Franch.	Plantae|Magnoliophyta|Magnoliopsida|Solanales|Solanaceae|Solanum|somalense|Solanum somalense Franch.	2
Alectis ciliaris (Bloch, 1787)	Animalia|Chordata|Actinopterygii|Perciformes|Carangidae|Alectis|ciliaris|Alectis ciliaris (Bloch, 1787)	2
Sphyraena obtusata Cuvier, 1829	Animalia|Chordata|Actinopterygii|Perciformes|Sphyraenidae|Sphyraena|obtusata|Sphyraena obtusata Cuvier, 1829	2
Muscicapa gambagae (Alexander, 1901)	Animalia|Chordata|Aves|Passeriformes|Muscicapidae|Muscicapa|gambagae|Muscicapa gambagae (Alexander, 1901)	2
Gerres acinaces Bleeker, 1854	Animalia|Chordata|Actinopterygii|Perciformes|Gerreidae|Gerres|acinaces|Gerres acinaces Bleeker, 1854	2
Fizesereneia Takeda & Tamura, 1980	Animalia|Arthropoda|Malacostraca|Decapoda|Cryptochiridae|Fizesereneia||Fizesereneia Takeda & Tamura, 1980	2
Tockus hemprichii (Ehrenberg, 1833)	Animalia|Chordata|Aves|Bucerotiformes|Bucerotidae|Tockus|hemprichii|Tockus hemprichii (Ehrenberg, 1833)	2
Hypoatherina temminckii (Bleeker, 1854)	Animalia|Chordata|Actinopterygii|Atheriniformes|Atherinidae|Hypoatherina|temminckii|Hypoatherina temminckii (Bleeker, 1854)	2
Abalistes stellatus (Anonymous, 1798)	Animalia|Chordata|Actinopterygii|Tetraodontiformes|Balistidae|Abalistes|stellatus|Abalistes stellatus (Anonymous, 1798)	2
Beatragus Heller, 1912	Animalia|Chordata|Mammalia|Artiodactyla|Bovidae|Beatragus||Beatragus Heller, 1912	2
Arothron nigropunctatus (Bloch & Schneider, 1801)	Animalia|Chordata|Actinopterygii|Tetraodontiformes|Tetraodontidae|Arothron|nigropunctatus|Arothron nigropunctatus (Bloch & Schneider, 1801)	2
Tockus flavirostris (Ruppell, 1835)	Animalia|Chordata|Aves|Bucerotiformes|Bucerotidae|Tockus|flavirostris|Tockus flavirostris (Ruppell, 1835)	2
Syncerus Hodgson, 1847	Animalia|Chordata|Mammalia|Artiodactyla|Bovidae|Syncerus||Syncerus Hodgson, 1847	2
Urocolius macrourus (Linnaeus, 1766)	Animalia|Chordata|Aves|Coliiformes|Coliidae|Urocolius|macrourus|Urocolius macrourus (Linnaeus, 1766)	2
Hemidactylus flaviviridis Rüppell, 1835	Animalia|Chordata|Reptilia|Squamata|Gekkonidae|Hemidactylus|flaviviridis|Hemidactylus flaviviridis Rüppell, 1835	2
Cirolanidae Dana, 1852	Animalia|Arthropoda|Malacostraca|Isopoda|Cirolanidae|||Cirolanidae Dana, 1852	2
Neopomacentrus cyanomos (Bleeker, 1856)	Animalia|Chordata|Actinopterygii|Perciformes|Pomacentridae|Neopomacentrus|cyanomos|Neopomacentrus cyanomos (Bleeker, 1856)	2
Lethrinus harak (Forsskål, 1775)	Animalia|Chordata|Actinopterygii|Perciformes|Lethrinidae|Lethrinus|harak|Lethrinus harak (Forsskål, 1775)	2
Laevichlamys superficialis (Forsskål, 1775)	Animalia|Mollusca|Bivalvia|Ostreoida|Pectinidae|Laevichlamys|superficialis|Laevichlamys superficialis (Forsskål, 1775)	2
Carangoides ferdau (Forsskål, 1775)	Animalia|Chordata|Actinopterygii|Perciformes|Carangidae|Carangoides|ferdau|Carangoides ferdau (Forsskål, 1775)	2
Aethaloperca rogaa (Forsskål, 1775)	Animalia|Chordata|Actinopterygii|Perciformes|Serranidae|Aethaloperca|rogaa|Aethaloperca rogaa (Forsskål, 1775)	2
Trimma macrophthalmum (Tomiyama, 1936)	Animalia|Chordata|Actinopterygii|Perciformes|Gobiidae|Trimma|macrophthalmum|Trimma macrophthalmum (Tomiyama, 1936)	2
Aristida L.	Plantae|Magnoliophyta|Liliopsida|Poales|Poaceae|Aristida||Aristida L.	2
Cercotrichas galactotes (Temminck, 1820)	Animalia|Chordata|Aves|Passeriformes|Muscicapidae|Cercotrichas|galactotes|Cercotrichas galactotes (Temminck, 1820)	2
Acrocephalus Naumann, 1811	Animalia|Chordata|Aves|Passeriformes|Sylviidae|Acrocephalus||Acrocephalus Naumann, 1811	2
Pomadasys furcatus (Bloch & Schneider, 1801)	Animalia|Chordata|Actinopterygii|Perciformes|Haemulidae|Pomadasys|furcatus|Pomadasys furcatus (Bloch & Schneider, 1801)	2
Leptoconchus Rüppell, 1834	Animalia|Mollusca|Gastropoda|Neogastropoda|Muricidae|Leptoconchus||Leptoconchus Rüppell, 1834	2
Protopalythoa Verrill, 1900	Animalia|Cnidaria|Anthozoa|Zoantharia|Zoanthidae|Protopalythoa||Protopalythoa Verrill, 1900	2
Conus striatellus Link, 1807	Animalia|Mollusca|Gastropoda|Neogastropoda|Conidae||striatellus|Conus striatellus Link, 1807	2
Xanthidae MacLeay, 1838	Animalia|Arthropoda|Malacostraca|Decapoda|Xanthidae|||Xanthidae MacLeay, 1838	2
Palaemonidae Rafinesque, 1815	Animalia|Arthropoda|Malacostraca|Decapoda|Palaemonidae|||Palaemonidae Rafinesque, 1815	2
Clathraria rubrinodis Gray, 1859	Animalia|Cnidaria|Anthozoa|Alcyonacea|Melithaeidae|Clathraria|rubrinodis|Clathraria rubrinodis Gray, 1859	2
Chaetodon mesoleucos Forsskål, 1775	Animalia|Chordata|Actinopterygii|Perciformes|Chaetodontidae|Chaetodon|mesoleucos|Chaetodon mesoleucos Forsskål, 1775	2
Euphorbia nigrispina N.E.Br.	Plantae|Magnoliophyta|Magnoliopsida|Malpighiales|Euphorbiaceae|Euphorbia|nigrispina|Euphorbia nigrispina N.E.Br.	2
Schizonycha angustiformis Fairmaire, 1892	Animalia|Arthropoda|Insecta|Coleoptera|Melolonthidae|Schizonycha|angustiformis|Schizonycha angustiformis Fairmaire, 1892	2
Oena capensis (Linnaeus, 1766)	Animalia|Chordata|Aves|Columbiformes|Columbidae|Oena|capensis|Oena capensis (Linnaeus, 1766)	2
Polyplacophora Blainvillle, 1816	Animalia|Mollusca|Polyplacophora|||||Polyplacophora Blainvillle, 1816	2
Terminalia catappa L.	Plantae|Magnoliophyta|Magnoliopsida|Myrtales|Combretaceae|Terminalia|catappa|Terminalia catappa L.	2
Ammomanes deserti (Lichtenstein, 1823)	Animalia|Chordata|Aves|Passeriformes|Alaudidae|Ammomanes|deserti|Ammomanes deserti (Lichtenstein, 1823)	2
Oenanthe isabellina (Temminck, 1829)	Animalia|Chordata|Aves|Passeriformes|Muscicapidae|Oenanthe|isabellina|Oenanthe isabellina (Temminck, 1829)	2
Cypraea annulus Linnaeus, 1758	Animalia|Mollusca|Gastropoda|Neotaenioglossa|Cypraeidae|Monetaria|annulus|Cypraea annulus Linnaeus, 1758	2
Coryphaena hippurus Linnaeus, 1758	Animalia|Chordata|Actinopterygii|Perciformes|Coryphaenidae|Coryphaena|hippurus|Coryphaena hippurus Linnaeus, 1758	2
Cuapetes tenuipes (Borradaile, 1898)	Animalia|Arthropoda|Malacostraca|Decapoda|Palaemonidae|Cuapetes|tenuipes|Cuapetes tenuipes (Borradaile, 1898)	2
Terpsiphone viridis (Müller, 1776)	Animalia|Chordata|Aves|Passeriformes|Monarchidae|Terpsiphone|viridis|Terpsiphone viridis (Müller, 1776)	2
Chrysococcyx caprius (Boddaert, 1783)	Animalia|Chordata|Aves|Cuculiformes|Cuculidae|Chrysococcyx|caprius|Chrysococcyx caprius (Boddaert, 1783)	2
Crenimugil crenilabis (Forsskål, 1775)	Animalia|Chordata|Actinopterygii|Mugiliformes|Mugilidae|Crenimugil|crenilabis|Crenimugil crenilabis (Forsskål, 1775)	2
Thalasseus bengalensis (Lesson, 1831)	Animalia|Chordata|Aves|Charadriiformes|Laridae|Thalaseus|bengalensis|Thalasseus bengalensis (Lesson, 1831)	2
Sargocentron rubrum (Forsskål, 1775)	Animalia|Chordata|Actinopterygii|Beryciformes|Holocentridae|Sargocentron|rubrum|Sargocentron rubrum (Forsskål, 1775)	2
Cercomela melanura (Temminck, 1824)	Animalia|Chordata|Aves|Passeriformes|Muscicapidae|Cercomela|melanura|Cercomela melanura (Temminck, 1824)	2
Ptychadena oxyrhynchus (Smith, 1849)	Animalia|Chordata|Amphibia|Anura|Ptychadenidae|Ptychadena|oxyrhynchus|Ptychadena oxyrhynchus (Smith, 1849)	2
Nemipterus zysron (Bleeker, 1856)	Animalia|Chordata|Actinopterygii|Perciformes|Nemipteridae|Nemipterus|zysron|Nemipterus zysron (Bleeker, 1856)	2
Antilopidae Gray, 1821	Animalia|Chordata|Mammalia|Artiodactyla|Bovidae|||Antilopidae Gray, 1821	2
Rhynchocinetes durbanensis Gordon, 1936	Animalia|Arthropoda|Malacostraca|Decapoda|Rhynchocinetidae|Rhynchocinetes|durbanensis|Rhynchocinetes durbanensis Gordon, 1936	2
Hippotragus Sundevall, 1846	Animalia|Chordata|Mammalia|Artiodactyla|Bovidae|Hippotragus||Hippotragus Sundevall, 1846	2
Chrysiptera biocellata (Quoy & Gaimard, 1825)	Animalia|Chordata|Actinopterygii|Perciformes|Pomacentridae|Chrysiptera|biocellata|Chrysiptera biocellata (Quoy & Gaimard, 1825)	2
Uromastyx Merrem, 1820	Animalia|Chordata|Reptilia|Squamata|Agamidae|Uromastyx||Uromastyx Merrem, 1820	2
Bathygobius cyclopterus (Valenciennes, 1837)	Animalia|Chordata|Actinopterygii|Perciformes|Gobiidae|Bathygobius|cyclopterus|Bathygobius cyclopterus (Valenciennes, 1837)	2
Iduna pallida (Hemprich & Ehrenberg, 1833)	Animalia|Chordata|Aves|Passeriformes|Acrocephalidae|Iduna|pallida|Iduna pallida (Hemprich & Ehrenberg, 1833)	2
Balanidae	Animalia|Arthropoda|Maxillopoda|Sessilia|Balanidae|||Balanidae	2
Connochaetes Lichtenstein, 1812	Animalia|Chordata|Mammalia|Artiodactyla|Bovidae|Connochaetes||Connochaetes Lichtenstein, 1812	2
Chaetopterus Cuvier, 1830	Animalia|Annelida|Polychaeta|Spionida|Chaetopteridae|Chaetopterus||Chaetopterus Cuvier, 1830	2
Alpheidae	Animalia|Arthropoda|Malacostraca|Decapoda|Alpheidae|||Alpheidae	2
Pterocles senegallus (Linnaeus, 1771)	Animalia|Chordata|Aves|Pteroclidiformes|Pteroclididae|Pterocles|senegallus|Pterocles senegallus (Linnaeus, 1771)	2
Haliotis Linnaeus, 1758	Animalia|Mollusca|Gastropoda|Archaeogastropoda|Haliotididae|Haliotis||Haliotis Linnaeus, 1758	2
Conus terebra Born, 1778	Animalia|Mollusca|Gastropoda|Neogastropoda|Conidae|Conus|terebra|Conus terebra Born, 1778	2
Acacia mellifera (M.Vahl) Benth.	Plantae|Magnoliophyta|Magnoliopsida|Fabales|Fabaceae|Acacia|mellifera|Acacia mellifera (M.Vahl) Benth.	2
Cyphostemma serpens (Hochst. ex A.Rich.) Desc.	Plantae|Tracheophyta|Magnoliopsida|Vitales|Vitaceae|Cyphostemma|serpens|Cyphostemma serpens (Hochst. ex A.Rich.) Desc.	2
Paramonacanthus pusillus (Rüppell, 1829)	Animalia|Chordata|Actinopterygii|Tetraodontiformes|Monacanthidae|Paramonacanthus|pusillus|Paramonacanthus pusillus (Rüppell, 1829)	2
Acacia retinodes Schltdl.	Plantae|Magnoliophyta|Magnoliopsida|Fabales|Fabaceae|Acacia|retinodes|Acacia retinodes Schltdl.	2
Acabaria Gray, 1859	Animalia|Cnidaria|Anthozoa|Alcyonacea|Melithaeidae|Melithaea||Acabaria Gray, 1859	2
Charadrius leschenaultii Lesson, 1826	Animalia|Chordata|Aves|Charadriiformes|Charadriidae|Charadrius|leschenaultii|Charadrius leschenaultii Lesson, 1826	2
Pseudochromis sankeyi Lubbock, 1975	Animalia|Chordata|Actinopterygii|Perciformes|Pseudochromidae|Pseudochromis|sankeyi|Pseudochromis sankeyi Lubbock, 1975	2
Millepora dichotoma (Forsskål, 1775)	Animalia|Cnidaria|Hydrozoa|Anthoathecata|Milleporidae|Millepora|dichotoma|Millepora dichotoma (Forsskål, 1775)	2
Ecsenius frontalis (Valenciennes, 1836)	Animalia|Chordata|Actinopterygii|Perciformes|Blenniidae|Ecsenius|frontalis|Ecsenius frontalis (Valenciennes, 1836)	2
Batis orientalis (Heuglin, 1870)	Animalia|Chordata|Aves|Passeriformes|Platysteiridae|Batis|orientalis|Batis orientalis (Heuglin, 1870)	2
Lithophaga Röding, 1798	Animalia|Mollusca|Bivalvia|Mytiloida|Mytilidae|Lithophaga||Lithophaga Röding, 1798	1
Serinus xanthopygius Rüppell, 1840	Animalia|Chordata|Aves|Passeriformes|Fringillidae|Serinus|xanthopygius|Serinus xanthopygius Rüppell, 1840	1
Odonus niger (Ruppell, 1836)	Animalia|Chordata|Actinopterygii|Tetraodontiformes|Balistidae|Odonus|niger|Odonus niger (Ruppell, 1836)	1
Egretta garzetta (Linnaeus, 1766)	Animalia|Chordata|Aves|Pelecaniformes|Ardeidae|Egretta|garzetta|Egretta garzetta (Linnaeus, 1766)	1
Cercotrichas galactotes (Temminck, 1820)	Animalia|Chordata|Aves|Passeriformes|Muscicapidae|Erythropygia|galactotes|Cercotrichas galactotes (Temminck, 1820)	1
Trachyphonus margaritatus subsp. somalicus Zedlitz, 1910	Animalia|Chordata|Aves|Piciformes|Ramphastidae|Trachyphonus|margaritatus|Trachyphonus margaritatus subsp. somalicus Zedlitz, 1910	1
Ptereleotris microlepis (Bleeker, 1856)	Animalia|Chordata|Actinopterygii|Perciformes|Microdesmidae|Ptereleotris|microlepis|Ptereleotris microlepis (Bleeker, 1856)	1
Cirolanidae	Animalia|Arthropoda|Malacostraca|Isopoda|Cirolanidae|||Cirolanidae	1
Pilodius Dana, 1851	Animalia|Arthropoda|Malacostraca|Decapoda|Xanthidae|Pilodius||Pilodius Dana, 1851	1
Emberiza tahapisi A. Smith, 1836	Animalia|Chordata|Aves|Passeriformes|Emberizidae|Emberiza|tahapisi|Emberiza tahapisi A. Smith, 1836	1
Pithecellobium dulce (Roxb.) Benth.	Plantae|Tracheophyta|Magnoliopsida|Fabales|Fabaceae|Pithecellobium|dulce|Pithecellobium dulce (Roxb.) Benth.	1
Calidris minuta (Leisler, 1812)	Animalia|Chordata|Aves|Charadriiformes|Scolopacidae|Calidris|minuta|Calidris minuta (Leisler, 1812)	1
Cercotrichas podobe (Statius Muller, 1776)	Animalia|Chordata|Aves|Passeriformes|Muscicapidae|Cercotrichas|podobe|Cercotrichas podobe (Statius Muller, 1776)	1
Suidae	Animalia|Chordata|Mammalia|Artiodactyla|Suidae|||Suidae	1
Pelorovis oldowayensis	Animalia|Chordata|Mammalia|Artiodactyla|Bovidae|Pelorovis|oldowayensis|Pelorovis oldowayensis	1
Conus angioiorum Röckel & Moolenbeek, 1992	Animalia|Mollusca|Gastropoda|Neogastropoda|Conidae||angioiorum|Conus angioiorum Röckel & Moolenbeek, 1992	1
Pelecanus onocrotalus Linnaeus, 1758	Animalia|Chordata|Aves|Pelecaniformes|Pelecanidae|Pelecanus|onocrotalus|Pelecanus onocrotalus Linnaeus, 1758	1
Monticola solitarius (Linnaeus, 1758)	Animalia|Chordata|Aves|Passeriformes|Turdidae|Monticola|solitarius|Monticola solitarius (Linnaeus, 1758)	1
Metridiochoerus andrewsi Hopwood, 1926	Animalia|Chordata|Mammalia|Artiodactyla|Suidae|Metridiochoerus|andrewsi|Metridiochoerus andrewsi Hopwood, 1926	1
Equus burchellii Gray, 1824	Animalia|Chordata|Mammalia|Perissodactyla|Equidae|Equus|burchellii|Equus burchellii Gray, 1824	1
Apogon novemfasciatus (non Cuvier, 1828)	Animalia|Chordata|Actinopterygii|Perciformes|Apogonidae|Ostorhinchus|novemfasciatus|Apogon novemfasciatus (non Cuvier, 1828)	1
Puffinus persicus Hume, 1872	Animalia|Chordata|Aves|Procellariiformes|Procellariidae|Puffinus|persicus|Puffinus persicus Hume, 1872	1
Trimma macrophthalmus (Tomiyama, 1936)	Animalia|Chordata|Actinopterygii|Perciformes|Gobiidae|Trimma|macrophthalmus|Trimma macrophthalmus (Tomiyama, 1936)	1
Teucrium spicastrum Hedge & A.G.Mill.	Plantae|Magnoliophyta|Magnoliopsida|Lamiales|Lamiaceae|Teucrium|spicastrum|Teucrium spicastrum Hedge & A.G.Mill.	1
Aloe mcloughlinii Chistian	Plantae|Magnoliophyta|Liliopsida|Asparagales|Xanthorrhoeaceae|Aloe|mcloughlinii|Aloe mcloughlinii Chistian	1
Hydroprogne caspia (Pallas, 1770)	Animalia|Chordata|Aves|Charadriiformes|Laridae|Hydroprogne|caspia|Hydroprogne caspia (Pallas, 1770)	1
Alopochen aegyptiaca (Linnaeus, 1766)	Animalia|Chordata|Aves|Anseriformes|Anatidae|Alopochen|aegyptiaca|Alopochen aegyptiaca (Linnaeus, 1766)	1
Thorectidae	Animalia|Porifera|Demospongiae|Dictyoceratida|Thorectidae|||Thorectidae	1
Buphagus erythrorhynchus (Stanley, 1814)	Animalia|Chordata|Aves|Passeriformes|Sturnidae|Buphagus|erythrorhynchus|Buphagus erythrorhynchus (Stanley, 1814)	1
Sylvia mystacea Ménétriès, 1832	Animalia|Chordata|Aves|Passeriformes|Sylviidae|Sylvia|mystacea|Sylvia mystacea Ménétriès, 1832	1
Streptopelia capicola (Sundevall, 1857)	Animalia|Chordata|Aves|Columbiformes|Columbidae|Streptopelia|capicola|Streptopelia capicola (Sundevall, 1857)	1
Thespesiopsis Exell & Hillc.	Plantae|Tracheophyta|Magnoliopsida|Malvales|Malvaceae|Thespesia||Thespesiopsis Exell & Hillc.	1
Turbo radiatus Gmelin, 1791	Animalia|Mollusca|Gastropoda||Turbinidae|Turbo|radiatus|Turbo radiatus Gmelin, 1791	1
Hyporhamphus dussumieri (Valenciennes, 1847)	Animalia|Chordata|Actinopterygii|Beloniformes|Hemiramphidae|Hyporhamphus|dussumieri|Hyporhamphus dussumieri (Valenciennes, 1847)	1
Bignoniaceae	Plantae|Tracheophyta|Magnoliopsida|Lamiales|Bignoniaceae|||Bignoniaceae	1
Lithoscaptus prionotus Kropp, 1994	Animalia|Arthropoda|Malacostraca|Decapoda|Cryptochiridae|Lithoscaptus|prionotus|Lithoscaptus prionotus Kropp, 1994	1
Acacia retinodes Schltdl.	Plantae|Tracheophyta|Magnoliopsida|Fabales|Fabaceae|Acacia|retinodes|Acacia retinodes Schltdl.	1
Euphorbia abyssinica J.F.Gmel.	Plantae|Tracheophyta|Magnoliopsida|Malpighiales|Euphorbiaceae|Euphorbia|abyssinica|Euphorbia abyssinica J.F.Gmel.	1
Megalotragus van Hoepen, 1932	Animalia|Chordata|Mammalia|Artiodactyla|Bovidae|Megalotragus||Megalotragus van Hoepen, 1932	1
Trochidae	Animalia|Mollusca|Gastropoda||Trochidae|||Trochidae	1
Conus acuminatus Hwass in Bruguière, 1792	Animalia|Mollusca|Gastropoda|Neogastropoda|Conidae||acuminatus|Conus acuminatus Hwass in Bruguière, 1792	1
Onychoprion fuscatus (Linnaeus, 1766)	Animalia|Chordata|Aves|Charadriiformes|Laridae|Onychoprion|fuscatus|Onychoprion fuscatus (Linnaeus, 1766)	1
Metridiochoerus andrewsi	Animalia|Chordata|Mammalia|Artiodactyla|Suidae|Metridiochoerus|andrewsi|Metridiochoerus andrewsi	1
Cuapetes tenuipes (Borradaile, 1898)	Animalia|Arthropoda|Malacostraca|Decapoda|Palaemonidae|Periclimenes|tenuipes|Cuapetes tenuipes (Borradaile, 1898)	1
Aloe rigens Reynolds & Bally	Plantae|Magnoliophyta|Liliopsida|Asparagales|Xanthorrhoeaceae|Aloe|rigens|Aloe rigens Reynolds & Bally	1
Bubulcus ibis (Linnaeus, 1758)	Animalia|Chordata|Aves|Pelecaniformes|Ardeidae|Bubulcus|ibis|Bubulcus ibis (Linnaeus, 1758)	1
Phoenicopterus minor E. Geoffroy Saint-Hilaire, 1798	Animalia|Chordata|Aves|Phoenicopteriformes|Phoenicopteridae|Phoeniconaias|minor|Phoenicopterus minor E. Geoffroy Saint-Hilaire, 1798	1
Pinctada Röding, 1798	Animalia|Mollusca|Bivalvia|Pterioida|Pteriidae|Pinctada||Pinctada Röding, 1798	1
Riparia riparia (Linnaeus, 1758)	Animalia|Chordata|Aves|Passeriformes|Hirundinidae|Riparia|riparia|Riparia riparia (Linnaeus, 1758)	1
Pithecellobium dulce (Roxb.) Benth.	Plantae|Magnoliophyta|Magnoliopsida|Fabales|Fabaceae|Pithecellobium|dulce|Pithecellobium dulce (Roxb.) Benth.	1
Lamyra vorax Loew, 1858	Animalia|Arthropoda|Insecta|Diptera|Asilidae|Lamyra|vorax|Lamyra vorax Loew, 1858	1
Equus burchelli (Gray, 1824) [orth. error]	Animalia|Chordata|Mammalia|Perissodactyla|Equidae|Equus|burchelli|Equus burchelli (Gray, 1824) [orth. error]	1
Megalotragus Van Hoepen, 1932	Animalia|Chordata|Mammalia|Artiodactyla|Bovidae|Megalotragus||Megalotragus Van Hoepen, 1932	1
Equus tabeti	Animalia|Chordata|Mammalia|Perissodactyla|Equidae|Equus|tabeti|Equus tabeti	1
Dendropicos namaquus schoensis (Ruppell, 1842)	Animalia|Chordata|Aves|Piciformes|Picidae|Dendropicos|namaquus|Dendropicos namaquus schoensis (Ruppell, 1842)	1
Sivatherium maurusium (Pomel, 1893)	Animalia|Chordata|Mammalia|Artiodactyla|Giraffidae|Sivatherium|maurusium|Sivatherium maurusium (Pomel, 1893)	1
Ardeola ralloides (Scopoli, 1769)	Animalia|Chordata|Aves|Pelecaniformes|Ardeidae|Ardeola|ralloides|Ardeola ralloides (Scopoli, 1769)	1
Pandion haliaetus (Linnaeus, 1758)	Animalia|Chordata|Aves|Accipitriformes|Pandionidae|Pandion|haliaetus|Pandion haliaetus (Linnaeus, 1758)	1
Cinachyra Sollas, 1886	Animalia|Porifera|Demospongiae|Tetractinellida|Tetillidae|Cinachyra||Cinachyra Sollas, 1886	1
Hemidactylus Gray, 1825	Animalia|Chordata|Reptilia|Squamata|Gekkonidae|Hemidactylus||Hemidactylus Gray, 1825	1
Pontoniinae Kingsley, 1878	Animalia|Arthropoda|Malacostraca|Decapoda|Pontoniinae|||Pontoniinae Kingsley, 1878	1
Xanthidae	Animalia|Arthropoda|Malacostraca|Decapoda|Xanthidae|||Xanthidae	1
Cypraea annulus Linnaeus, 1758	Animalia|Mollusca|Gastropoda|Littorinimorpha|Cypraeidae|Monetaria|annulus|Cypraea annulus Linnaeus, 1758	1
Halimeda discoidea Decaisne, 1842	Plantae|Chlorophyta|Ulvophyceae|Bryopsidales|Halimedaceae|Halimeda|discoidea|Halimeda discoidea Decaisne, 1842	1
Numenius phaeopus (Linnaeus, 1758)	Animalia|Chordata|Aves|Charadriiformes|Scolopacidae|Numenius|phaeopus|Numenius phaeopus (Linnaeus, 1758)	1
Prosopis juliflora (Sw.) DC.	Plantae|Magnoliophyta|Magnoliopsida|Fabales|Fabaceae|Prosopis|juliflora|Prosopis juliflora (Sw.) DC.	1
Wanella Anderson in Ross, 1999	Animalia|Arthropoda|Maxillopoda|Sessilia|Pyrgomatidae|Wanella||Wanella Anderson in Ross, 1999	1
Conus locumtenens Blumenbach, 1791	Animalia|Mollusca|Gastropoda|Neogastropoda|Conidae|Conus|locumtenens|Conus locumtenens Blumenbach, 1791	1
Himantura uarnak (Gmelin, 1789)	Animalia|Chordata|Elasmobranchii|Rajiformes|Dasyatidae|Himantura|uarnak|Himantura uarnak (Gmelin, 1789)	1
Ecsenius gravieri (Pellegrin, 1906)	Animalia|Chordata|Actinopterygii|Perciformes|Blenniidae|Ecsenius|gravieri|Ecsenius gravieri (Pellegrin, 1906)	1
Leptoconchus Rüppell, 1835	Animalia|Mollusca|Gastropoda|Neogastropoda|Muricidae|Leptoconchus||Leptoconchus Rüppell, 1835	1
Conus erythraeensis Reeve, 1843	Animalia|Mollusca|Gastropoda|Neogastropoda|Conidae||erythraeensis|Conus erythraeensis Reeve, 1843	1
Odonus niger (Rüppell, 1836)	Animalia|Chordata|Actinopterygii|Tetraodontiformes|Balistidae|Odonus|niger|Odonus niger (Rüppell, 1836)	1
Conus cuneolus Reeve, 1843	Animalia|Mollusca|Gastropoda|Neogastropoda|Conidae||cuneolus|Conus cuneolus Reeve, 1843	1
Aloe rigens Reynolds & P.R.O.Bally	Plantae|Tracheophyta|Liliopsida|Asparagales|Xanthorrhoeaceae|Aloë|rigens|Aloe rigens Reynolds & P.R.O.Bally	1
Tropiocolotes somalicus Lanza, 1990	Animalia|Chordata|Reptilia|Squamata|Gekkonidae|Tropiocolotes|somalicus|Tropiocolotes somalicus Lanza, 1990	1
Euphorbia nubica N.E.Br.	Plantae|Tracheophyta|Magnoliopsida|Malpighiales|Euphorbiaceae|Euphorbia|nubica|Euphorbia nubica N.E.Br.	1
Phylloscopus collybita (Vieillot, 1817)	Animalia|Chordata|Aves|Passeriformes|Sylviidae|Phylloscopus|collybita|Phylloscopus collybita (Vieillot, 1817)	1
Motacilla alba Linnaeus, 1758	Animalia|Chordata|Aves|Passeriformes|Motacillidae|Motacilla|alba|Motacilla alba Linnaeus, 1758	1
Psammophis punctulatus Duméril & Bibron, 1854	Animalia|Chordata|Reptilia|Squamata|Lamprophiidae|Psammophis|punctulatus|Psammophis punctulatus Duméril & Bibron, 1854	1
Racilius compressus	Animalia|Arthropoda|Malacostraca|Decapoda|Alpheidae|Racilius|compressus|Racilius compressus	1
Antipatharia	Animalia|Cnidaria|Anthozoa|Antipatharia|Antipathidae|Antipatharia||Antipatharia	1
Conus striatellus Link, 1807	Animalia|Mollusca|Gastropoda|Neogastropoda|Conidae|Conus|striatellus|Conus striatellus Link, 1807	1
Cercotrichas minor	Animalia|Chordata|Aves|Passeriformes|Muscicapidae|Cercotrichas|minor|Cercotrichas minor	1
Conus jickelii Weinkauff, 1873	Animalia|Mollusca|Gastropoda|Neogastropoda|Conidae|Conus|jickelii|Conus jickelii Weinkauff, 1873	1
Veneridae Rafinesque, 1815	Animalia|Mollusca|Bivalvia|Veneroida|Veneridae|||Veneridae Rafinesque, 1815	1
Paguridae	Animalia|Arthropoda|Malacostraca|Decapoda|Paguridae|||Paguridae	1
Calidris alba (Pallas, 1764)	Animalia|Chordata|Aves|Charadriiformes|Scolopacidae|Calidris|alba|Calidris alba (Pallas, 1764)	1
Asclepiadaceae Borkh.	Plantae|Tracheophyta|Magnoliopsida|Gentianales|Apocynaceae|||Asclepiadaceae Borkh.	1
Conus acuminatus Hwass in Bruguière, 1792	Animalia|Mollusca|Gastropoda|Neogastropoda|Conidae|Conus|acuminatus|Conus acuminatus Hwass in Bruguière, 1792	1
Galatheidae	Animalia|Arthropoda|Malacostraca|Decapoda|Galatheidae|||Galatheidae	1
Scolopsis bimaculata Rüppell, 1828	Animalia|Chordata|Actinopterygii|Perciformes|Nemipteridae|Scolopsis|bimaculata|Scolopsis bimaculata Rüppell, 1828	1
Euphorbia nubica N.E.Br.	Plantae|Magnoliophyta|Magnoliopsida|Malpighiales|Euphorbiaceae|Euphorbia|nubica|Euphorbia nubica N.E.Br.	1
Mus setulosus Peters, 1876	Animalia|Chordata|Mammalia|Rodentia|Muridae|Mus|setulosus|Mus setulosus Peters, 1876	1
Coracias garrulus Linnaeus, 1758	Animalia|Chordata|Aves|Coraciiformes|Coraciidae|Coracias|garrulus|Coracias garrulus Linnaeus, 1758	1
Clathraria rubrinodis Gray, 1859	Animalia|Cnidaria|Anthozoa|Alcyonacea|Melithaeidae|Melithaea|rubrinodis|Clathraria rubrinodis Gray, 1859	1
Larus cachinnans Pallas, 1811	Animalia|Chordata|Aves|Charadriiformes|Laridae|Larus|cachinnans|Larus cachinnans Pallas, 1811	1
Acacia mellifera (Vahl.) Benth.	Plantae|Tracheophyta|Magnoliopsida|Fabales|Fabaceae|Senegalia|mellifera|Acacia mellifera (Vahl.) Benth.	1
Conus arenatus Hwass in Bruguière, 1792	Animalia|Mollusca|Gastropoda|Neogastropoda|Conidae|Conus|arenatus|Conus arenatus Hwass in Bruguière, 1792	1
Chaetopteridae	Animalia|Annelida|Polychaeta|Spionida|Chaetopteridae|||Chaetopteridae	1
Buphagus erythrorhynchus (Stanley, 1814)	Animalia|Chordata|Aves|Passeriformes|Buphagidae|Buphagus|erythrorhynchus|Buphagus erythrorhynchus (Stanley, 1814)	1
Oenanthe xanthoprymna (Ehrenberg, 1833)	Animalia|Chordata|Aves|Passeriformes|Muscicapidae|Oenanthe|xanthoprymna|Oenanthe xanthoprymna (Ehrenberg, 1833)	1
Pseudosquillana richeri (Moosa, 1991)	Animalia|Arthropoda|Malacostraca|Stomatopoda|Pseudosquillidae|Pseudosquillana|richeri|Pseudosquillana richeri (Moosa, 1991)	1
Bufo dodsoni Boulenger, 1895	Animalia|Chordata|Amphibia|Anura|Bufonidae|Bufo|dodsoni|Bufo dodsoni Boulenger, 1895	1
Psittacula krameri (Scopoli, 1769)	Animalia|Chordata|Aves|Psittaciformes|Psittacidae|Psittacula|krameri|Psittacula krameri (Scopoli, 1769)	1
Thalasseus sandvicensis (Latham, 1787)	Animalia|Chordata|Aves|Charadriiformes|Laridae|Thalasseus|sandvicensis|Thalasseus sandvicensis (Latham, 1787)	1
Ophiolepis Müller & Troschel, 1840	Animalia|Echinodermata|Ophiuroidea|Ophiurida|Ophiolepididae|Ophiolepis||Ophiolepis Müller & Troschel, 1840	1
Hyporhamphus Gill, 1859	Animalia|Chordata|Actinopterygii|Beloniformes|Hemiramphidae|Hyporhamphus||Hyporhamphus Gill, 1859	1
Calandrella blanfordi (Shelley, 1902)	Animalia|Chordata|Aves|Passeriformes|Alaudidae|Calandrella|blanfordi|Calandrella blanfordi (Shelley, 1902)	1
Halimeda cylindracea Decaisne, 1842	Plantae|Chlorophyta|Ulvophyceae|Bryopsidales|Halimedaceae|Halimeda|cylindracea|Halimeda cylindracea Decaisne, 1842	1
Oenanthe leucopyga (Brehm, 1855)	Animalia|Chordata|Aves|Passeriformes|Muscicapidae|Oenanthe|leucopyga|Oenanthe leucopyga (Brehm, 1855)	1
Platalea leucorodia Linnaeus, 1758	Animalia|Chordata|Aves|Pelecaniformes|Threskiornithidae|Platalea|leucorodia|Platalea leucorodia Linnaeus, 1758	1
Protopalythoa	Animalia|Cnidaria|Anthozoa|Zoantharia|Zoanthidae|Protopalythoa||Protopalythoa	1
Urorhipis rufifrons (Rüppell, 1840)	Animalia|Chordata|Aves|Passeriformes|Cisticolidae|Urorhipis|rufifrons|Urorhipis rufifrons (Rüppell, 1840)	1
Conus inscriptus Reeve, 1845	Animalia|Mollusca|Gastropoda|Neogastropoda|Conidae||inscriptus|Conus inscriptus Reeve, 1845	1
Siganus oramin (Bloch & Schneider, 1801)	Animalia|Chordata|Actinopterygii|Perciformes|Siganidae|Siganus|oramin|Siganus oramin (Bloch & Schneider, 1801)	1
Sternula saundersi (Hume, 1877)	Animalia|Chordata|Aves|Charadriiformes|Laridae|Sternula|saundersi|Sternula saundersi (Hume, 1877)	1
Laevichlamys lemniscata (Reeve, 1853)	Animalia|Cnidaria|Anthozoa|Scleractinia|Pectiniidae|Scaeochlamys|lemniscata|Laevichlamys lemniscata (Reeve, 1853)	1
Lagonosticta senegala (Linnaeus, 1766)	Animalia|Chordata|Aves|Passeriformes|Estrildidae|Lagonosticta|senegala|Lagonosticta senegala (Linnaeus, 1766)	1
Ipomoea pes-caprae (L.) R. Br.	Plantae|Tracheophyta|Magnoliopsida|Solanales|Convolvulaceae|Ipomoea|pes-caprae|Ipomoea pes-caprae (L.) R. Br.	1
Aerva javanica (Burm. f.) Juss. ex Schult.	Plantae|Magnoliophyta|Magnoliopsida|Caryophyllales|Amaranthaceae|Aerva|javanica|Aerva javanica (Burm. f.) Juss. ex Schult.	1
Conus arenatus var. aequipunctata Dautzenberg, 1937	Animalia|Mollusca|Gastropoda|Neogastropoda|Conidae||arenatus|Conus arenatus var. aequipunctata Dautzenberg, 1937	1
Buccinidae	Animalia|Mollusca|Gastropoda|Neogastropoda|Buccinidae|||Buccinidae	1
Scolopsis taeniata (Cuvier, 1830)	Animalia|Chordata|Actinopterygii|Perciformes|Nemipteridae|Scolopsis|taeniata|Scolopsis taeniata (Cuvier, 1830)	1
Kobus kob (Erxleben, 1777)	Animalia|Chordata|Mammalia|Artiodactyla|Bovidae|Kobus|kob|Kobus kob (Erxleben, 1777)	1
Tropiocolotes somalicus Parker, 1942	Animalia|Chordata|Reptilia|Squamata|Gekkonidae|Tropiocolotes|somalicus|Tropiocolotes somalicus Parker, 1942	1
Balanites rotundifolius Blatt.	Plantae|Magnoliophyta|Magnoliopsida|Zygophyllales|Zygophyllaceae|Balanites|rotundifolius|Balanites rotundifolius Blatt.	1
Elephas Linnaeus, 1758	Animalia|Chordata|Mammalia|Proboscidea|Elephantidae|Elephas||Elephas Linnaeus, 1758	1
Calotropis procera (Aiton) W. T. Aiton	Plantae|Tracheophyta|Magnoliopsida|Gentianales|Apocynaceae|Calotropis|procera|Calotropis procera (Aiton) W. T. Aiton	1
Liza macrolepis (Smith, 1846)	Animalia|Chordata|Actinopterygii|Mugiliformes|Mugilidae|Liza|macrolepis|Liza macrolepis (Smith, 1846)	1
Polyplacophora	Animalia|Mollusca|Polyplacophora|||||Polyplacophora	1
Aristida L.	Plantae|Tracheophyta|Liliopsida|Poales|Poaceae|Aristida||Aristida L.	1
Oenanthe hispanica (Linnaeus, 1758)	Animalia|Chordata|Aves|Passeriformes|Muscicapidae|Oenanthe|hispanica|Oenanthe hispanica (Linnaeus, 1758)	1
Ostreoida	Animalia|Mollusca|Bivalvia|Ostreoida||||Ostreoida	1
Campylanthus junceus Edgew.	Plantae|Magnoliophyta|Magnoliopsida|Lamiales|Scrophulariaceae|Campylanthus|junceus|Campylanthus junceus Edgew.	1
Rhodophoneus cruentus (Hemprich & Ehrenberg, 1828)	Animalia|Chordata|Aves|Passeriformes|Malaconotidae|Telophorus|cruentus|Rhodophoneus cruentus (Hemprich & Ehrenberg, 1828)	1
Acalypha crenata Hochst. ex A.Rich.	Plantae|Magnoliophyta|Magnoliopsida|Malpighiales|Euphorbiaceae|Acalypha|crenata|Acalypha crenata Hochst. ex A.Rich.	1
Veneridae	Animalia|Mollusca|Bivalvia|Veneroida|Veneridae|||Veneridae	1
Lopha cristagalli (Linnaeus, 1758)	Animalia|Mollusca|Bivalvia|Ostreoida|Ostreidae|Lopha|cristagalli|Lopha cristagalli (Linnaeus, 1758)	1
Caranx sexfasciatus Quoy & Gaimard, 1825	Animalia|Chordata|Actinopterygii|Perciformes|Carangidae|Caranx|sexfasciatus|Caranx sexfasciatus Quoy & Gaimard, 1825	1
Cypraea pantherina Lightfoot, 1786	Animalia|Mollusca|Gastropoda|Littorinimorpha|Cypraeidae|Cypraea|pantherina|Cypraea pantherina Lightfoot, 1786	1
Oenanthe bottae (Bonaparte, 1854)	Animalia|Chordata|Aves|Passeriformes|Muscicapidae|Oenanthe|bottae|Oenanthe bottae (Bonaparte, 1854)	1
Siganus oramin (non Schneider, 1801)	Animalia|Chordata|Actinopterygii|Perciformes|Siganidae|Siganus|oramin|Siganus oramin (non Schneider, 1801)	1
Damaliscus Sclater & Thomas, 1894	Animalia|Chordata|Mammalia|Artiodactyla|Bovidae|Damaliscus||Damaliscus Sclater & Thomas, 1894	1
Conus namocanus Hwass in Bruguière, 1792	Animalia|Mollusca|Gastropoda|Neogastropoda|Conidae||namocanus|Conus namocanus Hwass in Bruguière, 1792	1
Aloe mcloughlinii Chistian	Plantae|Tracheophyta|Liliopsida|Asparagales|Xanthorrhoeaceae|Aloë|mcloughlinii|Aloe mcloughlinii Chistian	1
Ptereleotris microlepis (Bleeker, 1856)	Animalia|Chordata|Actinopterygii|Perciformes|Ptereleotridae|Ptereleotris|microlepis|Ptereleotris microlepis (Bleeker, 1856)	1
Pelorovis oldowayensis Reck, 1928	Animalia|Chordata|Mammalia|Artiodactyla|Bovidae|Pelorovis|oldowayensis|Pelorovis oldowayensis Reck, 1928	1
Ptyonoprogne fuligula (Lichtenstein, 1842)	Animalia|Chordata|Aves|Passeriformes|Hirundinidae|Ptyonoprogne|fuligula|Ptyonoprogne fuligula (Lichtenstein, 1842)	1
Halimeda discoidea Decaisne	Plantae|Chlorophyta|Bryopsidophyceae|Bryopsidales|Halimedaceae|Halimeda|discoidea|Halimeda discoidea Decaisne	1
Liza macrolepis (Smith, 1846)	Animalia|Chordata|Actinopterygii|Mugiliformes|Mugilidae|Chelon|macrolepis|Liza macrolepis (Smith, 1846)	1
Damaliscus P. L. Sclater & Thomas, 1894	Animalia|Chordata|Mammalia|Artiodactyla|Bovidae|Damaliscus||Damaliscus P. L. Sclater & Thomas, 1894	1
Scolopsis taeniatus (Cuvier, 1830)	Animalia|Chordata|Actinopterygii|Perciformes|Nemipteridae|Scolopsis|taeniatus|Scolopsis taeniatus (Cuvier, 1830)	1
Conus betulinus Linnaeus, 1758	Animalia|Mollusca|Gastropoda|Neogastropoda|Conidae||betulinus|Conus betulinus Linnaeus, 1758	1
Acacia laeta R.Br. ex Benth.	Plantae|Tracheophyta|Magnoliopsida|Fabales|Fabaceae|Senegalia|laeta|Acacia laeta R.Br. ex Benth.	1
Commiphora Jacq.	Plantae|Tracheophyta|Magnoliopsida|Sapindales|Burseraceae|Commiphora||Commiphora Jacq.	1
Carpospiza brachydactyla (Bonaparte, 1850)	Animalia|Chordata|Aves|Passeriformes|Passeridae|Carpospiza|brachydactyla|Carpospiza brachydactyla (Bonaparte, 1850)	1
Estrilda rhodopyga Sundevall, 1850	Animalia|Chordata|Aves|Passeriformes|Estrildidae|Estrilda|rhodopyga|Estrilda rhodopyga Sundevall, 1850	1
Monticola solitarius (Linnaeus, 1758)	Animalia|Chordata|Aves|Passeriformes|Muscicapidae|Monticola|solitarius|Monticola solitarius (Linnaeus, 1758)	1
Passer castanopterus Blyth, 1856	Animalia|Chordata|Aves|Passeriformes|Passeridae|Passer|castanopterus|Passer castanopterus Blyth, 1856	1
Ophiolepis cincta Müller & Troschel, 1842	Animalia|Echinodermata|Ophiuroidea|Ophiurida|Ophiolepididae|Ophiolepis|cincta|Ophiolepis cincta Müller & Troschel, 1842	1
Hapalocarcinus marsupialis Stimpson, 1859	Animalia|Arthropoda|Malacostraca|Decapoda|Cryptochiridae|Hapalocarcinus|marsupialis|Hapalocarcinus marsupialis Stimpson, 1859	1
Coluber rhodorachis Flower, 1933	Animalia|Chordata|Reptilia|Squamata|Colubridae|Platyceps|rhodorachis|Coluber rhodorachis Flower, 1933	1
Limosa lapponica (Linnaeus, 1758)	Animalia|Chordata|Aves|Charadriiformes|Scolopacidae|Limosa|lapponica|Limosa lapponica (Linnaeus, 1758)	1
Anthus similis Jerdon, 1840	Animalia|Chordata|Aves|Passeriformes|Motacillidae|Anthus|similis|Anthus similis Jerdon, 1840	1
Balanites rotundifolia (van Tiegh.) Blatter	Plantae|Tracheophyta|Magnoliopsida|Zygophyllales|Zygophyllaceae|Balanites|rotundifolia|Balanites rotundifolia (van Tiegh.) Blatter	1
Redunca Hamilton Smith, 1827	Animalia|Chordata|Mammalia|Artiodactyla|Bovidae|Redunca||Redunca Hamilton Smith, 1827	1
Cerithium echinatum Lamarck, 1822	Animalia|Mollusca|Gastropoda||Cerithiidae|Cerithium|echinatum|Cerithium echinatum Lamarck, 1822	1
Vasum Röding, 1798	Animalia|Mollusca|Gastropoda|Neogastropoda|Turbinellidae|Vasum||Vasum Röding, 1798	1
Muscicapa striata sarudnyi	Animalia|Chordata|Aves|Passeriformes|Muscicapidae|Muscicapa|striata|Muscicapa striata sarudnyi	1
Suidae Gray, 1821	Animalia|Chordata|Mammalia|Artiodactyla|Suidae|||Suidae Gray, 1821	1
Hippolais languida (Hemprich & Ehrenberg, 1833)	Animalia|Chordata|Aves|Passeriformes|Acrocephalidae|Hippolais|languida|Hippolais languida (Hemprich & Ehrenberg, 1833)	1
Sivatherium maurusium	Animalia|Chordata|Mammalia|Artiodactyla|Giraffidae|Sivatherium|maurusium|Sivatherium maurusium	1
Pelecanus rufescens Gmelin, 1789	Animalia|Chordata|Aves|Pelecaniformes|Pelecanidae|Pelecanus|rufescens|Pelecanus rufescens Gmelin, 1789	1
Chlidonias leucopterus (Temminck, 1815)	Animalia|Chordata|Aves|Charadriiformes|Laridae|Chlidonias|leucopterus|Chlidonias leucopterus (Temminck, 1815)	1
Giraffidae Gray, 1821	Animalia|Chordata|Mammalia|Artiodactyla|Giraffidae|||Giraffidae Gray, 1821	1
Nemertea	Animalia|Nemertea||||||Nemertea	1
Ophiocoma cynthiae Benavides-Serrato & O'Hara, 2008	Animalia|Echinodermata|Ophiuroidea|Ophiurida|Ophiocomidae|Ophiocoma|cynthiae|Ophiocoma cynthiae Benavides-Serrato & O'Hara, 2008	1
Halimeda cylindracea Decaisne	Plantae|Chlorophyta|Bryopsidophyceae|Bryopsidales|Halimedaceae|Halimeda|cylindracea|Halimeda cylindracea Decaisne	1
Euphorbia abyssinica J.F.Gmel.	Plantae|Magnoliophyta|Magnoliopsida|Malpighiales|Euphorbiaceae|Euphorbia|abyssinica|Euphorbia abyssinica J.F.Gmel.	1
Euphorbia cuneata Vahl	Plantae|Magnoliophyta|Magnoliopsida|Malpighiales|Euphorbiaceae|Euphorbia|cuneata|Euphorbia cuneata Vahl	1
Muscicapa striata subsp. sarudnyi	Animalia|Chordata|Aves|Passeriformes|Muscicapidae|Muscicapa|striata|Muscicapa striata subsp. sarudnyi	1
Giraffidae	Animalia|Chordata|Mammalia|Artiodactyla|Giraffidae|||Giraffidae	1
Himantura uarnak (Gmelin, 1789)	Animalia|Chordata|Elasmobranchii|Myliobatiformes|Dasyatidae|Himantura|uarnak|Himantura uarnak (Gmelin, 1789)	1
Phyllidia Cuvier, 1797	Animalia|Mollusca|Gastropoda|Nudibranchia|Phyllidiidae|Phyllidia||Phyllidia Cuvier, 1797	1
Muricidae	Animalia|Mollusca|Gastropoda|Neogastropoda|Muricidae|||Muricidae	1
Tringa nebularia (Gunnerus, 1767)	Animalia|Chordata|Aves|Charadriiformes|Scolopacidae|Tringa|nebularia|Tringa nebularia (Gunnerus, 1767)	1
Euodice cantans	Animalia|Chordata|Aves|Passeriformes|Estrildidae|Euodice|cantans|Euodice cantans	1
Tridacna squamosa Lamarck, 1819	Animalia|Mollusca|Bivalvia|Veneroida|Cardiidae|Tridacna|squamosa|Tridacna squamosa Lamarck, 1819	1
Scolopsis bimaculatus Rüppell, 1828	Animalia|Chordata|Actinopterygii|Perciformes|Nemipteridae|Scolopsis|bimaculatus|Scolopsis bimaculatus Rüppell, 1828	1
Merops albicollis Vieillot, 1817	Animalia|Chordata|Aves|Coraciiformes|Meropidae|Merops|albicollis|Merops albicollis Vieillot, 1817	1
Anous stolidus (Linnaeus, 1758)	Animalia|Chordata|Aves|Charadriiformes|Laridae|Anous|stolidus|Anous stolidus (Linnaeus, 1758)	1
Hemidactylus Oken, 1817	Animalia|Chordata|Reptilia|Squamata|Gekkonidae|Hemidactylus||Hemidactylus Oken, 1817	1
Haliotis Linnaeus, 1758	Animalia|Mollusca|Gastropoda||Haliotidae|Haliotis||Haliotis Linnaeus, 1758	1
Lantana camara L.	Plantae|Tracheophyta|Magnoliopsida|Lamiales|Verbenaceae|Lantana|camara|Lantana camara L.	1
Teucrium spicastrum Hedge & A.G.Mill.	Plantae|Tracheophyta|Magnoliopsida|Lamiales|Lamiaceae|Teucrium|spicastrum|Teucrium spicastrum Hedge & A.G.Mill.	1
Equus tabeti Arambourg, 1970	Animalia|Chordata|Mammalia|Perissodactyla|Equidae|Equus|tabeti|Equus tabeti Arambourg, 1970	1
Gonodactylellus Manning, 1995	Animalia|Arthropoda|Malacostraca|Stomatopoda|Gonodactylidae|Gonodactylellus||Gonodactylellus Manning, 1995	1
Cypraea pantherina Lightfoot, 1786	Animalia|Mollusca|Gastropoda|Neotaenioglossa|Cypraeidae|Cypraea|pantherina|Cypraea pantherina Lightfoot, 1786	1
Heterocentrotus mamillatus (Linnaeus, 1758)	Animalia|Echinodermata|Echinoidea|Camarodonta|Echinometridae|Heterocentrotus|mamillatus|Heterocentrotus mamillatus (Linnaeus, 1758)	1
Euphorbia cuneata Vahl	Plantae|Tracheophyta|Magnoliopsida|Malpighiales|Euphorbiaceae|Euphorbia|cuneata|Euphorbia cuneata Vahl	1
Oenanthe deserti (Temminck, 1825)	Animalia|Chordata|Aves|Passeriformes|Muscicapidae|Oenanthe|deserti|Oenanthe deserti (Temminck, 1825)	1
Chaetopterus Cuvier, 1827	Animalia|Annelida|Polychaeta|Spionida|Chaetopteridae|Chaetopterus||Chaetopterus Cuvier, 1827	1
Gastrochaenidae	Animalia|Mollusca|Bivalvia|Myoida|Gastrochaenidae|||Gastrochaenidae	1
Acalypha crenata Hochst. ex A.Rich.	Plantae|Tracheophyta|Magnoliopsida|Malpighiales|Euphorbiaceae|Acalypha|crenata|Acalypha crenata Hochst. ex A.Rich.	1
Asterropteryx semipunctatus Rüppell, 1830	Animalia|Chordata|Actinopterygii|Perciformes|Gobiidae|Asterropteryx|semipunctatus|Asterropteryx semipunctatus Rüppell, 1830	1
Ardea alba Linnaeus, 1758	Animalia|Chordata|Aves|Pelecaniformes|Ardeidae|Ardea|alba|Ardea alba Linnaeus, 1758	1
Solanum somalense Franch.	Plantae|Tracheophyta|Magnoliopsida|Solanales|Solanaceae|Solanum|somalense|Solanum somalense Franch.	1
Cercomela dubia (Blundell & Lovat, 1899)	Animalia|Chordata|Aves|Passeriformes|Muscicapidae|Cercomela|dubia|Cercomela dubia (Blundell & Lovat, 1899)	1
Lithoscaptus tri (Fize & Serène, 1956)	Animalia|Arthropoda|Malacostraca|Decapoda|Cryptochiridae|Lithoscaptus|tri|Lithoscaptus tri (Fize & Serène, 1956)	1
Terminalia catappa L.	Plantae|Tracheophyta|Magnoliopsida|Myrtales|Combretaceae|Terminalia|catappa|Terminalia catappa L.	1
Passer euchlorus (Bonaparte, 1850)	Animalia|Chordata|Aves|Passeriformes|Passeridae|Passer|euchlorus|Passer euchlorus (Bonaparte, 1850)	1
Ophiolepis cincta Müller & Troschel, 1842	Animalia|Echinodermata|Ophiuroidea|Ophiurida|Ophiuridae|Ophiocten|cincta|Ophiolepis cincta Müller & Troschel, 1842	1
Redunca C. H. Smith, 1827	Animalia|Chordata|Mammalia|Artiodactyla|Bovidae|Redunca||Redunca C. H. Smith, 1827	1
Columbellidae	Animalia|Mollusca|Gastropoda|Neogastropoda|Columbellidae|||Columbellidae	1
Hirundo rustica Linnaeus, 1758	Animalia|Chordata|Aves|Passeriformes|Hirundinidae|Hirundo|rustica|Hirundo rustica Linnaeus, 1758	1
Apogon Lacepède, 1801	Animalia|Chordata|Actinopterygii|Perciformes|Apogonidae|Apogon||Apogon Lacepède, 1801	1
Coluber rhodorachis Jan, 1865	Animalia|Chordata|Reptilia|Squamata|Colubridae|Coluber|rhodorachis|Coluber rhodorachis Jan, 1865	1
Ecsenius McCulloch, 1923	Animalia|Chordata|Actinopterygii|Perciformes|Blenniidae|Ecsenius||Ecsenius McCulloch, 1923	1
Petrolisthes moluccensis (de Man, 1888)	Animalia|Arthropoda|Malacostraca|Decapoda|Porcellanidae|Petrolisthes|moluccensis|Petrolisthes moluccensis (de Man, 1888)	1