taxonName	taxonPath	recordCount
Larus michahellis J. F. Naumann, 1840	Animalia|Chordata|Aves|Charadriiformes|Laridae|Larus|michahellis|Larus michahellis J. F. Naumann, 1840	44
Passer domesticus (Linnaeus, 1758)	Animalia|Chordata|Aves|Passeriformes|Passeridae|Passer|domesticus|Passer domesticus (Linnaeus, 1758)	29
Turdus merula Linnaeus, 1758	Animalia|Chordata|Aves|Passeriformes|Turdidae|Turdus|merula|Turdus merula Linnaeus, 1758	25
Columba livia Gmelin, 1789	Animalia|Chordata|Aves|Columbiformes|Columbidae|Columba|livia|Columba livia Gmelin, 1789	23
Falco peregrinus Tunstall, 1771	Animalia|Chordata|Aves|Falconiformes|Falconidae|Falco|peregrinus|Falco peregrinus Tunstall, 1771	22
Milvus migrans (Boddaert, 1783)	Animalia|Chordata|Aves|Accipitriformes|Accipitridae|Milvus|migrans|Milvus migrans (Boddaert, 1783)	19
Sylvia atricapilla (Linnaeus, 1758)	Animalia|Chordata|Aves|Passeriformes|Sylviidae|Sylvia|atricapilla|Sylvia atricapilla (Linnaeus, 1758)	19
Sylvia melanocephala (Gmelin, 1789)	Animalia|Chordata|Aves|Passeriformes|Sylviidae|Sylvia|melanocephala|Sylvia melanocephala (Gmelin, 1789)	18
Alectoris barbara (Bonnaterre, 1792)	Animalia|Chordata|Aves|Galliformes|Phasianidae|Alectoris|barbara|Alectoris barbara (Bonnaterre, 1792)	17
Sturnus unicolor Temminck, 1820	Animalia|Chordata|Aves|Passeriformes|Sturnidae|Sturnus|unicolor|Sturnus unicolor Temminck, 1820	17
Larus fuscus Linnaeus, 1758	Animalia|Chordata|Aves|Charadriiformes|Laridae|Larus|fuscus|Larus fuscus Linnaeus, 1758	12
Cyanistes caeruleus (Linnaeus, 1758)	Animalia|Chordata|Aves|Passeriformes|Paridae|Cyanistes|caeruleus|Cyanistes caeruleus (Linnaeus, 1758)	12
Circaetus gallicus (Gmelin, 1788)	Animalia|Chordata|Aves|Accipitriformes|Accipitridae|Circaetus|gallicus|Circaetus gallicus (Gmelin, 1788)	11
Troglodytes troglodytes (Linnaeus, 1758)	Animalia|Chordata|Aves|Passeriformes|Troglodytidae|Troglodytes|troglodytes|Troglodytes troglodytes (Linnaeus, 1758)	10
Pernis apivorus (Linnaeus, 1758)	Animalia|Chordata|Aves|Accipitriformes|Accipitridae|Pernis|apivorus|Pernis apivorus (Linnaeus, 1758)	10
Morus bassanus (Linnaeus, 1758)	Animalia|Chordata|Aves|Suliformes|Sulidae|Morus|bassanus|Morus bassanus (Linnaeus, 1758)	10
Monticola solitarius (Linnaeus, 1758)	Animalia|Chordata|Aves|Passeriformes|Muscicapidae|Monticola|solitarius|Monticola solitarius (Linnaeus, 1758)	10
Streptopelia decaocto (Frivaldszky, 1838)	Animalia|Chordata|Aves|Columbiformes|Columbidae|Streptopelia|decaocto|Streptopelia decaocto (Frivaldszky, 1838)	10
Hirundo rustica Linnaeus, 1758	Animalia|Chordata|Aves|Passeriformes|Hirundinidae|Hirundo|rustica|Hirundo rustica Linnaeus, 1758	9
Apus apus (Linnaeus, 1758)	Animalia|Chordata|Aves|Apodiformes|Apodidae|Apus|apus|Apus apus (Linnaeus, 1758)	9
Erithacus rubecula (Linnaeus, 1758)	Animalia|Chordata|Aves|Passeriformes|Muscicapidae|Erithacus|rubecula|Erithacus rubecula (Linnaeus, 1758)	9
Diplodus vulgaris	Animalia|Chordata|Actinopterygii|Sparidae|Diplodus vulgaris	8
Hieraaetus pennatus (Gmelin, 1788)	Animalia|Chordata|Aves|Accipitriformes|Accipitridae|Hieraaetus|pennatus|Hieraaetus pennatus (Gmelin, 1788)	8
Coris julis	Animalia|Chordata|Actinopterygii|Labridae|Coris julis	8
Diplodus sargus	Animalia|Chordata|Actinopterygii|Sparidae|Diplodus sargus	8
Falco tinnunculus Linnaeus, 1758	Animalia|Chordata|Aves|Falconiformes|Falconidae|Falco|tinnunculus|Falco tinnunculus Linnaeus, 1758	8
Merops apiaster Linnaeus, 1758	Animalia|Chordata|Aves|Coraciiformes|Meropidae|Merops|apiaster|Merops apiaster Linnaeus, 1758	7
Symphodus tinca	Animalia|Chordata|Actinopterygii|Labridae|Symphodus tinca	7
Lanius senator Linnaeus, 1758	Animalia|Chordata|Aves|Passeriformes|Laniidae|Lanius|senator|Lanius senator Linnaeus, 1758	7
Linaria amethystea subsp. amethystea	Plantae|Tracheophyta|Magnoliopsida|Lamiales|Plantaginaceae|Linaria|amethystea|Linaria amethystea subsp. amethystea	7
Ficedula hypoleuca (Pallas, 1764)	Animalia|Chordata|Aves|Passeriformes|Muscicapidae|Ficedula|hypoleuca|Ficedula hypoleuca (Pallas, 1764)	7
Neophron percnopterus (Linnaeus, 1758)	Animalia|Chordata|Aves|Accipitriformes|Accipitridae|Neophron|percnopterus|Neophron percnopterus (Linnaeus, 1758)	7
Crioceris Geoffroy, 1762	Animalia|Arthropoda|Insecta|Coleoptera|Chrysomelidae|Crioceris||Crioceris Geoffroy, 1762	7
Calonectris diomedea (Scopoli, 1769)	Animalia|Chordata|Aves|Procellariiformes|Procellariidae|Calonectris|diomedea|Calonectris diomedea (Scopoli, 1769)	7
Sphaerechinus granularis	Animalia|Echinodermata|Echinoidea|Toxopneustidae|Sphaerechinus granularis	6
Spondyliosoma cantharus	Animalia|Chordata|Actinopterygii|Sparidae|Spondyliosoma cantharus	6
Jasione montana L.	Plantae|Tracheophyta|Magnoliopsida|Asterales|Campanulaceae|Jasione|montana|Jasione montana L.	6
Ononis natrix subsp. ramosissima (Desf.) Batt.	Plantae|Tracheophyta|Magnoliopsida|Fabales|Fabaceae|Ononis|natrix|Ononis natrix subsp. ramosissima (Desf.) Batt.	6
Cerithium vulgatum	Animalia|Mollusca|Gastropoda|Cerithiidae|Cerithium vulgatum	6
Apus pallidus (Shelley, 1870)	Animalia|Chordata|Aves|Apodiformes|Apodidae|Apus|pallidus|Apus pallidus (Shelley, 1870)	6
Paracentrotus lividus	Animalia|Echinodermata|Echinoidea|Parechinidae|Paracentrotus lividus	6
Phylloscopus collybita (Vieillot, 1817)	Animalia|Chordata|Aves|Passeriformes|Phylloscopidae|Phylloscopus|collybita|Phylloscopus collybita (Vieillot, 1817)	6
Phalacrocorax aristotelis (Linnaeus, 1761)	Animalia|Chordata|Aves|Suliformes|Phalacrocoracidae|Phalacrocorax|aristotelis|Phalacrocorax aristotelis (Linnaeus, 1761)	6
Accipiter nisus (Linnaeus, 1758)	Animalia|Chordata|Aves|Accipitriformes|Accipitridae|Accipiter|nisus|Accipiter nisus (Linnaeus, 1758)	6
Mullus surmuletus	Animalia|Chordata|Actinopterygii|Mullidae|Mullus surmuletus	6
Gyps fulvus (Hablizl, 1783)	Animalia|Chordata|Aves|Accipitriformes|Accipitridae|Gyps|fulvus|Gyps fulvus (Hablizl, 1783)	6
Arbacia lixula	Animalia|Echinodermata|Echinoidea|Arbaciidae|Arbacia lixula	6
Diplodus annularis	Animalia|Chordata|Actinopterygii|Sparidae|Diplodus annularis	5
Falco naumanni Fleischer, 1818	Animalia|Chordata|Aves|Falconiformes|Falconidae|Falco|naumanni|Falco naumanni Fleischer, 1818	5
Symphodus mediterraneus	Animalia|Chordata|Actinopterygii|Labridae|Symphodus mediterraneus	5
Sylvia communis Latham, 1787	Animalia|Chordata|Aves|Passeriformes|Sylviidae|Sylvia|communis|Sylvia communis Latham, 1787	5
Macaca sylvanus (Linnaeus, 1758)	Animalia|Chordata|Mammalia|Primates|Cercopithecidae|Macaca|sylvanus|Macaca sylvanus (Linnaeus, 1758)	5
Muscicapa striata (Pallas, 1764)	Animalia|Chordata|Aves|Passeriformes|Muscicapidae|Muscicapa|striata|Muscicapa striata (Pallas, 1764)	5
Phylloscopus trochilus (Linnaeus, 1758)	Animalia|Chordata|Aves|Passeriformes|Phylloscopidae|Phylloscopus|trochilus|Phylloscopus trochilus (Linnaeus, 1758)	5
Motacilla alba Linnaeus, 1758	Animalia|Chordata|Aves|Passeriformes|Motacillidae|Motacilla|alba|Motacilla alba Linnaeus, 1758	5
Pagrus auriga	Animalia|Chordata|Actinopterygii|Sparidae|Pagrus auriga	5
Thalasseus sandvicensis (Latham, 1787)	Animalia|Chordata|Aves|Charadriiformes|Laridae|Thalaseus|sandvicensis|Thalasseus sandvicensis (Latham, 1787)	5
Boops boops	Animalia|Chordata|Actinopterygii|Sparidae|Boops boops	5
Serinus serinus (Linnaeus, 1766)	Animalia|Chordata|Aves|Passeriformes|Fringillidae|Serinus|serinus|Serinus serinus (Linnaeus, 1766)	5
Motacilla flava Linnaeus, 1758	Animalia|Chordata|Aves|Passeriformes|Motacillidae|Motacilla|flava|Motacilla flava Linnaeus, 1758	5
Serranus cabrilla	Animalia|Chordata|Actinopterygii|Serranidae|Serranus cabrilla	5
Puffinus mauretanicus Lowe, 1921	Animalia|Chordata|Aves|Procellariiformes|Procellariidae|Puffinus|mauretanicus|Puffinus mauretanicus Lowe, 1921	5
Thymus willdenowii Boiss.	Plantae|Tracheophyta|Magnoliopsida|Lamiales|Lamiaceae|Thymus|willdenowii|Thymus willdenowii Boiss.	5
Dactylis glomerata L.	Plantae|Tracheophyta|Liliopsida|Poales|Poaceae|Dactylis|glomerata|Dactylis glomerata L.	5
Saxicola rubetra (Linnaeus, 1758)	Animalia|Chordata|Aves|Passeriformes|Muscicapidae|Saxicola|rubetra|Saxicola rubetra (Linnaeus, 1758)	4
Aslia lefevrei	Animalia|Echinodermata|Holothuroidea|Cucumariidae|Aslia lefevrei	4
Symphodus ocellatus	Animalia|Chordata|Actinopterygii|Labridae|Symphodus ocellatus	4
Gobius bucchichi	Animalia|Chordata|Actinopterygii|Gobiidae|Gobius bucchichi	4
Corvus corax Linnaeus, 1758	Animalia|Chordata|Aves|Passeriformes|Corvidae|Corvus|corax|Corvus corax Linnaeus, 1758	4
Upupa epops Linnaeus, 1758	Animalia|Chordata|Aves|Bucerotiformes|Upupidae|Upupa|epops|Upupa epops Linnaeus, 1758	4
Motacilla cinerea Tunstall, 1771	Animalia|Chordata|Aves|Passeriformes|Motacillidae|Motacilla|cinerea|Motacilla cinerea Tunstall, 1771	4
Holothuria tubulosa	Animalia|Echinodermata|Holothuroidea|Holothuriidae|Holothuria tubulosa	4
Phoenicurus ochruros (S. G. Gmelin, 1774)	Animalia|Chordata|Aves|Passeriformes|Muscicapidae|Phoenicurus|ochruros|Phoenicurus ochruros (S. G. Gmelin, 1774)	4
Circus aeruginosus (Linnaeus, 1758)	Animalia|Chordata|Aves|Accipitriformes|Accipitridae|Circus|aeruginosus|Circus aeruginosus (Linnaeus, 1758)	4
Phoenicurus phoenicurus (Linnaeus, 1758)	Animalia|Chordata|Aves|Passeriformes|Muscicapidae|Phoenicurus|phoenicurus|Phoenicurus phoenicurus (Linnaeus, 1758)	4
Parablennius pilicornis	Animalia|Chordata|Actinopterygii|Blenniidae|Parablennius pilicornis	4
Chromis chromis	Animalia|Chordata|Actinopterygii|Pomacentridae|Chromis chromis	4
Aristolochia baetica	Plantae|Magnoliophyta|Magnoliopsida|Piperales|Aristolochiaceae|Aristolochia|Aristolochia baetica	4
Cerastium gibraltaricum Boiss.	Plantae|Tracheophyta|Magnoliopsida|Caryophyllales|Caryophyllaceae|Cerastium|gibraltaricum|Cerastium gibraltaricum Boiss.	4
Patella ferruginea Gmelin, 1791	Animalia|Mollusca|Gastropoda||Patellidae|Patella|ferruginea|Patella ferruginea Gmelin, 1791	4
Falco subbuteo Linnaeus, 1758	Animalia|Chordata|Aves|Falconiformes|Falconidae|Falco|subbuteo|Falco subbuteo Linnaeus, 1758	4
Fringilla coelebs Linnaeus, 1758	Animalia|Chordata|Aves|Passeriformes|Fringillidae|Fringilla|coelebs|Fringilla coelebs Linnaeus, 1758	4
Serranus scriba	Animalia|Chordata|Actinopterygii|Serranidae|Serranus scriba	4
Zerynthia rumina	Animalia|Arthropoda|Insecta|Lepidoptera|Papilionidae|Zerynthia|Zerynthia rumina	4
Chroicocephalus ridibundus (Linnaeus, 1766)	Animalia|Chordata|Aves|Charadriiformes|Laridae|Chroicocephalus|ridibundus|Chroicocephalus ridibundus (Linnaeus, 1766)	4
Reichardia picroides (L.) Roth	Plantae|Tracheophyta|Magnoliopsida|Asterales|Asteraceae|Reichardia|picroides|Reichardia picroides (L.) Roth	3
Sylvia cantillans (Pallas, 1764)	Animalia|Chordata|Aves|Passeriformes|Sylviidae|Sylvia|cantillans|Sylvia cantillans (Pallas, 1764)	3
Circus pygargus (Linnaeus, 1758)	Animalia|Chordata|Aves|Accipitriformes|Accipitridae|Circus|pygargus|Circus pygargus (Linnaeus, 1758)	3
Monticola solitarius (Linnaeus, 1758)	Animalia|Chordata|Aves|Passeriformes|Turdidae|Monticola|solitarius|Monticola solitarius (Linnaeus, 1758)	3
Lavandula multifida L.	Plantae|Tracheophyta|Magnoliopsida|Lamiales|Lamiaceae|Lavandula|multifida|Lavandula multifida L.	3
Antirrhinum majus subsp. tortuosum (Bosc ex Vent.) Rouy	Plantae|Magnoliophyta|Magnoliopsida|Lamiales|Plantaginaceae|Antirrhinum|majus|Antirrhinum majus subsp. tortuosum (Bosc ex Vent.) Rouy	3
Antirrhinum majus subsp. tortuosum (Bosc ex Vent.) Rouy	Plantae|Tracheophyta|Magnoliopsida|Lamiales|Plantaginaceae|Antirrhinum|majus|Antirrhinum majus subsp. tortuosum (Bosc ex Vent.) Rouy	3
Tortella flavovirens Brotherus, 1902	Plantae|Bryophyta|Bryopsida|Pottiales|Pottiaceae|Tortella|flavovirens|Tortella flavovirens Brotherus, 1902	3
Sylvia borin (Boddaert, 1783)	Animalia|Chordata|Aves|Passeriformes|Sylviidae|Sylvia|borin|Sylvia borin (Boddaert, 1783)	3
Oenanthe hispanica (Linnaeus, 1758)	Animalia|Chordata|Aves|Passeriformes|Muscicapidae|Oenanthe|hispanica|Oenanthe hispanica (Linnaeus, 1758)	3
Chelon labrosus	Animalia|Chordata|Actinopterygii|Mugilidae|Chelon labrosus	3
Achyranthes aspera L.	Plantae|Tracheophyta|Magnoliopsida|Caryophyllales|Amaranthaceae|Achyranthes|aspera|Achyranthes aspera L.	3
Larus michahellis	Animalia|Chordata|Aves|Charadriiformes|Laridae|Larus|Larus michahellis	3
Parus major Linnaeus, 1758	Animalia|Chordata|Aves|Passeriformes|Paridae|Parus|major|Parus major Linnaeus, 1758	3
Bolma rugosa	Animalia|Mollusca|Gastropoda|Turbinidae|Bolma rugosa	3
Emberiza hortulana Linnaeus, 1758	Animalia|Chordata|Aves|Passeriformes|Emberizidae|Emberiza|hortulana|Emberiza hortulana Linnaeus, 1758	3
Crioceris asparagi (Linnaeus, 1758)	Animalia|Arthropoda|Insecta|Coleoptera|Chrysomelidae|Crioceris|asparagi|Crioceris asparagi (Linnaeus, 1758)	3
Apus melba (Linnaeus, 1758)	Animalia|Chordata|Aves|Apodiformes|Apodidae|Apus|melba|Apus melba (Linnaeus, 1758)	3
Thalassoma pavo	Animalia|Chordata|Actinopterygii|Labridae|Thalassoma pavo	3
Pagrus pagrus	Animalia|Chordata|Actinopterygii|Sparidae|Pagrus pagrus	2
Tetramorium Mayr, 1855	Animalia|Arthropoda|Insecta|Hymenoptera|Formicidae|Tetramorium||Tetramorium Mayr, 1855	2
Inachus dorsettensis (Pennant, 1777)	Animalia|Arthropoda|Malacostraca|Decapoda|Inachidae|Inachus|dorsettensis|Inachus dorsettensis (Pennant, 1777)	2
Boops Cuvier, 1814	Animalia|Chordata|Actinopterygii|Perciformes|Sparidae|Boops||Boops Cuvier, 1814	2
Pseudorlaya pumila (L.) Grande	Plantae|Tracheophyta|Magnoliopsida|Apiales|Apiaceae|Pseudorlaya|pumila|Pseudorlaya pumila (L.) Grande	2
Tarentola mauritanica	Animalia|Chordata|Reptilia|Squamata|Phyllodactylidae|Tarentola|Tarentola mauritanica	2
Thalasseus sandvicensis (Latham, 1787)	Animalia|Chordata|Aves|Charadriiformes|Laridae|Thalasseus|sandvicensis|Thalasseus sandvicensis (Latham, 1787)	2
Ruscus hypophyllum	Plantae|Magnoliophyta|Liliopsida|Asparagales|Asparagaceae|Ruscus|Ruscus hypophyllum	2
Delichon urbicum (Linnaeus, 1758)	Animalia|Chordata|Aves|Passeriformes|Hirundinidae|Delichon|urbicum|Delichon urbicum (Linnaeus, 1758)	2
Thymus L.	Plantae|Tracheophyta|Magnoliopsida|Lamiales|Lamiaceae|Thymus||Thymus L.	2
Genista linifolia	Plantae|Magnoliophyta|Magnoliopsida|Fabales|Fabaceae|Genista|Genista linifolia	2
Andryala integrifolia	Plantae|Magnoliophyta|Magnoliopsida|Asterales|Asteraceae|Andryala|Andryala integrifolia	2
Coris julis (Linnaeus, 1758)	Animalia|Chordata|Actinopterygii|Perciformes|Labridae|Coris|julis|Coris julis (Linnaeus, 1758)	2
Sylvia melanocephala (J. F. Gmelin, 1789)	Animalia|Chordata|Aves|Passeriformes|Sylviidae|Sylvia|melanocephala|Sylvia melanocephala (J. F. Gmelin, 1789)	2
Ciconia nigra (Linnaeus, 1758)	Animalia|Chordata|Aves|Ciconiiformes|Ciconiidae|Ciconia|nigra|Ciconia nigra (Linnaeus, 1758)	2
Ptyonoprogne rupestris (Scopoli, 1769)	Animalia|Chordata|Aves|Passeriformes|Hirundinidae|Ptyonoprogne|rupestris|Ptyonoprogne rupestris (Scopoli, 1769)	2
Hippocampus hippocampus (Linnaeus, 1758)	Animalia|Chordata|Actinopterygii|Syngnathiformes|Syngnathidae|Hippocampus|hippocampus|Hippocampus hippocampus (Linnaeus, 1758)	2
Tetramorium ruginode Stitz, 1917	Animalia|Arthropoda|Insecta|Hymenoptera|Formicidae|Tetramorium|ruginode|Tetramorium ruginode Stitz, 1917	2
Chloris chloris (Linnaeus, 1758)	Animalia|Chordata|Aves|Passeriformes|Fringillidae|Chloris|chloris|Chloris chloris (Linnaeus, 1758)	2
Brassica papillaris Boiss.	Plantae|Tracheophyta|Magnoliopsida|Brassicales|Brassicaceae|Brassica|papillaris|Brassica papillaris Boiss.	2
Anagallis arvensis azurea	Plantae|Magnoliophyta|Magnoliopsida|Ericales|Myrsinaceae|Anagallis|Anagallis arvensis azurea	2
Phalacrocorax carbo (Linnaeus, 1758)	Animalia|Chordata|Aves|Suliformes|Phalacrocoracidae|Phalacrocorax|carbo|Phalacrocorax carbo (Linnaeus, 1758)	2
Sepia esculenta Hoyle, 1885	Animalia|Mollusca|Cephalopoda|Sepiida|Sepiidae|Sepia|esculenta|Sepia esculenta Hoyle, 1885	2
Puffinus yelkouan (Acerbi, 1827)	Animalia|Chordata|Aves|Procellariiformes|Procellariidae|Puffinus|yelkouan|Puffinus yelkouan (Acerbi, 1827)	2
Oenanthe oenanthe (Linnaeus, 1758)	Animalia|Chordata|Aves|Passeriformes|Muscicapidae|Oenanthe|oenanthe|Oenanthe oenanthe (Linnaeus, 1758)	2
Danaus plexippus Linnaeus, 1758	Animalia|Arthropoda|Insecta|Lepidoptera|Nymphalidae|Danaus|plexippus|Danaus plexippus Linnaeus, 1758	2
Carduelis carduelis (Linnaeus, 1758)	Animalia|Chordata|Aves|Passeriformes|Fringillidae|Carduelis|carduelis|Carduelis carduelis (Linnaeus, 1758)	2
Buteo buteo (Linnaeus, 1758)	Animalia|Chordata|Aves|Accipitriformes|Accipitridae|Buteo|buteo|Buteo buteo (Linnaeus, 1758)	2
Zerynthia rumina (Linnaeus, 1758)	Animalia|Arthropoda|Insecta|Lepidoptera|Papilionidae|Zerynthia|rumina|Zerynthia rumina (Linnaeus, 1758)	2
Sarpa salpa	Animalia|Chordata|Actinopterygii|Sparidae|Sarpa salpa	2
Aphanes australis Rydb.	Plantae|Tracheophyta|Magnoliopsida|Rosales|Rosaceae|Aphanes|australis|Aphanes australis Rydb.	2
Streptopelia turtur (Linnaeus, 1758)	Animalia|Chordata|Aves|Columbiformes|Columbidae|Streptopelia|turtur|Streptopelia turtur (Linnaeus, 1758)	2
Vanessa atalanta	Animalia|Arthropoda|Insecta|Lepidoptera|Nymphalidae|Vanessa|Vanessa atalanta	2
Charadrius alexandrinus Linnaeus, 1758	Animalia|Chordata|Aves|Charadriiformes|Charadriidae|Charadrius|alexandrinus|Charadrius alexandrinus Linnaeus, 1758	2
Solanum linnaeanum Hepper & P.-M.L. Jaeger	Plantae|Tracheophyta|Magnoliopsida|Solanales|Solanaceae|Solanum|linnaeanum|Solanum linnaeanum Hepper & P.-M.L. Jaeger	2
Gyps fulvus fulvus	Animalia|Chordata|Aves|Accipitriformes|Accipitridae|Gyps|fulvus|Gyps fulvus fulvus	2
Hippolais polyglotta (Vieillot, 1817)	Animalia|Chordata|Aves|Passeriformes|Acrocephalidae|Hippolais|polyglotta|Hippolais polyglotta (Vieillot, 1817)	2
Gastropoda	Animalia|Mollusca|Gastropoda|Gastropoda	2
Anthus campestris (Linnaeus, 1758)	Animalia|Chordata|Aves|Passeriformes|Motacillidae|Anthus|campestris|Anthus campestris (Linnaeus, 1758)	2
Pagurus bernhardus (Linnaeus, 1758)	Animalia|Arthropoda|Malacostraca|Decapoda|Paguridae|Pagurus|bernhardus|Pagurus bernhardus (Linnaeus, 1758)	2
Larinae	Animalia|Chordata|Aves|Charadriiformes|Laridae|Larinae	2
Aristolochia baetica L.	Plantae|Tracheophyta|Magnoliopsida|Piperales|Aristolochiaceae|Aristolochia|baetica|Aristolochia baetica L.	2
Ophisurus serpens (Linnaeus, 1758)	Animalia|Chordata|Actinopterygii|Anguilliformes|Ophichthidae|Ophisurus|serpens|Ophisurus serpens (Linnaeus, 1758)	2
Danaus plexippus	Animalia|Arthropoda|Insecta|Lepidoptera|Nymphalidae|Danaus|Danaus plexippus	2
Centrolabrus exoletus	Animalia|Chordata|Actinopterygii|Labridae|Centrolabrus exoletus	2
Polysiphonia simpliciuscula P.L.Crouan & H.M.Crouan, 1852	Plantae|Rhodophyta|Florideophyceae|Ceramiales|Rhodomelaceae|Ophidocladus|simpliciuscula|Polysiphonia simpliciuscula P.L.Crouan & H.M.Crouan, 1852	2
Erodium laciniatum (Cav.) Willd.	Plantae|Tracheophyta|Magnoliopsida|Geraniales|Geraniaceae|Erodium|laciniatum|Erodium laciniatum (Cav.) Willd.	2
Tripterygion delaisi	Animalia|Chordata|Actinopterygii|Tripterygiidae|Tripterygion delaisi	2
Solea solea (Linnaeus, 1758)	Animalia|Chordata|Actinopterygii|Pleuronectiformes|Soleidae|Solea|solea|Solea solea (Linnaeus, 1758)	2
Gnathophis cinctus (Garman, 1899)	Animalia|Chordata|Actinopterygii|Anguilliformes|Congridae|Gnathophis|cinctus|Gnathophis cinctus (Garman, 1899)	2
Emberiza calandra Linnaeus, 1758	Animalia|Chordata|Aves|Passeriformes|Emberizidae|Emberiza|calandra|Emberiza calandra Linnaeus, 1758	2
Corvus monedula Linnaeus, 1758	Animalia|Chordata|Aves|Passeriformes|Corvidae|Coloeus|monedula|Corvus monedula Linnaeus, 1758	2
Larus argentatus Pontoppidan, 1763	Animalia|Chordata|Aves|Charadriiformes|Laridae|Larus|argentatus|Larus argentatus Pontoppidan, 1763	2
Sylvia hortensis (Gmelin, 1789)	Animalia|Chordata|Aves|Passeriformes|Sylviidae|Sylvia|hortensis|Sylvia hortensis (Gmelin, 1789)	2
Patella ferruginea Gmelin, 1791	Animalia|Mollusca|Gastropoda|Archaeogastropoda|Patellidae|Patella|ferruginea|Patella ferruginea Gmelin, 1791	2
Polysiphonia paradoxa Thuret	Plantae|Rhodophyta|Florideophyceae|Ceramiales|Rhodomelaceae|Polysiphonia|paradoxa|Polysiphonia paradoxa Thuret	2
Clinopodium nepeta (L.) Kuntze	Plantae|Tracheophyta|Magnoliopsida|Lamiales|Lamiaceae|Clinopodium|nepeta|Clinopodium nepeta (L.) Kuntze	2
Luscinia megarhynchos C. L. Brehm, 1831	Animalia|Chordata|Aves|Passeriformes|Muscicapidae|Luscinia|megarhynchos|Luscinia megarhynchos C. L. Brehm, 1831	2
Targionia hypophylla L.	Plantae|Marchantiophyta|Marchantiopsida|Marchantiales|Targioniaceae|Targionia|hypophylla|Targionia hypophylla L.	1
Marthasterias glacialis	Animalia|Echinodermata|Asteroidea|Asteriidae|Marthasterias glacialis	1
Callista chione (Linnaeus, 1758)	Animalia|Mollusca|Bivalvia|Veneroida|Veneridae|Callista|chione|Callista chione (Linnaeus, 1758)	1
Allium triquetrum	Plantae|Magnoliophyta|Liliopsida|Asparagales|Alliaceae|Allium|Allium triquetrum	1
Cardites antiquatus (Linnaeus, 1758)	Animalia|Mollusca|Bivalvia|Carditoida|Carditidae|Cardites|antiquatus|Cardites antiquatus (Linnaeus, 1758)	1
Timmiella barbuloides Mönkemeyer, 1927	Plantae|Bryophyta|Bryopsida|Pottiales|Pottiaceae|Timmiella|barbuloides|Timmiella barbuloides Mönkemeyer, 1927	1
Genista linifolia L.	Plantae|Tracheophyta|Magnoliopsida|Fabales|Fabaceae|Genista|linifolia|Genista linifolia L.	1
Bryum bicolor Dicks.	Plantae|Bryophyta|Bryopsida|Bryales|Bryaceae|Bryum|bicolor|Bryum bicolor Dicks.	1
Mytilus edulis Linnaeus, 1758	Animalia|Mollusca|Bivalvia|Mytiloida|Mytilidae|Mytilus|edulis|Mytilus edulis Linnaeus, 1758	1
Tortella nitida Brotherus, 1902	Plantae|Bryophyta|Bryopsida|Pottiales|Pottiaceae|Tortella|nitida|Tortella nitida Brotherus, 1902	1
Allium roseum L.	Plantae|Tracheophyta|Liliopsida|Asparagales|Amaryllidaceae|Allium|roseum|Allium roseum L.	1
Ophichthus rufus (Rafinesque, 1810)	Animalia|Chordata|Actinopterygii|Anguilliformes|Ophichthidae|Ophichthus|rufus|Ophichthus rufus (Rafinesque, 1810)	1
Anagallis arvensis f. azurea Hyl.	Plantae|Tracheophyta|Magnoliopsida|Ericales|Primulaceae|Anagallis|arvensis|Anagallis arvensis f. azurea Hyl.	1
Homarus gammarus (Linnaeus, 1758)	Animalia|Arthropoda|Malacostraca|Decapoda|Nephropidae|Homarus|gammarus|Homarus gammarus (Linnaeus, 1758)	1
Allium triquetrum L.	Plantae|Magnoliophyta|Liliopsida|Asparagales|Amaryllidaceae|Allium|triquetrum|Allium triquetrum L.	1
Silene tomentosa Otth	Plantae|Tracheophyta|Magnoliopsida|Caryophyllales|Caryophyllaceae|Silene|tomentosa|Silene tomentosa Otth	1
Ruscus hypophyllum L.	Plantae|Tracheophyta|Liliopsida|Asparagales|Asparagaceae|Ruscus|hypophyllum|Ruscus hypophyllum L.	1
Haliotis tuberculata Linnaeus, 1758	Animalia|Mollusca|Gastropoda||Haliotidae|Haliotis|tuberculata|Haliotis tuberculata Linnaeus, 1758	1
Allium triquetrum	Plantae|Magnoliophyta|Liliopsida|Asparagales|Amaryllidaceae|Allium|Allium triquetrum	1
Ophryotrocha puerilis siberti (McIntosh, 1885)	Animalia|Annelida|Polychaeta|Eunicida|Dorvilleidae|Ophryotrocha|puerilis|Ophryotrocha puerilis siberti (McIntosh, 1885)	1
Muraena helena Linnaeus, 1758	Animalia|Chordata|Actinopterygii|Anguilliformes|Muraenidae|Muraena|helena|Muraena helena Linnaeus, 1758	1
Macromphalus abylensis Warén & Bouchet, 1988	Animalia|Mollusca|Gastropoda|Neotaenioglossa|Vanikoridae|Macromphalus|abylensis|Macromphalus abylensis Warén & Bouchet, 1988	1
Patella rustica Linnaeus, 1758	Animalia|Mollusca|Gastropoda|Archaeogastropoda|Patellidae|Patella|rustica|Patella rustica Linnaeus, 1758	1
Erodium cicutarium	Plantae|Tracheophyta|Magnoliopsida|Geraniales|Geraniaceae|Erodium|cicutarium|Erodium cicutarium	1
Biscutella coronopifolia L.	Plantae|Tracheophyta|Magnoliopsida|Brassicales|Brassicaceae|Biscutella|coronopifolia|Biscutella coronopifolia L.	1
Silene nicaeensis All.	Plantae|Tracheophyta|Magnoliopsida|Caryophyllales|Caryophyllaceae|Silene|nicaeensis|Silene nicaeensis All.	1
Laridae Vigors, 1825	Animalia|Chordata|Aves|Charadriiformes|Laridae|||Laridae Vigors, 1825	1
Falco eleonorae Géné, 1839	Animalia|Chordata|Aves|Falconiformes|Falconidae|Falco|eleonorae|Falco eleonorae Géné, 1839	1
Iberis gibraltarica L.	Plantae|Tracheophyta|Magnoliopsida|Brassicales|Brassicaceae|Iberis|gibraltarica|Iberis gibraltarica L.	1
Scilla peruviana L.	Plantae|Tracheophyta|Liliopsida|Asparagales|Asparagaceae|Scilla|peruviana|Scilla peruviana L.	1
Arenaria procumbens Vahl	Plantae|Tracheophyta|Magnoliopsida|Caryophyllales|Caryophyllaceae|Rhodalsine|procumbens|Arenaria procumbens Vahl	1
Saxicola rubicola (Linnaeus, 1766)	Animalia|Chordata|Aves|Passeriformes|Muscicapidae|Saxicola|rubicola|Saxicola rubicola (Linnaeus, 1766)	1
Antinoria agrostidea (DC.) Parl.	Plantae|Tracheophyta|Liliopsida|Poales|Poaceae|Antinoria|agrostidea|Antinoria agrostidea (DC.) Parl.	1
Linepithema humile subsp. humile	Animalia|Arthropoda|Insecta|Hymenoptera|Formicidae|Linepithema|humile|Linepithema humile subsp. humile	1
Tachymarptis melba (Linnaeus, 1758)	Animalia|Chordata|Aves|Apodiformes|Apodidae|Apus|melba|Tachymarptis melba (Linnaeus, 1758)	1
Oenanthe hispanica subsp. hispanica	Animalia|Chordata|Aves|Passeriformes|Muscicapidae|Oenanthe|hispanica|Oenanthe hispanica subsp. hispanica	1
Silene colorata Schousb. ex Hornem.	Plantae|Tracheophyta|Magnoliopsida|Caryophyllales|Caryophyllaceae|Silene|colorata|Silene colorata Schousb. ex Hornem.	1
Campanula erinoides L.	Plantae|Tracheophyta|Magnoliopsida|Asterales|Campanulaceae|Campanula|erinoides|Campanula erinoides L.	1
Tetramorium exasperatum Emery, 1891	Animalia|Arthropoda|Insecta|Hymenoptera|Formicidae|Tetramorium|exasperatum|Tetramorium exasperatum Emery, 1891	1
Oblada melanura	Animalia|Chordata|Actinopterygii|Sparidae|Oblada melanura	1
Tarentola mauritanica Linnaeus, 1758	Animalia|Chordata|Reptilia|Squamata|Gekkonidae|Tarentola|mauritanica|Tarentola mauritanica Linnaeus, 1758	1
Chamaerops humilis L.	Plantae|Magnoliophyta|Liliopsida|Arecales|Arecaceae|Chamaerops|humilis|Chamaerops humilis L.	1
Cerastium strictum Linnaeus	Plantae|Tracheophyta|Magnoliopsida|Caryophyllales|Caryophyllaceae|Cerastium|strictum|Cerastium strictum Linnaeus	1
Athene noctua (Scopoli, 1769)	Animalia|Chordata|Aves|Strigiformes|Strigidae|Athene|noctua|Athene noctua (Scopoli, 1769)	1
Allium roseum	Plantae|Magnoliophyta|Liliopsida|Asparagales|Amaryllidaceae|Allium|Allium roseum	1
Silene mollissima subsp. gibraltarica (Boiss.) Maire	Plantae|Tracheophyta|Magnoliopsida|Caryophyllales|Caryophyllaceae|Silene|mollissima|Silene mollissima subsp. gibraltarica (Boiss.) Maire	1
Turdus merula subsp. mauritanicus	Animalia|Chordata|Aves|Passeriformes|Turdidae|Turdus|merula|Turdus merula subsp. mauritanicus	1
Phyllitis sagittata (DC.) Guinea & Heywood	Plantae|Tracheophyta|Polypodiopsida|Polypodiales|Aspleniaceae|Asplenium|sagittata|Phyllitis sagittata (DC.) Guinea & Heywood	1
Frullania dilatata (L.) Dumort.	Plantae|Marchantiophyta|Jungermanniopsida|Porellales|Frullaniaceae|Frullania|dilatata|Frullania dilatata (L.) Dumort.	1
Phylloscopus trochilus (Linnaeus, 1758)	Animalia|Chordata|Aves|Passeriformes|Sylviidae|Phylloscopus|trochilus|Phylloscopus trochilus (Linnaeus, 1758)	1
Patella rustica Linnaeus, 1758	Animalia|Mollusca|Gastropoda||Patellidae|Patella|rustica|Patella rustica Linnaeus, 1758	1
Solanum villosum Mill.	Plantae|Tracheophyta|Magnoliopsida|Solanales|Solanaceae|Solanum|villosum|Solanum villosum Mill.	1
Gyps fulvus subsp. fulvus	Animalia|Chordata|Aves|Accipitriformes|Accipitridae|Gyps|fulvus|Gyps fulvus subsp. fulvus	1
Ononis serrata Forssk.	Plantae|Tracheophyta|Magnoliopsida|Fabales|Fabaceae|Ononis|serrata|Ononis serrata Forssk.	1
Allium roseum L.	Plantae|Magnoliophyta|Liliopsida|Asparagales|Amaryllidaceae|Allium|roseum|Allium roseum L.	1
Camphorosma monspeliaca L.	Plantae|Tracheophyta|Magnoliopsida|Caryophyllales|Amaranthaceae|Camphorosma|monspeliaca|Camphorosma monspeliaca L.	1
Aristolochia baetica L.	Plantae|Magnoliophyta|Magnoliopsida|Piperales|Aristolochiaceae|Aristolochia|baetica|Aristolochia baetica L.	1
Pistacia lentiscus L.	Plantae|Tracheophyta|Magnoliopsida|Sapindales|Anacardiaceae|Pistacia|lentiscus|Pistacia lentiscus L.	1
Gonepteryx cleopatra (Linnaeus, 1767)	Animalia|Arthropoda|Insecta|Lepidoptera|Pieridae|Gonepteryx|cleopatra|Gonepteryx cleopatra (Linnaeus, 1767)	1
Asphodelus aestivus Brot.	Plantae|Tracheophyta|Liliopsida|Asparagales|Xanthorrhoeaceae|Asphodelus|aestivus|Asphodelus aestivus Brot.	1
Tarentola mauritanica (Linnaeus, 1758)	Animalia|Chordata|Reptilia|Squamata|Phyllodactylidae|Tarentola|mauritanica|Tarentola mauritanica (Linnaeus, 1758)	1
Reichardia gaditana (Willk.) Samp.	Plantae|Tracheophyta|Magnoliopsida|Asterales|Asteraceae|Reichardia|gaditana|Reichardia gaditana (Willk.) Samp.	1
Lavandula dentata L.	Plantae|Tracheophyta|Magnoliopsida|Lamiales|Lamiaceae|Lavandula|dentata|Lavandula dentata L.	1
Chamaerops humilis L.	Plantae|Tracheophyta|Liliopsida|Arecales|Arecaceae|Chamaerops|humilis|Chamaerops humilis L.	1
Charonia lampas	Animalia|Mollusca|Gastropoda|Ranellidae|Charonia lampas	1
Opuntia ficus-indica	Plantae|Magnoliophyta|Magnoliopsida|Caryophyllales|Cactaceae|Opuntia|Opuntia ficus-indica	1
Solanum sodomeum L.	Plantae|Tracheophyta|Magnoliopsida|Solanales|Solanaceae|Solanum|sodomeum|Solanum sodomeum L.	1
Hexaplex trunculus	Animalia|Mollusca|Gastropoda|Muricidae|Hexaplex trunculus	1
Cytisus patens Murray	Plantae|Tracheophyta|Magnoliopsida|Fabales|Fabaceae|Verzinum|patens|Cytisus patens Murray	1
Picridium ligulatum Vent.	Plantae|Tracheophyta|Magnoliopsida|Asterales|Asteraceae|Reichardia|ligulatum|Picridium ligulatum Vent.	1
Erica scoparia L.	Plantae|Tracheophyta|Magnoliopsida|Ericales|Ericaceae|Erica|scoparia|Erica scoparia L.	1
Charaxes jasius Linnaeus, 1767	Animalia|Arthropoda|Insecta|Lepidoptera|Nymphalidae|Charaxes|jasius|Charaxes jasius Linnaeus, 1767	1
Riccia sorocarpa Bisch.	Plantae|Marchantiophyta|Marchantiopsida|Marchantiales|Ricciaceae|Riccia|sorocarpa|Riccia sorocarpa Bisch.	1
Campanula mollis L.	Plantae|Tracheophyta|Magnoliopsida|Asterales|Campanulaceae|Campanula|mollis|Campanula mollis L.	1
Leucoraja naevus (Müller & Henle, 1841)	Animalia|Chordata|Elasmobranchii|Rajiformes|Rajidae|Leucoraja|naevus|Leucoraja naevus (Müller & Henle, 1841)	1
Conger conger (Linnaeus, 1758)	Animalia|Chordata|Actinopterygii|Anguilliformes|Congridae|Conger|conger|Conger conger (Linnaeus, 1758)	1
Acrocephalus scirpaceus (Hermann, 1804)	Animalia|Chordata|Aves|Passeriformes|Acrocephalidae|Acrocephalus|scirpaceus|Acrocephalus scirpaceus (Hermann, 1804)	1
Orobanche minor Sm.	Plantae|Tracheophyta|Magnoliopsida|Lamiales|Orobanchaceae|Orobanche|minor|Orobanche minor Sm.	1
Euphorbia exigua L.	Plantae|Tracheophyta|Magnoliopsida|Malpighiales|Euphorbiaceae|Euphorbia|exigua|Euphorbia exigua L.	1
Allium roseum	Plantae|Magnoliophyta|Liliopsida|Asparagales|Alliaceae|Allium|Allium roseum	1
Labrus bergylta	Animalia|Chordata|Actinopterygii|Labridae|Labrus bergylta	1
Octopus vulgaris	Animalia|Mollusca|Cephalopoda|Octopodidae|Octopus vulgaris	1
Schilderia achatidea (Gray in G.B. Sowerby I, 1837)	Animalia|Mollusca|Gastropoda|Littorinimorpha|Cypraeidae|Schilderia|achatidea|Schilderia achatidea (Gray in G.B. Sowerby I, 1837)	1
Symphodus melops	Animalia|Chordata|Actinopterygii|Labridae|Symphodus melops	1
Holothuria forskali	Animalia|Echinodermata|Holothuroidea|Holothuriidae|Holothuria forskali	1
Thymelaea canescens (Schousboe) Endl.	Plantae|Tracheophyta|Magnoliopsida|Malvales|Thymelaeaceae|Thymelaea|canescens|Thymelaea canescens (Schousboe) Endl.	1
Pandion haliaetus (Linnaeus, 1758)	Animalia|Chordata|Aves|Accipitriformes|Pandionidae|Pandion|haliaetus|Pandion haliaetus (Linnaeus, 1758)	1
Paratrechina longicornis subsp. longicornis	Animalia|Arthropoda|Insecta|Hymenoptera|Formicidae|Paratrechina|longicornis|Paratrechina longicornis subsp. longicornis	1
Bryum radiculosum Bridel, 1817	Plantae|Bryophyta|Bryopsida|Bryales|Bryaceae|Bryum|radiculosum|Bryum radiculosum Bridel, 1817	1
Ruscus hypophyllum L.	Plantae|Magnoliophyta|Liliopsida|Asparagales|Asparagaceae|Ruscus|hypophyllum|Ruscus hypophyllum L.	1
Pterogonium gracile Smith, 1803	Plantae|Bryophyta|Bryopsida|Leucodontales|Leucodontaceae|Pterogonium|gracile|Pterogonium gracile Smith, 1803	1
Phylloscopus bonelli (Vieillot, 1819)	Animalia|Chordata|Aves|Passeriformes|Phylloscopidae|Phylloscopus|bonelli|Phylloscopus bonelli (Vieillot, 1819)	1
Spergularia fimbriata Boiss. & Reuter	Plantae|Tracheophyta|Magnoliopsida|Caryophyllales|Caryophyllaceae|Spergularia|fimbriata|Spergularia fimbriata Boiss. & Reuter	1
Pyroteuthis margaritifera (Rüppell, 1844)	Animalia|Mollusca|Cephalopoda|Oegopsida|Pyroteuthidae|Pyroteuthis|margaritifera|Pyroteuthis margaritifera (Rüppell, 1844)	1
Iris filifolia Boiss.	Plantae|Tracheophyta|Liliopsida|Asparagales|Iridaceae|Iris|filifolia|Iris filifolia Boiss.	1
Pyroteuthis margaritifera (Rüppell, 1844)	Animalia|Mollusca|Cephalopoda|Teuthida|Pyroteuthidae|Pyroteuthis|margaritifera|Pyroteuthis margaritifera (Rüppell, 1844)	1
Helichrysum rupestre (Raf.) DC.	Plantae|Tracheophyta|Magnoliopsida|Asterales|Asteraceae|Helichrysum|rupestre|Helichrysum rupestre (Raf.) DC.	1
Tortula laevipila (Brid.) Schwägr.	Plantae|Bryophyta|Bryopsida|Pottiales|Pottiaceae|Syntrichia|laevipila|Tortula laevipila (Brid.) Schwägr.	1
Thrincia maroccana Pers.	Plantae|Tracheophyta|Magnoliopsida|Asterales|Asteraceae|Leontodon|maroccana|Thrincia maroccana Pers.	1
Maja squinado (Herbst, 1788)	Animalia|Arthropoda|Malacostraca|Decapoda|Majidae|Maja|squinado|Maja squinado (Herbst, 1788)	1
Inula viscosa (L.) Aiton	Plantae|Tracheophyta|Magnoliopsida|Asterales|Asteraceae|Dittrichia|viscosa|Inula viscosa (L.) Aiton	1
Trechus tingitanus Putzeys, 1870	Animalia|Arthropoda|Insecta|Coleoptera|Carabidae|Amara|tingitanus|Trechus tingitanus Putzeys, 1870	1
Sturnus vulgaris Linnaeus, 1758	Animalia|Chordata|Aves|Passeriformes|Sturnidae|Sturnus|vulgaris|Sturnus vulgaris Linnaeus, 1758	1
Ichthyaetus audouinii (Payraudeau, 1826)	Animalia|Chordata|Aves|Charadriiformes|Laridae|Ichthyaetus|audouinii|Ichthyaetus audouinii (Payraudeau, 1826)	1
Calendula marginata Willd.	Plantae|Tracheophyta|Magnoliopsida|Asterales|Asteraceae|Calendula|marginata|Calendula marginata Willd.	1
Euphorbia chamaesyce L.	Plantae|Tracheophyta|Magnoliopsida|Malpighiales|Euphorbiaceae|Euphorbia|chamaesyce|Euphorbia chamaesyce L.	1
Simnia spelta (Linnaeus, 1758)	Animalia|Mollusca|Gastropoda|Littorinimorpha|Ovulidae|Simnia|spelta|Simnia spelta (Linnaeus, 1758)	1
Tomares ballus (Fabricius, 1787)	Animalia|Arthropoda|Insecta|Lepidoptera|Lycaenidae|Tomares|ballus|Tomares ballus (Fabricius, 1787)	1
Orobanche gracilis subsp. deludens (Beck) A.Pujadas	Plantae|Tracheophyta|Magnoliopsida|Lamiales|Orobanchaceae|Orobanche|gracilis|Orobanche gracilis subsp. deludens (Beck) A.Pujadas	1
Andryala arenaria (Guss. ex DC.) Boiss. & Reut.	Plantae|Tracheophyta|Magnoliopsida|Asterales|Asteraceae|Andryala|arenaria|Andryala arenaria (Guss. ex DC.) Boiss. & Reut.	1
Formicidae	Animalia|Arthropoda|Insecta|Hymenoptera|Formicidae|||Formicidae	1
Spinus spinus (Linnaeus, 1758)	Animalia|Chordata|Aves|Passeriformes|Fringillidae|Spinus|spinus|Spinus spinus (Linnaeus, 1758)	1
Biscutella sempervirens L.	Plantae|Tracheophyta|Magnoliopsida|Brassicales|Brassicaceae|Biscutella|sempervirens|Biscutella sempervirens L.	1
Trechus (Trechus) tingitanus tingitanus Putzeys, 1870	Animalia|Arthropoda|Insecta|Coleoptera|Carabidae|Trechus|tingitanus|Trechus (Trechus) tingitanus tingitanus Putzeys, 1870	1
Vulpia alopecuros (Schousb.) Link	Plantae|Tracheophyta|Liliopsida|Poales|Poaceae|Vulpia|alopecuros|Vulpia alopecuros (Schousb.) Link	1
Hippolais polyglotta (Vieillot, 1817)	Animalia|Chordata|Aves|Passeriformes|Sylviidae|Hippolais|polyglotta|Hippolais polyglotta (Vieillot, 1817)	1
Liza aurata	Animalia|Chordata|Actinopterygii|Mugilidae|Liza aurata	1