taxonName	taxonPath	recordCount
Zea mays L.	Plantae|Tracheophyta|Liliopsida|Poales|Poaceae|Zea|mays|Zea mays L.	155
Zea mays L.	Plantae|Magnoliophyta|Liliopsida|Poales|Poaceae|Zea|mays|Zea mays L.	155
	|||||||	58
Corvus cornix Linnaeus, 1758	Animalia|Chordata|Aves|Passeriformes|Corvidae|Corvus|cornix|Corvus cornix Linnaeus, 1758	33
Ctenophthalmus agyrtes (Heller, 1896)	Animalia|Arthropoda|Insecta|Siphonaptera|Hystrichopsyllidae|Ctenophthalmus|agyrtes|Ctenophthalmus agyrtes (Heller, 1896)	30
Palaeopsylla smiti Peus, 1965	Animalia|Arthropoda|Insecta|Siphonaptera|Hystrichopsyllidae|Palaeopsylla|smiti|Palaeopsylla smiti Peus, 1965	23
Palaeopsylla smiti Peus, 1965	Animalia|Arthropoda|Insecta|Siphonaptera|Ctenophthalmidae|Palaeopsylla|smiti|Palaeopsylla smiti Peus, 1965	23
Parus major Linnaeus, 1758	Animalia|Chordata|Aves|Passeriformes|Paridae|Parus|major|Parus major Linnaeus, 1758	23
Lecidea lapicida var. pantherina Ach.	Fungi|Ascomycota|Lecanoromycetes|Lecanorales|Lecideaceae|Lecidea|lapicida|Lecidea lapicida var. pantherina Ach.	21
Vaccinites Fischer, 1887	Animalia|Mollusca|Bivalvia||Hippuritidae|Vaccinites||Vaccinites Fischer, 1887	21
Cuculus canorus Linnaeus, 1758	Animalia|Chordata|Aves|Cuculiformes|Cuculidae|Cuculus|canorus|Cuculus canorus Linnaeus, 1758	20
Pica pica (Linnaeus, 1758)	Animalia|Chordata|Aves|Passeriformes|Corvidae|Pica|pica|Pica pica (Linnaeus, 1758)	20
Corvus monedula Linnaeus, 1758	Animalia|Chordata|Aves|Passeriformes|Corvidae|Coloeus|monedula|Corvus monedula Linnaeus, 1758	20
Peltigera rufescens (Weiss) Humb.	Fungi|Ascomycota|Lecanoromycetes|Peltigerales|Peltigeraceae|Peltigera|rufescens|Peltigera rufescens (Weiss) Humb.	18
Rhizocarpon geographicum (L.) DC.	Fungi|Ascomycota|Lecanoromycetes|Lecanorales|Rhizocarpaceae|Rhizocarpon|geographicum|Rhizocarpon geographicum (L.) DC.	18
Rinodina mniaraea var. cinnamomea Th. Fr.	Fungi|Ascomycota|Lecanoromycetes|Teloschistales|Physciaceae|Rinodina|mniaraea|Rinodina mniaraea var. cinnamomea Th. Fr.	18
Testudo hermanni Gmelin, 1789	Animalia|Chordata|Reptilia|Testudines|Testudinidae|Testudo|hermanni|Testudo hermanni Gmelin, 1789	18
Hirundo rustica Linnaeus, 1758	Animalia|Chordata|Aves|Passeriformes|Hirundinidae|Hirundo|rustica|Hirundo rustica Linnaeus, 1758	18
Luscinia megarhynchos C. L. Brehm, 1831	Animalia|Chordata|Aves|Passeriformes|Muscicapidae|Luscinia|megarhynchos|Luscinia megarhynchos C. L. Brehm, 1831	18
Ctenophthalmus monticola (Kohaut, 1904)	Animalia|Arthropoda|Insecta|Siphonaptera|Hystrichopsyllidae|Ctenophthalmus|monticola|Ctenophthalmus monticola (Kohaut, 1904)	18
Corvus corax Linnaeus, 1758	Animalia|Chordata|Aves|Passeriformes|Corvidae|Corvus|corax|Corvus corax Linnaeus, 1758	17
Podarcis muralis	Animalia|Chordata|Reptilia|Squamata|Lacertidae|Podarcis|Podarcis muralis	16
Testudo hermanni	Animalia|Chordata|Reptilia|Testudines|Testudinidae|Testudo|Testudo hermanni	16
Buteo buteo (Linnaeus, 1758)	Animalia|Chordata|Aves|Accipitriformes|Accipitridae|Buteo|buteo|Buteo buteo (Linnaeus, 1758)	16
Campanula versicolor Andrews	Plantae|Tracheophyta|Magnoliopsida|Asterales|Campanulaceae|Campanula|versicolor|Campanula versicolor Andrews	16
Campanula versicolor Andrews	Plantae|Magnoliophyta|Magnoliopsida|Asterales|Campanulaceae|Campanula|versicolor|Campanula versicolor Andrews	16
Nosopsyllus fasciatus (Bosc, 1800)	Animalia|Arthropoda|Insecta|Siphonaptera|Ceratophyllidae|Nosopsyllus|fasciatus|Nosopsyllus fasciatus (Bosc, 1800)	16
Sturnus vulgaris Linnaeus, 1758	Animalia|Chordata|Aves|Passeriformes|Sturnidae|Sturnus|vulgaris|Sturnus vulgaris Linnaeus, 1758	15
Garrulus glandarius (Linnaeus, 1758)	Animalia|Chordata|Aves|Passeriformes|Corvidae|Garrulus|glandarius|Garrulus glandarius (Linnaeus, 1758)	15
Edraianthus graminifolius (L.) A.DC.	Plantae|Magnoliophyta|Magnoliopsida|Asterales|Campanulaceae|Edraianthus|graminifolius|Edraianthus graminifolius (L.) A.DC.	15
Lecidella elaeochroma (Ach.) M. Choisy	Fungi|Ascomycota|Lecanoromycetes|Lecanorales|Lecanoraceae|Lecidella|elaeochroma|Lecidella elaeochroma (Ach.) M. Choisy	15
Farnoldia jurana (Schaer.) Hertel	Fungi|Ascomycota|Lecanoromycetes|Lecanorales|Lecideaceae|Farnoldia|jurana|Farnoldia jurana (Schaer.) Hertel	15
Edraianthus graminifolius (L.) A.DC.	Plantae|Tracheophyta|Magnoliopsida|Asterales|Campanulaceae|Edraianthus|graminifolius|Edraianthus graminifolius (L.) A.DC.	15
Xanthoria elegans (Link) Th. Fr.	Fungi|Ascomycota|Lecanoromycetes|Teloschistales|Teloschistaceae|Xanthoria|elegans|Xanthoria elegans (Link) Th. Fr.	15
Motacilla alba Linnaeus, 1758	Animalia|Chordata|Aves|Passeriformes|Motacillidae|Motacilla|alba|Motacilla alba Linnaeus, 1758	14
Oriolus oriolus (Linnaeus, 1758)	Animalia|Chordata|Aves|Passeriformes|Oriolidae|Oriolus|oriolus|Oriolus oriolus (Linnaeus, 1758)	14
Lecidella stigmatea (Ach.) Hertel & Leuckert	Fungi|Ascomycota|Lecanoromycetes|Lecanorales|Lecanoraceae|Lecidella|stigmatea|Lecidella stigmatea (Ach.) Hertel & Leuckert	14
Protoparmeliopsis muralis (Schreb.) M.Choisy	Fungi|Ascomycota|Lecanoromycetes|Lecanorales|Lecanoraceae|Protoparmeliopsis|muralis|Protoparmeliopsis muralis (Schreb.) M.Choisy	14
Streptopelia decaocto (Frivaldszky, 1838)	Animalia|Chordata|Aves|Columbiformes|Columbidae|Streptopelia|decaocto|Streptopelia decaocto (Frivaldszky, 1838)	14
Passer domesticus (Linnaeus, 1758)	Animalia|Chordata|Aves|Passeriformes|Passeridae|Passer|domesticus|Passer domesticus (Linnaeus, 1758)	14
Cetraria islandica (L.) Ach.	Fungi|Ascomycota|Lecanoromycetes|Lecanorales|Parmeliaceae|Cetraria|islandica|Cetraria islandica (L.) Ach.	14
Doratopsylla dasycnema dasycnema (Rothschild, 1897)	Animalia|Arthropoda|Insecta|Siphonaptera|Ctenophthalmidae|Doratopsylla|dasycnema|Doratopsylla dasycnema dasycnema (Rothschild, 1897)	13
Doratopsylla dasycnema (Rothschild, 1897)	Animalia|Arthropoda|Insecta|Siphonaptera|Hystrichopsyllidae|Doratopsylla|dasycnema|Doratopsylla dasycnema (Rothschild, 1897)	13
Flavocetraria nivalis (L.) Kärnefelt & A. Thell	Fungi|Ascomycota|Lecanoromycetes|Lecanorales|Parmeliaceae|Flavocetraria|nivalis|Flavocetraria nivalis (L.) Kärnefelt & A. Thell	12
Erithacus rubecula (Linnaeus, 1758)	Animalia|Chordata|Aves|Passeriformes|Muscicapidae|Erithacus|rubecula|Erithacus rubecula (Linnaeus, 1758)	12
Carthamus lanatus	Plantae|Magnoliophyta|Magnoliopsida|Asterales|Asteraceae|Carthamus|Carthamus lanatus	12
Carlina acaulis	Plantae|Magnoliophyta|Magnoliopsida|Asterales|Asteraceae|Carlina|Carlina acaulis	12
Rinodina mniaraea var. mniaraeiza (Nyl.) H. Magn.	Fungi|Ascomycota|Lecanoromycetes|Teloschistales|Physciaceae|Rinodina|mniaraea|Rinodina mniaraea var. mniaraeiza (Nyl.) H. Magn.	12
Rinodina freyi H. Magn.	Fungi|Ascomycota|Lecanoromycetes|Teloschistales|Physciaceae|Rinodina|freyi|Rinodina freyi H. Magn.	12
Calvitimela armeniaca (DC.) Hafellner	Fungi|Ascomycota|Lecanoromycetes|Lecanorales|Mycoblastaceae|Calvitimela|armeniaca|Calvitimela armeniaca (DC.) Hafellner	12
Protoparmelia badia (Hoffm.) Hafellner	Fungi|Ascomycota|Lecanoromycetes|Lecanorales|Parmeliaceae|Protoparmelia|badia|Protoparmelia badia (Hoffm.) Hafellner	12
Umbilicaria cylindrica (L.) Delise ex Duby	Fungi|Ascomycota|Lecanoromycetes|Umbilicariales|Umbilicariaceae|Umbilicaria|cylindrica|Umbilicaria cylindrica (L.) Delise ex Duby	12
Parmelia saxatilis (L.) Ach.	Fungi|Ascomycota|Lecanoromycetes|Lecanorales|Parmeliaceae|Parmelia|saxatilis|Parmelia saxatilis (L.) Ach.	12
Bilimbia lobulata (Sommerf.) Hafellner & Coppins	Fungi|Ascomycota|Lecanoromycetes|||Bilimbia|lobulata|Bilimbia lobulata (Sommerf.) Hafellner & Coppins	12
Corvus cornix	Animalia|Chordata|Aves|Passeriformes|Corvidae|Corvus|Corvus cornix	12
Turdus merula Linnaeus, 1758	Animalia|Chordata|Aves|Passeriformes|Turdidae|Turdus|merula|Turdus merula Linnaeus, 1758	12
Rinodina milvina (Wahlenb.) Th. Fr.	Fungi|Ascomycota|Lecanoromycetes|Teloschistales|Physciaceae|Rinodina|milvina|Rinodina milvina (Wahlenb.) Th. Fr.	12
Luscinia megarhynchos (Brehm, 1831)	Animalia|Chordata|Aves|Passeriformes|Muscicapidae|Luscinia|megarhynchos|Luscinia megarhynchos (Brehm, 1831)	12
Fringilla coelebs Linnaeus, 1758	Animalia|Chordata|Aves|Passeriformes|Fringillidae|Fringilla|coelebs|Fringilla coelebs Linnaeus, 1758	12
Catapyrenium cinereum (Pers.) Körb.	Fungi|Ascomycota|Eurotiomycetes|Verrucariales|Verrucariaceae|Catapyrenium|cinereum|Catapyrenium cinereum (Pers.) Körb.	12
Lecanora varia (Hoffm.) Ach.	Fungi|Ascomycota|Lecanoromycetes|Lecanorales|Lecanoraceae|Lecanora|varia|Lecanora varia (Hoffm.) Ach.	11
Sylvia communis Latham, 1787	Animalia|Chordata|Aves|Passeriformes|Sylviidae|Sylvia|communis|Sylvia communis Latham, 1787	11
Palaeopsylla similis Dampf, 1910	Animalia|Arthropoda|Insecta|Siphonaptera|Hystrichopsyllidae|Palaeopsylla|similis|Palaeopsylla similis Dampf, 1910	11
Avena sativa L.	Plantae|Magnoliophyta|Liliopsida|Poales|Poaceae|Avena|sativa|Avena sativa L.	11
Emberiza citrinella Linnaeus, 1758	Animalia|Chordata|Aves|Passeriformes|Emberizidae|Emberiza|citrinella|Emberiza citrinella Linnaeus, 1758	11
Avena sativa L.	Plantae|Tracheophyta|Liliopsida|Poales|Poaceae|Avena|sativa|Avena sativa L.	11
Carduelis carduelis (Linnaeus, 1758)	Animalia|Chordata|Aves|Passeriformes|Fringillidae|Carduelis|carduelis|Carduelis carduelis (Linnaeus, 1758)	11
Staurothele areolata (Ach.) Lettau	Fungi|Ascomycota|Eurotiomycetes|Verrucariales|Verrucariaceae|Staurothele|areolata|Staurothele areolata (Ach.) Lettau	11
Dendrocopos major (Linnaeus, 1758)	Animalia|Chordata|Aves|Piciformes|Picidae|Dendrocopos|major|Dendrocopos major (Linnaeus, 1758)	11
Palaeopsylla similis peusi Smit, 1953	Animalia|Arthropoda|Insecta|Siphonaptera|Ctenophthalmidae|Palaeopsylla|similis|Palaeopsylla similis peusi Smit, 1953	10
Lecanora polytropa (Ehrh.) Rabenh.	Fungi|Ascomycota|Lecanoromycetes|Lecanorales|Lecanoraceae|Lecanora|polytropa|Lecanora polytropa (Ehrh.) Rabenh.	10
Corvus frugilegus Linnaeus, 1758	Animalia|Chordata|Aves|Passeriformes|Corvidae|Corvus|frugilegus|Corvus frugilegus Linnaeus, 1758	10
Passer montanus (Linnaeus, 1758)	Animalia|Chordata|Aves|Passeriformes|Passeridae|Passer|montanus|Passer montanus (Linnaeus, 1758)	10
Sylvia atricapilla (Linnaeus, 1758)	Animalia|Chordata|Aves|Passeriformes|Sylviidae|Sylvia|atricapilla|Sylvia atricapilla (Linnaeus, 1758)	10
Megabothris turbidus (Rothschild, 1909)	Animalia|Arthropoda|Insecta|Siphonaptera|Ceratophyllidae|Megabothris|turbidus|Megabothris turbidus (Rothschild, 1909)	10
Motacilla cinerea Tunstall, 1771	Animalia|Chordata|Aves|Passeriformes|Motacillidae|Motacilla|cinerea|Motacilla cinerea Tunstall, 1771	10
Iphiclides podalirius (Linnaeus, 1758)	Animalia|Arthropoda|Insecta|Lepidoptera|Papilionidae|Iphiclides|podalirius|Iphiclides podalirius (Linnaeus, 1758)	10
Sitta europaea Linnaeus, 1758	Animalia|Chordata|Aves|Passeriformes|Sittidae|Sitta|europaea|Sitta europaea Linnaeus, 1758	10
Protonemura intricata subsp. intricata	Animalia|Arthropoda|Insecta|Plecoptera|Nemouridae|Protonemura|intricata|Protonemura intricata subsp. intricata	10
Ochrolechia alboflavescens (Wulfen) Zahlbr.	Fungi|Ascomycota|Lecanoromycetes|Pertusariales|Ochrolechiaceae|Ochrolechia|alboflavescens|Ochrolechia alboflavescens (Wulfen) Zahlbr.	9
Ramboldia insidiosa (Th. Fr.) Hafellner	Fungi|Ascomycota|Lecanoromycetes|Lecanorales|Lecanoraceae|Ramboldia|insidiosa|Ramboldia insidiosa (Th. Fr.) Hafellner	9
Diploschistes muscorum (Scop.) R. Sant.	Fungi|Ascomycota|Lecanoromycetes|Ostropales|Graphidaceae|Diploschistes|muscorum|Diploschistes muscorum (Scop.) R. Sant.	9
Umbilicaria decussata (Vill.) Zahlbr.	Fungi|Ascomycota|Lecanoromycetes|Umbilicariales|Umbilicariaceae|Umbilicaria|decussata|Umbilicaria decussata (Vill.) Zahlbr.	9
Dryocopus martius (Linnaeus, 1758)	Animalia|Chordata|Aves|Piciformes|Picidae|Dryocopus|martius|Dryocopus martius (Linnaeus, 1758)	9
Lecanora hagenii var. fallax Hepp	Fungi|Ascomycota|Lecanoromycetes|Lecanorales|Lecanoraceae|Lecanora|hagenii|Lecanora hagenii var. fallax Hepp	9
Columba livia Gmelin, 1789	Animalia|Chordata|Aves|Columbiformes|Columbidae|Columba|livia|Columba livia Gmelin, 1789	9
Fulica atra Linnaeus, 1758	Animalia|Chordata|Aves|Gruiformes|Rallidae|Fulica|atra|Fulica atra Linnaeus, 1758	9
Rhizocarpon carpaticum Runemark	Fungi|Ascomycota|Lecanoromycetes|Lecanorales|Rhizocarpaceae|Rhizocarpon|carpaticum|Rhizocarpon carpaticum Runemark	9
Anaptychia ciliaris (L.) Körb.	Fungi|Ascomycota|Lecanoromycetes|Teloschistales|Physciaceae|Anaptychia|ciliaris|Anaptychia ciliaris (L.) Körb.	9
Ochrolechia androgyna (Hoffm.) Arnold	Fungi|Ascomycota|Lecanoromycetes|Pertusariales|Ochrolechiaceae|Ochrolechia|androgyna|Ochrolechia androgyna (Hoffm.) Arnold	9
Geranium sanguineum	Plantae|Magnoliophyta|Magnoliopsida|Geraniales|Geraniaceae|Geranium|Geranium sanguineum	8
Euphydryas aurinia	Animalia|Arthropoda|Insecta|Lepidoptera|Nymphalidae|Euphydryas|Euphydryas aurinia	8
Cladonia arbuscula subsp. mitis (Sandst.) Ruoss	Fungi|Ascomycota|Lecanoromycetes|Lecanorales|Cladoniaceae|Cladonia|arbuscula|Cladonia arbuscula subsp. mitis (Sandst.) Ruoss	8
Lecanora cenisia Ach.	Fungi|Ascomycota|Lecanoromycetes|Lecanorales|Lecanoraceae|Lecanora|cenisia|Lecanora cenisia Ach.	8
Peromyscopsylla fallax (Rothschild, 1909)	Animalia|Arthropoda|Insecta|Siphonaptera|Ceratophyllidae|Peromyscopsylla|fallax|Peromyscopsylla fallax (Rothschild, 1909)	8
Orchis purpurea	Plantae|Magnoliophyta|Liliopsida|Asparagales|Orchidaceae|Orchis|Orchis purpurea	8
Ornithogalum umbellatum	Plantae|Magnoliophyta|Liliopsida|Asparagales|Asparagaceae|Ornithogalum|Ornithogalum umbellatum	8
Cetraria ericetorum Opiz	Fungi|Ascomycota|Lecanoromycetes|Lecanorales|Parmeliaceae|Cetraria|ericetorum|Cetraria ericetorum Opiz	8
Picus viridis Linnaeus, 1758	Animalia|Chordata|Aves|Piciformes|Picidae|Picus|viridis|Picus viridis Linnaeus, 1758	8
Lamium amplexicaule	Plantae|Magnoliophyta|Magnoliopsida|Lamiales|Lamiaceae|Lamium|Lamium amplexicaule	8
Phoenicurus ochruros (S. G. Gmelin, 1774)	Animalia|Chordata|Aves|Passeriformes|Muscicapidae|Phoenicurus|ochruros|Phoenicurus ochruros (S. G. Gmelin, 1774)	8
Cladonia symphycarpia (Flörke) Fr.	Fungi|Ascomycota|Lecanoromycetes|Lecanorales|Cladoniaceae|Cladonia|symphycarpia|Cladonia symphycarpia (Flörke) Fr.	8
Polygonatum odoratum	Plantae|Magnoliophyta|Liliopsida|Asparagales|Asparagaceae|Polygonatum|Polygonatum odoratum	8
Lonchodina Bassler, 1925	Animalia|Chordata||||Lonchodina||Lonchodina Bassler, 1925	8
Peromyscopsylla fallax (Rothschild, 1909)	Animalia|Arthropoda|Insecta|Siphonaptera|Leptopsyllidae|Peromyscopsylla|fallax|Peromyscopsylla fallax (Rothschild, 1909)	8
Amphinemura triangularis (Ris, 1902)	Animalia|Arthropoda|Insecta|Plecoptera|Nemouridae|Amphinemura|triangularis|Amphinemura triangularis (Ris, 1902)	8
Iphiclides podalirius	Animalia|Arthropoda|Insecta|Lepidoptera|Papilionidae|Iphiclides|Iphiclides podalirius	8
Brachyptera seticornis (Klapálek, 1902)	Animalia|Arthropoda|Insecta|Plecoptera|Taeniopterygidae|Brachyptera|seticornis|Brachyptera seticornis (Klapálek, 1902)	8
Cytisus hirsutus	Plantae|Magnoliophyta|Magnoliopsida|Fabales|Fabaceae|Cytisus|Cytisus hirsutus	8
Physcia dubia (Hoffm.) Lettau	Fungi|Ascomycota|Lecanoromycetes|Teloschistales|Physciaceae|Physcia|dubia|Physcia dubia (Hoffm.) Lettau	8
Columba palumbus Linnaeus, 1758	Animalia|Chordata|Aves|Columbiformes|Columbidae|Columba|palumbus|Columba palumbus Linnaeus, 1758	8
Cichorium intybus	Plantae|Magnoliophyta|Magnoliopsida|Asterales|Asteraceae|Cichorium|Cichorium intybus	8
Galerida cristata (Linnaeus, 1758)	Animalia|Chordata|Aves|Passeriformes|Alaudidae|Galerida|cristata|Galerida cristata (Linnaeus, 1758)	7
Palaeopsylla soricis (Dale, 1878)	Animalia|Arthropoda|Insecta|Siphonaptera|Hystrichopsyllidae|Palaeopsylla|soricis|Palaeopsylla soricis (Dale, 1878)	7
Lecidea lactea Flörke ex Schaer.	Fungi|Ascomycota|Lecanoromycetes|Lecanorales|Lecideaceae|Lecidea|lactea|Lecidea lactea Flörke ex Schaer.	7
Emberiza calandra Linnaeus, 1758	Animalia|Chordata|Aves|Passeriformes|Emberizidae|Emberiza|calandra|Emberiza calandra Linnaeus, 1758	7
Emberiza cirlus Linnaeus, 1766	Animalia|Chordata|Aves|Passeriformes|Emberizidae|Emberiza|cirlus|Emberiza cirlus Linnaeus, 1766	7
Anas platyrhynchos Linnaeus, 1758	Animalia|Chordata|Aves|Anseriformes|Anatidae|Anas|platyrhynchos|Anas platyrhynchos Linnaeus, 1758	7
Troglodytes troglodytes (Linnaeus, 1758)	Animalia|Chordata|Aves|Passeriformes|Troglodytidae|Troglodytes|troglodytes|Troglodytes troglodytes (Linnaeus, 1758)	7
Bacidia bagliettoana (A. Massal. & De Not.) Jatta	Fungi|Ascomycota|Lecanoromycetes|Lecanorales|Ramalinaceae|Bacidia|bagliettoana|Bacidia bagliettoana (A. Massal. & De Not.) Jatta	7
Hypogymnia tubulosa (Schaer.) Hav.	Fungi|Ascomycota|Lecanoromycetes|Lecanorales|Parmeliaceae|Hypogymnia|tubulosa|Hypogymnia tubulosa (Schaer.) Hav.	7
Neotinea tridentata	Plantae|Magnoliophyta|Liliopsida|Asparagales|Orchidaceae|Neotinea|Neotinea tridentata	7
Accipiter nisus (Linnaeus, 1758)	Animalia|Chordata|Aves|Accipitriformes|Accipitridae|Accipiter|nisus|Accipiter nisus (Linnaeus, 1758)	7
Amandinea punctata (Hoffm.) Coppins & Scheid.	Fungi|Ascomycota|Lecanoromycetes|Teloschistales|Physciaceae|Amandinea|punctata|Amandinea punctata (Hoffm.) Coppins & Scheid.	7
Delichon urbicum (Linnaeus, 1758)	Animalia|Chordata|Aves|Passeriformes|Hirundinidae|Delichon|urbicum|Delichon urbicum (Linnaeus, 1758)	7
Sporastatia testudinea (Ach.) A. Massal.	Fungi|Ascomycota|Lecanoromycetes||Sporastatiaceae|Sporastatia|testudinea|Sporastatia testudinea (Ach.) A. Massal.	7
Turdus viscivorus Linnaeus, 1758	Animalia|Chordata|Aves|Passeriformes|Turdidae|Turdus|viscivorus|Turdus viscivorus Linnaeus, 1758	7
Phylloscopus collybita (Vieillot, 1817)	Animalia|Chordata|Aves|Passeriformes|Phylloscopidae|Phylloscopus|collybita|Phylloscopus collybita (Vieillot, 1817)	7
Protoparmeliopsis muralis (Rabenh.) M. Choisy	Fungi|Ascomycota|Lecanoromycetes|Lecanorales|Lecanoraceae|Protoparmeliopsis|muralis|Protoparmeliopsis muralis (Rabenh.) M. Choisy	7
Lecidea promiscens Nyl.	Fungi|Ascomycota|Lecanoromycetes|Lecanorales|Lecideaceae|Lecidea|promiscens|Lecidea promiscens Nyl.	7
Carbonea vitellinaria (Nyl.) Hertel	Fungi|Ascomycota|Lecanoromycetes|Lecanorales|Lecanoraceae|Carbonea|vitellinaria|Carbonea vitellinaria (Nyl.) Hertel	6
Romjularia lurida (Ach.) Timdal	Fungi|Ascomycota|Lecanoromycetes|Lecanorales|Lecideaceae|Romjularia|lurida|Romjularia lurida (Ach.) Timdal	6
Arcyria dentata Schumach.	Protozoa|Mycetozoa|Myxomycetes|Trichiales|Arcyriaceae|Arcyria|dentata|Arcyria dentata Schumach.	6
Anthus spinoletta (Linnaeus, 1758)	Animalia|Chordata|Aves|Passeriformes|Motacillidae|Anthus|spinoletta|Anthus spinoletta (Linnaeus, 1758)	6
Orchis purpurea Huds.	Plantae|Tracheophyta|Liliopsida|Asparagales|Orchidaceae|Orchis|purpurea|Orchis purpurea Huds.	6
Peltigera leucophlebia (Nyl.) Gyeln.	Fungi|Ascomycota|Lecanoromycetes|Peltigerales|Peltigeraceae|Peltigera|leucophlebia|Peltigera leucophlebia (Nyl.) Gyeln.	6
Protoblastenia calva (Dicks.) Zahlbr.	Fungi|Ascomycota|Lecanoromycetes|Lecanorales|Psoraceae|Protoblastenia|calva|Protoblastenia calva (Dicks.) Zahlbr.	6
Rhizocarpon lavatum (Fr.) Hazsl.	Fungi|Ascomycota|Lecanoromycetes|Lecanorales|Rhizocarpaceae|Rhizocarpon|lavatum|Rhizocarpon lavatum (Fr.) Hazsl.	6
Bellemerea alpina (Sommerf.) Clauzade & Cl. Roux	Fungi|Ascomycota|Lecanoromycetes|Lecanorales|Lecideaceae|Bellemerea|alpina|Bellemerea alpina (Sommerf.) Clauzade & Cl. Roux	6
Rinodina mniaraea (Ach.) Körb.	Fungi|Ascomycota|Lecanoromycetes|Teloschistales|Physciaceae|Rinodina|mniaraea|Rinodina mniaraea (Ach.) Körb.	6
Gondolella Stauffer & Plummer, 1932	Animalia|Chordata||||Gondolella||Gondolella Stauffer & Plummer, 1932	6
Rhizocarpon polycarpum (Hepp) Th. Fr.	Fungi|Ascomycota|Lecanoromycetes|Lecanorales|Rhizocarpaceae|Rhizocarpon|polycarpum|Rhizocarpon polycarpum (Hepp) Th. Fr.	6
Solorina saccata (L.) Ach.	Fungi|Ascomycota|Lecanoromycetes|Peltigerales|Peltigeraceae|Solorina|saccata|Solorina saccata (L.) Ach.	6
Pleopsidium chlorophanum (Wahlenb.) Zopf	Fungi|Ascomycota|Lecanoromycetes|Acarosporales|Acarosporaceae|Pleopsidium|chlorophanum|Pleopsidium chlorophanum (Wahlenb.) Zopf	6
Pseudevernia furfuracea (L.) Zopf	Fungi|Ascomycota|Lecanoromycetes|Lecanorales|Parmeliaceae|Pseudevernia|furfuracea|Pseudevernia furfuracea (L.) Zopf	6
Verrucaria funckii (Spreng.) Zahlbr.	Fungi|Ascomycota|Eurotiomycetes|Verrucariales|Verrucariaceae|Verrucaria|funckii|Verrucaria funckii (Spreng.) Zahlbr.	6
Hindeodella Bassler, 1925	Animalia|Chordata|||Coleodontidae|Hindeodella||Hindeodella Bassler, 1925	6
Solorina crocea (L.) Ach.	Fungi|Ascomycota|Lecanoromycetes|Peltigerales|Peltigeraceae|Solorina|crocea|Solorina crocea (L.) Ach.	6
Gondolella navicula (Huckriede, 1958)	Animalia|Chordata||||Gondolella|navicula|Gondolella navicula (Huckriede, 1958)	6
Protoparmelia cupreobadia (Nyl.) Poelt	Fungi|Ascomycota|Lecanoromycetes|Lecanorales|Parmeliaceae|Protoparmelia|cupreobadia|Protoparmelia cupreobadia (Nyl.) Poelt	6
Gorjanovicia Polsak, 1967	Animalia|Mollusca|Bivalvia||Radiolitidae|Gorjanovicia||Gorjanovicia Polsak, 1967	6
Psora decipiens (Hedw.) Hoffm.	Fungi|Ascomycota|Lecanoromycetes|Lecanorales|Psoraceae|Psora|decipiens|Psora decipiens (Hedw.) Hoffm.	6
Cladonia pyxidata (L.) Hoffm.	Fungi|Ascomycota|Lecanoromycetes|Lecanorales|Cladoniaceae|Cladonia|pyxidata|Cladonia pyxidata (L.) Hoffm.	6
Placidium squamulosum (Ach.) Breuss	Fungi|Ascomycota|Eurotiomycetes|Verrucariales|Verrucariaceae|Placidium|squamulosum|Placidium squamulosum (Ach.) Breuss	6
Falco tinnunculus Linnaeus, 1758	Animalia|Chordata|Aves|Falconiformes|Falconidae|Falco|tinnunculus|Falco tinnunculus Linnaeus, 1758	6
Tremolecia atrata (Ach.) Hertel	Fungi|Ascomycota|Lecanoromycetes|Lecanorales|Hymeneliaceae|Tremolecia|atrata|Tremolecia atrata (Ach.) Hertel	6
Issoria lathonia Linnaeus, 1758	Animalia|Arthropoda|Insecta|Lepidoptera|Nymphalidae|Issoria|lathonia|Issoria lathonia Linnaeus, 1758	6
Lecanora pulicaris (Pers.) Ach.	Fungi|Ascomycota|Lecanoromycetes|Lecanorales|Lecanoraceae|Lecanora|pulicaris|Lecanora pulicaris (Pers.) Ach.	6
Otus scops (Linnaeus, 1758)	Animalia|Chordata|Aves|Strigiformes|Strigidae|Otus|scops|Otus scops (Linnaeus, 1758)	6
Lecidella patavina (A. Massal.) Knoph & Leuckert	Fungi|Ascomycota|Lecanoromycetes|Lecanorales|Lecanoraceae|Lecidella|patavina|Lecidella patavina (A. Massal.) Knoph & Leuckert	6
Orchis purpurea Huds.	Plantae|Magnoliophyta|Liliopsida|Asparagales|Orchidaceae|Orchis|purpurea|Orchis purpurea Huds.	6
Lecanora carpinea (L.) Vain.	Fungi|Ascomycota|Lecanoromycetes|Lecanorales|Lecanoraceae|Lecanora|carpinea|Lecanora carpinea (L.) Vain.	6
Tachybaptus ruficollis (Pallas, 1764)	Animalia|Chordata|Aves|Podicipediformes|Podicipedidae|Tachybaptus|ruficollis|Tachybaptus ruficollis (Pallas, 1764)	6
Ciconia ciconia (Linnaeus, 1758)	Animalia|Chordata|Aves|Ciconiiformes|Ciconiidae|Ciconia|ciconia|Ciconia ciconia (Linnaeus, 1758)	6
Chloris chloris (Linnaeus, 1758)	Animalia|Chordata|Aves|Passeriformes|Fringillidae|Chloris|chloris|Chloris chloris (Linnaeus, 1758)	6
Parus caeruleus Linnaeus, 1758	Animalia|Chordata|Aves|Passeriformes|Paridae|Cyanistes|caeruleus|Parus caeruleus Linnaeus, 1758	6
Cirsium vulgare	Plantae|Magnoliophyta|Magnoliopsida|Asterales|Asteraceae|Cirsium|Cirsium vulgare	6
Pseudephebe pubescens (L.) M. Choisy	Fungi|Ascomycota|Lecanoromycetes|Lecanorales|Parmeliaceae|Pseudephebe|pubescens|Pseudephebe pubescens (L.) M. Choisy	6
Pseudevernia furfuracea var. furfuracea	Fungi|Ascomycota|Lecanoromycetes|Lecanorales|Parmeliaceae|Pseudevernia|furfuracea|Pseudevernia furfuracea var. furfuracea	6
Squamarina gypsacea (Sm.) Poelt	Fungi|Ascomycota|Lecanoromycetes|Lecanorales|Stereocaulaceae|Squamarina|gypsacea|Squamarina gypsacea (Sm.) Poelt	6
Parmeliopsis ambigua (Wulfen) Nyl.	Fungi|Ascomycota|Lecanoromycetes|Lecanorales|Parmeliaceae|Parmeliopsis|ambigua|Parmeliopsis ambigua (Wulfen) Nyl.	6
Ramalina fraxinea (L.) Ach.	Fungi|Ascomycota|Lecanoromycetes|Lecanorales|Ramalinaceae|Ramalina|fraxinea|Ramalina fraxinea (L.) Ach.	6
Cornicularia normoerica (Gunnerus) Du Rietz	Fungi|Ascomycota|Lecanoromycetes|Lecanorales|Parmeliaceae|Cornicularia|normoerica|Cornicularia normoerica (Gunnerus) Du Rietz	6
Isoperla tripartita Illies, 1954	Animalia|Arthropoda|Insecta|Plecoptera|Perlodidae|Isoperla|tripartita|Isoperla tripartita Illies, 1954	6
Emberiza hortulana Linnaeus, 1758	Animalia|Chordata|Aves|Passeriformes|Emberizidae|Emberiza|hortulana|Emberiza hortulana Linnaeus, 1758	6
Ctenophthalmus assimilis subsp. assimilis	Animalia|Arthropoda|Insecta|Siphonaptera|Hystrichopsyllidae|Ctenophthalmus|assimilis|Ctenophthalmus assimilis subsp. assimilis	5
Thamnolia vermicularis (Sw.) Ach. ex Schaer.	Fungi|Ascomycota|Lecanoromycetes|Pertusariales|Icmadophilaceae|Thamnolia|vermicularis|Thamnolia vermicularis (Sw.) Ach. ex Schaer.	5
Streptopelia turtur (Linnaeus, 1758)	Animalia|Chordata|Aves|Columbiformes|Columbidae|Streptopelia|turtur|Streptopelia turtur (Linnaeus, 1758)	5
Pyrrhula pyrrhula (Linnaeus, 1758)	Animalia|Chordata|Aves|Passeriformes|Fringillidae|Pyrrhula|pyrrhula|Pyrrhula pyrrhula (Linnaeus, 1758)	5
Perdix perdix (Linnaeus, 1758)	Animalia|Chordata|Aves|Galliformes|Phasianidae|Perdix|perdix|Perdix perdix (Linnaeus, 1758)	5
Apus apus (Linnaeus, 1758)	Animalia|Chordata|Aves|Apodiformes|Apodidae|Apus|apus|Apus apus (Linnaeus, 1758)	5
Ornithogalum umbellatum L.	Plantae|Tracheophyta|Liliopsida|Asparagales|Asparagaceae|Ornithogalum|umbellatum|Ornithogalum umbellatum L.	5
Carduelis cannabina (Linnaeus, 1758)	Animalia|Chordata|Aves|Passeriformes|Fringillidae|Linaria|cannabina|Carduelis cannabina (Linnaeus, 1758)	5
Lobothallia radiosa (Hoffm.) Hafellner	Fungi|Ascomycota|Lecanoromycetes|Pertusariales|Megasporaceae|Lobothallia|radiosa|Lobothallia radiosa (Hoffm.) Hafellner	5
Ctenophthalmus assimilis (Taschenberg, 1880)	Animalia|Arthropoda|Insecta|Siphonaptera|Hystrichopsyllidae|Ctenophthalmus|assimilis|Ctenophthalmus assimilis (Taschenberg, 1880)	5
Dendrocopos medius (Linnaeus, 1758)	Animalia|Chordata|Aves|Piciformes|Picidae|Dendrocopos|medius|Dendrocopos medius (Linnaeus, 1758)	5
Lepraria alpina (B. de Lesd.) Tretiach & Baruffo	Fungi|Ascomycota|Lecanoromycetes|Lecanorales|Stereocaulaceae|Lepraria|alpina|Lepraria alpina (B. de Lesd.) Tretiach & Baruffo	5
Lullula arborea (Linnaeus, 1758)	Animalia|Chordata|Aves|Passeriformes|Alaudidae|Lullula|arborea|Lullula arborea (Linnaeus, 1758)	5
Lanius collurio Linnaeus, 1758	Animalia|Chordata|Aves|Passeriformes|Laniidae|Lanius|collurio|Lanius collurio Linnaeus, 1758	5
Triticum aestivum L.	Plantae|Tracheophyta|Liliopsida|Poales|Poaceae|Triticum|aestivum|Triticum aestivum L.	5
Serinus serinus (Linnaeus, 1766)	Animalia|Chordata|Aves|Passeriformes|Fringillidae|Serinus|serinus|Serinus serinus (Linnaeus, 1766)	5
Stereocaulon alpinum Laurer	Fungi|Ascomycota|Lecanoromycetes|Lecanorales|Stereocaulaceae|Stereocaulon|alpinum|Stereocaulon alpinum Laurer	5
Ardea cinerea Linnaeus, 1758	Animalia|Chordata|Aves|Pelecaniformes|Ardeidae|Ardea|cinerea|Ardea cinerea Linnaeus, 1758	5
Palaeopsylla soricis starki Wagner, 1930	Animalia|Arthropoda|Insecta|Siphonaptera|Ctenophthalmidae|Palaeopsylla|soricis|Palaeopsylla soricis starki Wagner, 1930	5
Leptopsylla taschenbergi (Wagner, 1898)	Animalia|Arthropoda|Insecta|Siphonaptera|Ceratophyllidae|Leptopsylla|taschenbergi|Leptopsylla taschenbergi (Wagner, 1898)	5
Cytisus hirsutus L.	Plantae|Tracheophyta|Magnoliopsida|Fabales|Fabaceae|Cytisus|hirsutus|Cytisus hirsutus L.	5
Oenanthe oenanthe (Linnaeus, 1758)	Animalia|Chordata|Aves|Passeriformes|Muscicapidae|Oenanthe|oenanthe|Oenanthe oenanthe (Linnaeus, 1758)	5
Triticum aestivum L.	Plantae|Magnoliophyta|Liliopsida|Poales|Poaceae|Triticum|aestivum|Triticum aestivum L.	5
Turdus philomelos C. L. Brehm, 1831	Animalia|Chordata|Aves|Passeriformes|Turdidae|Turdus|philomelos|Turdus philomelos C. L. Brehm, 1831	5
Saxicola rubetra (Linnaeus, 1758)	Animalia|Chordata|Aves|Passeriformes|Muscicapidae|Saxicola|rubetra|Saxicola rubetra (Linnaeus, 1758)	5
Aegithalos caudatus (Linnaeus, 1758)	Animalia|Chordata|Aves|Passeriformes|Aegithalidae|Aegithalos|caudatus|Aegithalos caudatus (Linnaeus, 1758)	5
Leptopsylla taschenbergi (Wagner, 1898)	Animalia|Arthropoda|Insecta|Siphonaptera|Leptopsyllidae|Leptopsylla|taschenbergi|Leptopsylla taschenbergi (Wagner, 1898)	5
Ornithogalum umbellatum L.	Plantae|Magnoliophyta|Liliopsida|Asparagales|Asparagaceae|Ornithogalum|umbellatum|Ornithogalum umbellatum L.	5
Corvus corone Linnaeus, 1758	Animalia|Chordata|Aves|Passeriformes|Corvidae|Corvus|corone|Corvus corone Linnaeus, 1758	5
Herilla Robineau-Desvoidy, 1863	Animalia|Arthropoda|Insecta|Diptera|Tachinidae|Herilla||Herilla Robineau-Desvoidy, 1863	5
Caloplaca cerina var. muscorum (A. Massal.) Jatta	Fungi|Ascomycota|Lecanoromycetes|Teloschistales|Teloschistaceae|Caloplaca|cerina|Caloplaca cerina var. muscorum (A. Massal.) Jatta	4
Carduelis carduelis	Animalia|Chordata|Aves|Passeriformes|Fringillidae|Carduelis|Carduelis carduelis	4
Smyrnium perfoliatum L.	Plantae|Magnoliophyta|Magnoliopsida|Apiales|Apiaceae|Smyrnium|perfoliatum|Smyrnium perfoliatum L.	4
Secale cereale subsp. cereale	Plantae|Magnoliophyta|Liliopsida|Poales|Poaceae|Secale|cereale|Secale cereale subsp. cereale	4
Ranunculus millefoliatus Vahl	Plantae|Magnoliophyta|Magnoliopsida|Ranunculales|Ranunculaceae|Ranunculus|millefoliatus|Ranunculus millefoliatus Vahl	4
Zootoca vivipara Von Jacquin, 1787	Animalia|Chordata|Reptilia|Squamata|Lacertidae|Zootoca|vivipara|Zootoca vivipara Von Jacquin, 1787	4
Muellerella pygmaea (Körb.) D. Hawksw.	Fungi|Ascomycota|Eurotiomycetes|Verrucariales|Verrucariaceae|Muellerella|pygmaea|Muellerella pygmaea (Körb.) D. Hawksw.	4
Radiolites Lamarck, 1801	Animalia|Mollusca|Bivalvia||Radiolitidae|Radiolites||Radiolites Lamarck, 1801	4
Saturnia pyri	Animalia|Arthropoda|Insecta|Lepidoptera|Saturniidae|Saturnia|Saturnia pyri	4
Lapeirousella Milovanovic, 1938	Animalia|Mollusca|Bivalvia||Radiolitidae|Lapeirousella||Lapeirousella Milovanovic, 1938	4
Limodorum abortivum	Plantae|Magnoliophyta|Liliopsida|Asparagales|Orchidaceae|Limodorum|Limodorum abortivum	4
Motacilla cinerea	Animalia|Chordata|Aves|Passeriformes|Motacillidae|Motacilla|Motacilla cinerea	4
Scopula ornata	Animalia|Arthropoda|Insecta|Lepidoptera|Geometridae|Scopula|Scopula ornata	4
Galeopsis speciosa	Plantae|Magnoliophyta|Magnoliopsida|Lamiales|Lamiaceae|Galeopsis|Galeopsis speciosa	4
Vicia lutea	Plantae|Magnoliophyta|Magnoliopsida|Fabales|Fabaceae|Vicia|Vicia lutea	4
Emberiza cirlus	Animalia|Chordata|Aves|Passeriformes|Emberizidae|Emberiza|Emberiza cirlus	4
Ozarkodina Branson & Mehl, 1933	Animalia|Chordata|||Prioniodontidae|Ozarkodina||Ozarkodina Branson & Mehl, 1933	4
Vicia villosa	Plantae|Magnoliophyta|Magnoliopsida|Fabales|Fabaceae|Vicia|Vicia villosa	4
Cataglyphis nodus	Animalia|Arthropoda|Insecta|Hymenoptera|Formicidae|Cataglyphis|Cataglyphis nodus	4
Euclidia glyphica	Animalia|Arthropoda|Insecta|Lepidoptera|Erebidae|Euclidia|Euclidia glyphica	4
Thalictrum aquilegiifolium	Plantae|Magnoliophyta|Magnoliopsida|Ranunculales|Ranunculaceae|Thalictrum|Thalictrum aquilegiifolium	4
Rinodina immersa (Körb.) Arnold, 1884	Fungi|Ascomycota|Lecanoromycetes|Teloschistales|Physciaceae|Rinodina|immersa|Rinodina immersa (Körb.) Arnold, 1884	4
Filipendula vulgaris	Plantae|Magnoliophyta|Magnoliopsida|Rosales|Rosaceae|Filipendula|Filipendula vulgaris	4
Rhinolophus hipposideros (Bechstein, 1800)	Animalia|Chordata|Mammalia|Chiroptera|Rhinolophidae|Rhinolophus|hipposideros|Rhinolophus hipposideros (Bechstein, 1800)	4
Zootoca vivipara (Von Jacquin, 1787)	Animalia|Chordata|Reptilia|Squamata|Lacertidae|Zootoca|vivipara|Zootoca vivipara (Von Jacquin, 1787)	4
Motacilla flava feldegg	Animalia|Chordata|Aves|Passeriformes|Motacillidae|Motacilla|Motacilla flava feldegg	4
Lecidoma demissum (Rutstr.) Gotth. Schneid. & Hertel	Fungi|Ascomycota|Lecanoromycetes|Lecanorales|Lecideaceae|Lecidoma|demissum|Lecidoma demissum (Rutstr.) Gotth. Schneid. & Hertel	4
Brachyptera graeca Berthélemy, 1971	Animalia|Arthropoda|Insecta|Plecoptera|Taeniopterygidae|Brachyptera|graeca|Brachyptera graeca Berthélemy, 1971	4
Thamnolia vermicularis subsp. subuliformis (Ehrh.) Schaer.	Fungi|Ascomycota|Lecanoromycetes|Pertusariales|Icmadophilaceae|Thamnolia|vermicularis|Thamnolia vermicularis subsp. subuliformis (Ehrh.) Schaer.	4
Pseudopanthera macularia	Animalia|Arthropoda|Insecta|Lepidoptera|Geometridae|Pseudopanthera|Pseudopanthera macularia	4
Araneus diadematus	Animalia|Arthropoda|Arachnida|Araneae|Araneidae|Araneus|Araneus diadematus	4
Linaria vulgaris	Plantae|Magnoliophyta|Magnoliopsida|Lamiales|Plantaginaceae|Linaria|Linaria vulgaris	4
Euphorbia cyparissias	Plantae|Magnoliophyta|Magnoliopsida|Malpighiales|Euphorbiaceae|Euphorbia|Euphorbia cyparissias	4
Aegonychon purpurea-coeruleum Holub.	Plantae|Tracheophyta|Magnoliopsida|Boraginales|Boraginaceae|Aegonychon|purpurea-coeruleum|Aegonychon purpurea-coeruleum Holub.	4
Sisyphus schaefferi	Animalia|Arthropoda|Insecta|Coleoptera|Scarabaeidae|Sisyphus|Sisyphus schaefferi	4
Peromyscopsylla bidentata (Kolenati, 1863)	Animalia|Arthropoda|Insecta|Siphonaptera|Leptopsyllidae|Peromyscopsylla|bidentata|Peromyscopsylla bidentata (Kolenati, 1863)	4
Salamandra salamandra	Animalia|Chordata|Amphibia|Caudata|Salamandridae|Salamandra|Salamandra salamandra	4
Cladonia gracilis (L.) Willd.	Fungi|Ascomycota|Lecanoromycetes|Lecanorales|Cladoniaceae|Cladonia|gracilis|Cladonia gracilis (L.) Willd.	4
Erigeron annuus	Plantae|Magnoliophyta|Magnoliopsida|Asterales|Asteraceae|Erigeron|Erigeron annuus	4
Eucyclops serrulatus (Fischer, 1851)	Animalia|Arthropoda|Maxillopoda|Cyclopoida|Cyclopidae|Eucyclops|serrulatus|Eucyclops serrulatus (Fischer, 1851)	4
Corvus monedula soemmerringii	Animalia|Chordata|Aves|Passeriformes|Corvidae|Coloeus|monedula|Corvus monedula soemmerringii	4
Anacamptis pyramidalis	Plantae|Magnoliophyta|Liliopsida|Asparagales|Orchidaceae|Anacamptis|Anacamptis pyramidalis	4
Xylographa parallela (Ach. Fr.) Fr.	Fungi|Ascomycota|Lecanoromycetes|Agyriales|Agyriaceae|Xylographa|parallela|Xylographa parallela (Ach. Fr.) Fr.	4
Sporastatia testudinea (Ach.) A. Massal.	Fungi|Ascomycota|Lecanoromycetes|Lecanorales|Catillariaceae|Sporastatia|testudinea|Sporastatia testudinea (Ach.) A. Massal.	4
Vinca major	Plantae|Magnoliophyta|Magnoliopsida|Gentianales|Apocynaceae|Vinca|Vinca major	4
Motacilla flava subsp. feldegg Michahelles, 1830	Animalia|Chordata|Aves|Passeriformes|Motacillidae|Motacilla|flava|Motacilla flava subsp. feldegg Michahelles, 1830	4
Melittis melissophyllum	Plantae|Magnoliophyta|Magnoliopsida|Lamiales|Lamiaceae|Melittis|Melittis melissophyllum	4
Papaver dubium	Plantae|Magnoliophyta|Magnoliopsida|Ranunculales|Papaveraceae|Papaver|Papaver dubium	4
Scilla bifolia	Plantae|Magnoliophyta|Liliopsida|Asparagales|Asparagaceae|Scilla|Scilla bifolia	4
Coturnix coturnix (Linnaeus, 1758)	Animalia|Chordata|Aves|Galliformes|Phasianidae|Coturnix|coturnix|Coturnix coturnix (Linnaeus, 1758)	4
Polygonatum odoratum (Mill.) Druce	Plantae|Tracheophyta|Liliopsida|Asparagales|Asparagaceae|Polygonatum|odoratum|Polygonatum odoratum (Mill.) Druce	4
Palaeopsylla steini Jordan, 1932	Animalia|Arthropoda|Insecta|Siphonaptera|Hystrichopsyllidae|Palaeopsylla|steini|Palaeopsylla steini Jordan, 1932	4
Emberiza cia Linnaeus, 1766	Animalia|Chordata|Aves|Passeriformes|Emberizidae|Emberiza|cia|Emberiza cia Linnaeus, 1766	4
Ranunculus millefoliatus Vahl	Plantae|Tracheophyta|Magnoliopsida|Ranunculales|Ranunculaceae|Ranunculus|millefoliatus|Ranunculus millefoliatus Vahl	4
Silene italica	Plantae|Magnoliophyta|Magnoliopsida|Caryophyllales|Caryophyllaceae|Silene|Silene italica	4
Anthyllis vulneraria	Plantae|Magnoliophyta|Magnoliopsida|Fabales|Fabaceae|Anthyllis|Anthyllis vulneraria	4
Melampyrum arvense	Plantae|Magnoliophyta|Magnoliopsida|Lamiales|Orobanchaceae|Melampyrum|Melampyrum arvense	4
Rupicapra rupicapra	Animalia|Chordata|Mammalia|Artiodactyla|Bovidae|Rupicapra|Rupicapra rupicapra	4
Megaspora verrucosa (Ach.) Hafellner & V. Wirth	Fungi|Ascomycota|Lecanoromycetes|Pertusariales|Megasporaceae|Megaspora|verrucosa|Megaspora verrucosa (Ach.) Hafellner & V. Wirth	4
Convallaria majalis	Plantae|Magnoliophyta|Liliopsida|Asparagales|Asparagaceae|Convallaria|Convallaria majalis	4
Ajuga chamaepitys	Plantae|Magnoliophyta|Magnoliopsida|Lamiales|Lamiaceae|Ajuga|Ajuga chamaepitys	4
Cruciata laevipes	Plantae|Magnoliophyta|Magnoliopsida|Gentianales|Rubiaceae|Cruciata|Cruciata laevipes	4
Medicago falcata	Plantae|Magnoliophyta|Magnoliopsida|Fabales|Fabaceae|Medicago|Medicago falcata	4
Dolycoris baccarum	Animalia|Arthropoda|Insecta|Hemiptera|Pentatomidae|Dolycoris|Dolycoris baccarum	4
Verrucaria H.A.Schrader, 1794	Fungi|Ascomycota|Eurotiomycetes|Verrucariales|Verrucariaceae|Verrucaria||Verrucaria H.A.Schrader, 1794	4
Perla marginata (Panzer, 1799)	Animalia|Arthropoda|Insecta|Plecoptera|Perlidae|Perla|marginata|Perla marginata (Panzer, 1799)	4
Smyrnium perfoliatum L.	Plantae|Tracheophyta|Magnoliopsida|Apiales|Apiaceae|Smyrnium|perfoliatum|Smyrnium perfoliatum L.	4
Peromyscopsylla bidentata (Kolenati, 1863)	Animalia|Arthropoda|Insecta|Siphonaptera|Ceratophyllidae|Peromyscopsylla|bidentata|Peromyscopsylla bidentata (Kolenati, 1863)	4
Phalacrocorax carbo (Linnaeus, 1758)	Animalia|Chordata|Aves|Suliformes|Phalacrocoracidae|Phalacrocorax|carbo|Phalacrocorax carbo (Linnaeus, 1758)	4
Fumana procumbens	Plantae|Magnoliophyta|Magnoliopsida|Malvales|Cistaceae|Fumana|Fumana procumbens	4
Pulmonaria mollis	Plantae|Magnoliophyta|Magnoliopsida|Boraginales|Boraginaceae|Pulmonaria|Pulmonaria mollis	4
Hirundo rustica	Animalia|Chordata|Aves|Passeriformes|Hirundinidae|Hirundo|Hirundo rustica	4
Lepidium campestre	Plantae|Magnoliophyta|Magnoliopsida|Brassicales|Brassicaceae|Lepidium|Lepidium campestre	4
Anacamptis morio	Plantae|Magnoliophyta|Liliopsida|Asparagales|Orchidaceae|Anacamptis|Anacamptis morio	4
Potentilla micrantha Ramond ex DC.	Plantae|Tracheophyta|Magnoliopsida|Rosales|Rosaceae|Potentilla|micrantha|Potentilla micrantha Ramond ex DC.	4
Lathyrus aphaca	Plantae|Magnoliophyta|Magnoliopsida|Fabales|Fabaceae|Lathyrus|Lathyrus aphaca	4
Smyrnium perfoliatum	Plantae|Magnoliophyta|Magnoliopsida|Apiales|Apiaceae|Smyrnium|Smyrnium perfoliatum	4
Zygaena loti	Animalia|Arthropoda|Insecta|Lepidoptera|Zygaenidae|Zygaena|Zygaena loti	4
Laburnum anagyroides	Plantae|Magnoliophyta|Magnoliopsida|Fabales|Fabaceae|Laburnum|Laburnum anagyroides	4
Globularia punctata	Plantae|Magnoliophyta|Magnoliopsida|Lamiales|Plantaginaceae|Globularia|Globularia punctata	4
Inula conyza	Plantae|Magnoliophyta|Magnoliopsida|Asterales|Asteraceae|Inula|Inula conyza	4
Physcia stellaris (L.) Nyl.	Fungi|Ascomycota|Lecanoromycetes|Teloschistales|Physciaceae|Physcia|stellaris|Physcia stellaris (L.) Nyl.	4
Acarospora cervina (Ach.) A. Massal.	Fungi|Ascomycota|Lecanoromycetes|Acarosporales|Acarosporaceae|Acarospora|cervina|Acarospora cervina (Ach.) A. Massal.	4
Poa bulbosa	Plantae|Magnoliophyta|Liliopsida|Poales|Poaceae|Poa|Poa bulbosa	4
Lathraea squamaria	Plantae|Magnoliophyta|Magnoliopsida|Lamiales|Orobanchaceae|Lathraea|Lathraea squamaria	4
Palaeopsylla steini Jordan, 1932	Animalia|Arthropoda|Insecta|Siphonaptera|Ctenophthalmidae|Palaeopsylla|steini|Palaeopsylla steini Jordan, 1932	4
Erythronium dens-canis	Plantae|Magnoliophyta|Liliopsida|Liliales|Liliaceae|Erythronium|Erythronium dens-canis	4
Emberiza calandra	Animalia|Chordata|Aves|Passeriformes|Emberizidae|Emberiza|Emberiza calandra	4
Buteo buteo	Animalia|Chordata|Aves|Accipitriformes|Accipitridae|Buteo|Buteo buteo	4
Acinos alpinus	Plantae|Magnoliophyta|Magnoliopsida|Lamiales|Lamiaceae|Acinos|Acinos alpinus	4
Corvus monedula	Animalia|Chordata|Aves|Passeriformes|Corvidae|Corvus|Corvus monedula	4
Erinaceus roumanicus	Animalia|Chordata|Mammalia|Eulipotyphla|Erinaceidae|Erinaceus|Erinaceus roumanicus	4
Ononis spinosa	Plantae|Magnoliophyta|Magnoliopsida|Fabales|Fabaceae|Ononis|Ononis spinosa	4
Convolvulus cantabrica	Plantae|Magnoliophyta|Magnoliopsida|Solanales|Convolvulaceae|Convolvulus|Convolvulus cantabrica	4
Tyta luctuosa	Animalia|Arthropoda|Insecta|Lepidoptera|Noctuidae|Tyta|Tyta luctuosa	4
Callophrys rubi	Animalia|Arthropoda|Insecta|Lepidoptera|Lycaenidae|Callophrys|Callophrys rubi	4
Trifolium incarnatum	Plantae|Magnoliophyta|Magnoliopsida|Fabales|Fabaceae|Trifolium|Trifolium incarnatum	4
Corvus monedula subsp. soemmerringii	Animalia|Chordata|Aves|Passeriformes|Corvidae|Corvus|monedula|Corvus monedula subsp. soemmerringii	4
Luzula campestris	Plantae|Magnoliophyta|Liliopsida|Poales|Juncaceae|Luzula|Luzula campestris	4
Anthus trivialis (Linnaeus, 1758)	Animalia|Chordata|Aves|Passeriformes|Motacillidae|Anthus|trivialis|Anthus trivialis (Linnaeus, 1758)	4
Sus scrofa Linnaeus, 1758	Animalia|Chordata|Mammalia|Artiodactyla|Suidae|Sus|scrofa|Sus scrofa Linnaeus, 1758	4
Periparus ater	Animalia|Chordata|Aves|Passeriformes|Paridae|Periparus|Periparus ater	4
Cornus mas	Plantae|Magnoliophyta|Magnoliopsida|Cornales|Cornaceae|Cornus|Cornus mas	4
Cephalanthera damasonium	Plantae|Magnoliophyta|Liliopsida|Asparagales|Orchidaceae|Cephalanthera|Cephalanthera damasonium	4
Secale cereale L.	Plantae|Tracheophyta|Liliopsida|Poales|Poaceae|Secale|cereale|Secale cereale L.	4
Cyclamen hederifolium	Plantae|Magnoliophyta|Magnoliopsida|Ericales|Myrsinaceae|Cyclamen|Cyclamen hederifolium	4
Muellerella pygmaea (Körb.) D.Hawksw.	Fungi|Ascomycota|Eurotiomycetes|Verrucariales|Verrucariaceae|Muellerella|pygmaea|Muellerella pygmaea (Körb.) D.Hawksw.	4
Gallinula chloropus	Animalia|Chordata|Aves|Gruiformes|Rallidae|Gallinula|Gallinula chloropus	4
Crupina crupinastrum	Plantae|Magnoliophyta|Magnoliopsida|Asterales|Asteraceae|Crupina|Crupina crupinastrum	4
Iris sibirica	Plantae|Magnoliophyta|Liliopsida|Asparagales|Iridaceae|Iris|Iris sibirica	4
Pyrrhosoma nymphula	Animalia|Arthropoda|Insecta|Odonata|Coenagrionidae|Pyrrhosoma|Pyrrhosoma nymphula	4
Triticum monococcum L.	Plantae|Tracheophyta|Liliopsida|Poales|Poaceae|Triticum|monococcum|Triticum monococcum L.	4
Mantis religiosa	Animalia|Arthropoda|Insecta|Mantodea|Mantidae|Mantis|Mantis religiosa	4
Buellia aethalea (Ach.) Th. Fr.	Fungi|Ascomycota|Lecanoromycetes|Teloschistales|Physciaceae|Buellia|aethalea|Buellia aethalea (Ach.) Th. Fr.	4
Parnassia palustris	Plantae|Magnoliophyta|Magnoliopsida|Celastrales|Celastraceae|Parnassia|Parnassia palustris	4
Cornu aspersum	Animalia|Mollusca|Gastropoda|Stylommatophora|Helicidae|Cornu|Cornu aspersum	4
Triticum monococcum L.	Plantae|Magnoliophyta|Liliopsida|Poales|Poaceae|Triticum|monococcum|Triticum monococcum L.	4
Linum campanulatum	Plantae|Magnoliophyta|Magnoliopsida|Malpighiales|Linaceae|Linum|Linum campanulatum	4
Linum tenuifolium	Plantae|Magnoliophyta|Magnoliopsida|Malpighiales|Linaceae|Linum|Linum tenuifolium	4
Cladonia macroceras (Delise) Ahti	Fungi|Ascomycota|Lecanoromycetes|Lecanorales|Cladoniaceae|Cladonia|macroceras|Cladonia macroceras (Delise) Ahti	4
Trichia favoginea (Batsch) Pers., 1794	Protozoa|Mycetozoa|Myxomycetes|Trichiales|Trichiaceae|Trichia|favoginea|Trichia favoginea (Batsch) Pers., 1794	4
Bellis perennis	Plantae|Magnoliophyta|Magnoliopsida|Asterales|Asteraceae|Bellis|Bellis perennis	4
Aegonychon purpurocaeruleum (L.) Holub	Plantae|Magnoliophyta|Magnoliopsida|Boraginales|Boraginaceae|Aegonychon|purpurocaeruleum|Aegonychon purpurocaeruleum (L.) Holub	4
Collema fuscovirens (With.) J. R. Laundon	Fungi|Ascomycota|Lecanoromycetes|Peltigerales|Collemataceae|Collema|fuscovirens|Collema fuscovirens (With.) J. R. Laundon	4
Coenagrion puella	Animalia|Arthropoda|Insecta|Odonata|Coenagrionidae|Coenagrion|Coenagrion puella	4
Tanacetum corymbosum	Plantae|Magnoliophyta|Magnoliopsida|Asterales|Asteraceae|Tanacetum|Tanacetum corymbosum	4
Lecidella carpathica Körb.	Fungi|Ascomycota|Lecanoromycetes|Lecanorales|Lecanoraceae|Lecidella|carpathica|Lecidella carpathica Körb.	4
Anchusa officinalis	Plantae|Magnoliophyta|Magnoliopsida|Boraginales|Boraginaceae|Anchusa|Anchusa officinalis	4
Potentilla micrantha	Plantae|Magnoliophyta|Magnoliopsida|Rosales|Rosaceae|Potentilla|Potentilla micrantha	4
Foeniculum vulgare	Plantae|Magnoliophyta|Magnoliopsida|Apiales|Apiaceae|Foeniculum|Foeniculum vulgare	4
Siona lineata	Animalia|Arthropoda|Insecta|Lepidoptera|Geometridae|Siona|Siona lineata	4
Placidium A.Massal.	Fungi|Ascomycota|Eurotiomycetes|Verrucariales|Verrucariaceae|Placidium||Placidium A.Massal.	4
Chondrina Reichenbach, 1828	Animalia|Mollusca|Gastropoda|Stylommatophora|Chondrinidae|Chondrina||Chondrina Reichenbach, 1828	4
Origanum vulgare	Plantae|Magnoliophyta|Magnoliopsida|Lamiales|Lamiaceae|Origanum|Origanum vulgare	4
Reseda lutea	Plantae|Magnoliophyta|Magnoliopsida|Brassicales|Resedaceae|Reseda|Reseda lutea	4
Hippurites Lamarck, 1801	Animalia|Mollusca|Bivalvia||Hippuritidae|Hippurites||Hippurites Lamarck, 1801	4
Zebrina detrita	Animalia|Mollusca|Gastropoda|Stylommatophora|Enidae|Zebrina|Zebrina detrita	4
Bombina variegata	Animalia|Chordata|Amphibia|Anura|Bombinatoridae|Bombina|Bombina variegata	4
Trifolium montanum	Plantae|Magnoliophyta|Magnoliopsida|Fabales|Fabaceae|Trifolium|Trifolium montanum	4
Toninia sedifolia (Scop.) Timdal	Fungi|Ascomycota|Lecanoromycetes|Lecanorales|Ramalinaceae|Toninia|sedifolia|Toninia sedifolia (Scop.) Timdal	4
Fraxinus ornus	Plantae|Magnoliophyta|Magnoliopsida|Lamiales|Oleaceae|Fraxinus|Fraxinus ornus	4
Juniperus communis	Plantae|Pinophyta|Pinopsida|Pinales|Cupressaceae|Juniperus|Juniperus communis	4
Dorycnium pentaphyllum herbaceum	Plantae|Magnoliophyta|Magnoliopsida|Fabales|Fabaceae|Dorycnium|Dorycnium pentaphyllum herbaceum	4
Daphne laureola	Plantae|Magnoliophyta|Magnoliopsida|Malvales|Thymelaeaceae|Daphne|Daphne laureola	4
Mycobilimbia carneoalbida (Müll. Arg.) S. Ekman & Printzen	Fungi|Ascomycota|Lecanoromycetes|Lecanorales|Lecideaceae|Mycobilimbia|carneoalbida|Mycobilimbia carneoalbida (Müll. Arg.) S. Ekman & Printzen	3
Callophrys rubi (Linnaeus, 1758)	Animalia|Arthropoda|Insecta|Lepidoptera|Lycaenidae|Callophrys|rubi|Callophrys rubi (Linnaeus, 1758)	3
Cruciata laevipes Opiz	Plantae|Magnoliophyta|Magnoliopsida|Gentianales|Rubiaceae|Cruciata|laevipes|Cruciata laevipes Opiz	3
Podiceps cristatus (Linnaeus, 1758)	Animalia|Chordata|Aves|Podicipediformes|Podicipedidae|Podiceps|cristatus|Podiceps cristatus (Linnaeus, 1758)	3
Strix aluco Linnaeus, 1758	Animalia|Chordata|Aves|Strigiformes|Strigidae|Strix|aluco|Strix aluco Linnaeus, 1758	3
Praelapeirousia	Animalia|Mollusca|Bivalvia||Radiolitidae|Praelapeirousia||Praelapeirousia	3
Diplotomma hedinii (H. Magn.) P. Clerc & Cl. Roux	Fungi|Ascomycota|Lecanoromycetes|Teloschistales|Physciaceae|Diplotomma|hedinii|Diplotomma hedinii (H. Magn.) P. Clerc & Cl. Roux	3
Neotinea tridentata (Scop.) R.M.Bateman, Pridgeon & M.W.Chase	Plantae|Tracheophyta|Liliopsida|Asparagales|Orchidaceae|Platanthera|tridentata|Neotinea tridentata (Scop.) R.M.Bateman, Pridgeon & M.W.Chase	3
Leptopsylla sciurobia (Wagner, 1934)	Animalia|Arthropoda|Insecta|Siphonaptera|Leptopsyllidae|Leptopsylla|sciurobia|Leptopsylla sciurobia (Wagner, 1934)	3
Placynthium nigrum (Huds.) Gray	Fungi|Ascomycota|Lecanoromycetes|Peltigerales|Placynthiaceae|Placynthium|nigrum|Placynthium nigrum (Huds.) Gray	3
Usnea lapponica Vain.	Fungi|Ascomycota|Lecanoromycetes|Lecanorales|Parmeliaceae|Usnea|lapponica|Usnea lapponica Vain.	3
Usnea hirta (L.) Weber ex F. H. Wigg.	Fungi|Ascomycota|Lecanoromycetes|Lecanorales|Parmeliaceae|Usnea|hirta|Usnea hirta (L.) Weber ex F. H. Wigg.	3
Lobothallia radiosa (Hoffm.) Hafellner	Fungi|Ascomycota|Lecanoromycetes|Pertusariales|Megasporaceae|Aspicilia|radiosa|Lobothallia radiosa (Hoffm.) Hafellner	3
Symphytum tuberosum L.	Plantae|Magnoliophyta|Magnoliopsida|Boraginales|Boraginaceae|Symphytum|tuberosum|Symphytum tuberosum L.	3
Viola kitaibeliana Schultes	Plantae|Tracheophyta|Magnoliopsida|Malpighiales|Violaceae|Viola|kitaibeliana|Viola kitaibeliana Schultes	3
Lepraria caesioalba (B. de Lesd.) J. R. Laundon	Fungi|Ascomycota|Lecanoromycetes|Lecanorales|Stereocaulaceae|Lepraria|caesioalba|Lepraria caesioalba (B. de Lesd.) J. R. Laundon	3
Gryllus campestris Linnaeus, C.N., 1758	Animalia|Arthropoda|Insecta|Orthoptera|Gryllidae|Gryllus|campestris|Gryllus campestris Linnaeus, C.N., 1758	3
Ardea alba Linnaeus, 1758	Animalia|Chordata|Aves|Pelecaniformes|Ardeidae|Ardea|alba|Ardea alba Linnaeus, 1758	3
Palaeopsylla oxygonia Peus, 1965	Animalia|Arthropoda|Insecta|Siphonaptera|Ctenophthalmidae|Palaeopsylla|oxygonia|Palaeopsylla oxygonia Peus, 1965	3
Regulus regulus (Linnaeus, 1758)	Animalia|Chordata|Aves|Passeriformes|Regulidae|Regulus|regulus|Regulus regulus (Linnaeus, 1758)	3
Anacamptis morio (L.) R.M.Bateman, Pridgeon & M.W.Chase	Plantae|Tracheophyta|Liliopsida|Asparagales|Orchidaceae|Anacamptis|morio|Anacamptis morio (L.) R.M.Bateman, Pridgeon & M.W.Chase	3
Mycobilimbia berengeriana (A. Massal.) Hafellner & V. Wirth	Fungi|Ascomycota|Lecanoromycetes|Lecanorales|Lecideaceae|Mycobilimbia|berengeriana|Mycobilimbia berengeriana (A. Massal.) Hafellner & V. Wirth	3
Phaeophyscia sciastra (Ach.) Moberg	Fungi|Ascomycota|Lecanoromycetes|Teloschistales|Physciaceae|Phaeophyscia|sciastra|Phaeophyscia sciastra (Ach.) Moberg	3
Siona lineata Scopoli, 1763	Animalia|Arthropoda|Insecta|Lepidoptera|Geometridae|Siona|lineata|Siona lineata Scopoli, 1763	3
Leptopsylla segnis (Schonherr, 1811)	Animalia|Arthropoda|Insecta|Siphonaptera|Ceratophyllidae|Leptopsylla|segnis|Leptopsylla segnis (Schonherr, 1811)	3
Usnea filipendula Stirt.	Fungi|Ascomycota|Lecanoromycetes|Lecanorales|Parmeliaceae|Usnea|filipendula|Usnea filipendula Stirt.	3
Vinca major L.	Plantae|Tracheophyta|Magnoliopsida|Gentianales|Apocynaceae|Vinca|major|Vinca major L.	3
Poa bulbosa L.	Plantae|Tracheophyta|Liliopsida|Poales|Poaceae|Poa|bulbosa|Poa bulbosa L.	3
Platismatia glauca (L.) W. L. Culb. & C. F. Culb.	Fungi|Ascomycota|Lecanoromycetes|Lecanorales|Parmeliaceae|Platismatia|glauca|Platismatia glauca (L.) W. L. Culb. & C. F. Culb.	3
Circus aeruginosus (Linnaeus, 1758)	Animalia|Chordata|Aves|Accipitriformes|Accipitridae|Circus|aeruginosus|Circus aeruginosus (Linnaeus, 1758)	3
Fringilla montifringilla Linnaeus, 1758	Animalia|Chordata|Aves|Passeriformes|Fringillidae|Fringilla|montifringilla|Fringilla montifringilla Linnaeus, 1758	3
Adonis vernalis L.	Plantae|Tracheophyta|Magnoliopsida|Ranunculales|Ranunculaceae|Adonis|vernalis|Adonis vernalis L.	3
Rhizocarpon reductum Th. Fr.	Fungi|Ascomycota|Lecanoromycetes|Lecanorales|Rhizocarpaceae|Rhizocarpon|reductum|Rhizocarpon reductum Th. Fr.	3
Alectoris graeca (Meisner, 1804)	Animalia|Chordata|Aves|Galliformes|Phasianidae|Alectoris|graeca|Alectoris graeca (Meisner, 1804)	3
Lecidella euphorea (Flörke) Hertel	Fungi|Ascomycota|Lecanoromycetes|Lecanorales|Lecanoraceae|Lecidella|euphorea|Lecidella euphorea (Flörke) Hertel	3
Parus ater Linnaeus, 1758	Animalia|Chordata|Aves|Passeriformes|Paridae|Periparus|ater|Parus ater Linnaeus, 1758	3
Prunella modularis (Linnaeus, 1758)	Animalia|Chordata|Aves|Passeriformes|Prunellidae|Prunella|modularis|Prunella modularis (Linnaeus, 1758)	3
Androsace hedraeantha Griseb.	Plantae|Tracheophyta|Magnoliopsida|Ericales|Primulaceae|Androsace|hedraeantha|Androsace hedraeantha Griseb.	3
Umbilicaria deusta (L.) Baumg.	Fungi|Ascomycota|Lecanoromycetes|Umbilicariales|Umbilicariaceae|Umbilicaria|deusta|Umbilicaria deusta (L.) Baumg.	3
Convallaria majalis L.	Plantae|Tracheophyta|Liliopsida|Asparagales|Asparagaceae|Convallaria|majalis|Convallaria majalis L.	3
Lamium amplexicaule L.	Plantae|Tracheophyta|Magnoliopsida|Lamiales|Lamiaceae|Lamium|amplexicaule|Lamium amplexicaule L.	3
Alcedo atthis (Linnaeus, 1758)	Animalia|Chordata|Aves|Coraciiformes|Alcedinidae|Alcedo|atthis|Alcedo atthis (Linnaeus, 1758)	3
Euphorbia cyparissias L.	Plantae|Tracheophyta|Magnoliopsida|Malpighiales|Euphorbiaceae|Euphorbia|cyparissias|Euphorbia cyparissias L.	3
Toninia candida (Weber) Th. Fr.	Fungi|Ascomycota|Lecanoromycetes|Lecanorales|Ramalinaceae|Toninia|candida|Toninia candida (Weber) Th. Fr.	3
Hordeum vulgare L.	Plantae|Magnoliophyta|Liliopsida|Poales|Poaceae|Hordeum|vulgare|Hordeum vulgare L.	3
Lecanora anopta Nyl.	Fungi|Ascomycota|Lecanoromycetes|Lecanorales|Lecanoraceae|Lecanora|anopta|Lecanora anopta Nyl.	3
Umbilicaria nylanderiana (Zahlbr.) H. Magn.	Fungi|Ascomycota|Lecanoromycetes|Umbilicariales|Umbilicariaceae|Umbilicaria|nylanderiana|Umbilicaria nylanderiana (Zahlbr.) H. Magn.	3
Protopannaria pezizoides (Weber) P. M. Jørg. & S. Ekman	Fungi|Ascomycota|Lecanoromycetes|Peltigerales|Pannariaceae|Protopannaria|pezizoides|Protopannaria pezizoides (Weber) P. M. Jørg. & S. Ekman	3
Lecidea atrobrunnea (Ramond ex Lam. & DC.) Schaer.	Fungi|Ascomycota|Lecanoromycetes|Lecanorales|Lecideaceae|Lecidea|atrobrunnea|Lecidea atrobrunnea (Ramond ex Lam. & DC.) Schaer.	3
Potentilla micrantha Ramond ex DC.	Plantae|Magnoliophyta|Magnoliopsida|Rosales|Rosaceae|Potentilla|micrantha|Potentilla micrantha Ramond ex DC.	3
Xerocampylaea zelebori (L. Pfeiffer, 1853)	Animalia|Mollusca|Gastropoda|Stylommatophora|Hygromiidae|Xerocampylaea|zelebori|Xerocampylaea zelebori (L. Pfeiffer, 1853)	3
Protoparmeliopsis muralis var. dubyi (Müll. Arg.) Hafellner & Türk	Fungi|Ascomycota|Lecanoromycetes|Lecanorales|Lecanoraceae|Protoparmeliopsis|muralis|Protoparmeliopsis muralis var. dubyi (Müll. Arg.) Hafellner & Türk	3
Sarcogyne regularis Körb.	Fungi|Ascomycota|Lecanoromycetes|Acarosporales|Acarosporaceae|Sarcogyne|regularis|Sarcogyne regularis Körb.	3
Brodoa intestiniformis (Vill.) Goward	Fungi|Ascomycota|Lecanoromycetes|Lecanorales|Parmeliaceae|Brodoa|intestiniformis|Brodoa intestiniformis (Vill.) Goward	3
Parmelinopsis horrescens (Taylor) Elix & Hale	Fungi|Ascomycota|Lecanoromycetes|Lecanorales|Parmeliaceae|Parmelinopsis|horrescens|Parmelinopsis horrescens (Taylor) Elix & Hale	3
Symphytum tuberosum L.	Plantae|Tracheophyta|Magnoliopsida|Boraginales|Boraginaceae|Symphytum|tuberosum|Symphytum tuberosum L.	3
Rhizocarpon badioatrum (Flörke ex Spreng.) Th. Fr.	Fungi|Ascomycota|Lecanoromycetes|Lecanorales|Rhizocarpaceae|Rhizocarpon|badioatrum|Rhizocarpon badioatrum (Flörke ex Spreng.) Th. Fr.	3
Rimularia insularis (Nyl.) Rambold & Hertel	Fungi|Ascomycota|Lecanoromycetes|Baeomycetales|Trapeliaceae|Rimularia|insularis|Rimularia insularis (Nyl.) Rambold & Hertel	3
Cruciata laevipes Opiz	Plantae|Tracheophyta|Magnoliopsida|Gentianales|Rubiaceae|Cruciata|laevipes|Cruciata laevipes Opiz	3
Aspicilia calcarea (L.) Körb.	Fungi|Ascomycota|Lecanoromycetes|Pertusariales|Megasporaceae|Aspicilia|calcarea|Aspicilia calcarea (L.) Körb.	3
Securigera varia	Plantae|Magnoliophyta|Magnoliopsida|Fabales|Fabaceae|Securigera|Securigera varia	3
Usnea Dill. ex Adans.	Fungi|Ascomycota|Lecanoromycetes|Lecanorales|Parmeliaceae|Usnea||Usnea Dill. ex Adans.	3
Medicago arabica	Plantae|Magnoliophyta|Magnoliopsida|Fabales|Fabaceae|Medicago|Medicago arabica	3
Certhia familiaris Linnaeus, 1758	Animalia|Chordata|Aves|Passeriformes|Certhiidae|Certhia|familiaris|Certhia familiaris Linnaeus, 1758	3
Dermatocarpon miniatum (L.) W. Mann	Fungi|Ascomycota|Eurotiomycetes|Verrucariales|Verrucariaceae|Dermatocarpon|miniatum|Dermatocarpon miniatum (L.) W. Mann	3
Xerocampylaea Kobelt, 1871	Animalia|Mollusca|Gastropoda|Stylommatophora|Hygromiidae|Xerocampylaea||Xerocampylaea Kobelt, 1871	3
Lecanora perpruinosa Fröberg	Fungi|Ascomycota|Lecanoromycetes|Lecanorales|Lecanoraceae|Lecanora|perpruinosa|Lecanora perpruinosa Fröberg	3
Viola kitaibeliana auct. non Roem. & Schult.	Plantae|Magnoliophyta|Magnoliopsida|Malpighiales|Violaceae|Viola|kitaibeliana|Viola kitaibeliana auct. non Roem. & Schult.	3
Motacilla flava subsp. feldegg	Animalia|Chordata|Aves|Passeriformes|Motacillidae|Motacilla|flava|Motacilla flava subsp. feldegg	3
Bilimbia microcarpa (Th. Fr.) Th. Fr.	Fungi|Ascomycota|Lecanoromycetes|||Bilimbia|microcarpa|Bilimbia microcarpa (Th. Fr.) Th. Fr.	3
Placynthiella oligotropha (J. R. Laundon) Coppins & P. James	Fungi|Ascomycota|Lecanoromycetes|Baeomycetales|Trapeliaceae|Placynthiella|oligotropha|Placynthiella oligotropha (J. R. Laundon) Coppins & P. James	3
Corvus monedula Linnaeus, 1758	Animalia|Chordata|Aves|Passeriformes|Corvidae|Corvus|monedula|Corvus monedula Linnaeus, 1758	3
Rhizocarpon furax Poelt & V. Wirth	Fungi|Ascomycota|Lecanoromycetes|Lecanorales|Rhizocarpaceae|Rhizocarpon|furax|Rhizocarpon furax Poelt & V. Wirth	3
Mycobilimbia hypnorum (Lib.) Kalb & Hafellner	Fungi|Ascomycota|Lecanoromycetes|Lecanorales|Lecideaceae|Mycobilimbia|hypnorum|Mycobilimbia hypnorum (Lib.) Kalb & Hafellner	3
Sporastatia polyspora (Nyl.) Grummann	Fungi|Ascomycota|Lecanoromycetes||Sporastatiaceae|Sporastatia|polyspora|Sporastatia polyspora (Nyl.) Grummann	3
Coccothraustes coccothraustes (Linnaeus, 1758)	Animalia|Chordata|Aves|Passeriformes|Fringillidae|Coccothraustes|coccothraustes|Coccothraustes coccothraustes (Linnaeus, 1758)	3
Alauda arvensis Linnaeus, 1758	Animalia|Chordata|Aves|Passeriformes|Alaudidae|Alauda|arvensis|Alauda arvensis Linnaeus, 1758	3
Cyclamen hederifolium Aiton	Plantae|Magnoliophyta|Magnoliopsida|Ericales|Primulaceae|Cyclamen|hederifolium|Cyclamen hederifolium Aiton	3
Aegonychon purpurocaeruleum	Plantae|Magnoliophyta|Magnoliopsida|Boraginales|Boraginaceae|Aegonychon|Aegonychon purpurocaeruleum	3
Vulpicida pinastri (Scop.) J.-E. Mattsson & M. J. Lai	Fungi|Ascomycota|Lecanoromycetes|Lecanorales|Parmeliaceae|Vulpicida|pinastri|Vulpicida pinastri (Scop.) J.-E. Mattsson & M. J. Lai	3
Cytisus hirsutus L.	Plantae|Magnoliophyta|Magnoliopsida|Fabales|Fabaceae|Cytisus|hirsutus|Cytisus hirsutus L.	3
Carthamus lanatus L.	Plantae|Tracheophyta|Magnoliopsida|Asterales|Asteraceae|Carthamus|lanatus|Carthamus lanatus L.	3
Mycobilimbia hypnorum (Lib.) Kalb & Hafellner	Fungi|Ascomycota|Lecanoromycetes|||Bryobilimbia|hypnorum|Mycobilimbia hypnorum (Lib.) Kalb & Hafellner	3
Rhagadostoma lichenicola (De Not.) Keissl., 1930	Fungi|Ascomycota|Sordariomycetes|Coronophorales|Nitschkiaceae|Rhagadostoma|lichenicola|Rhagadostoma lichenicola (De Not.) Keissl., 1930	3
Lecidea fuscoatra (L.) Ach.	Fungi|Ascomycota|Lecanoromycetes|Lecanorales|Lecideaceae|Lecidea|fuscoatra|Lecidea fuscoatra (L.) Ach.	3
Ophioparma ventosa (L.) Norman	Fungi|Ascomycota|Lecanoromycetes|Umbilicariales|Ophioparmaceae|Ophioparma|ventosa|Ophioparma ventosa (L.) Norman	3
Anagallis arvensis	Plantae|Magnoliophyta|Magnoliopsida|Ericales|Myrsinaceae|Anagallis|Anagallis arvensis	3
Polygonia c-album Linnaeus, 1758	Animalia|Arthropoda|Insecta|Lepidoptera|Nymphalidae|Polygonia|c-album|Polygonia c-album Linnaeus, 1758	3
Leptopsylla segnis (Schonherr, 1811)	Animalia|Arthropoda|Insecta|Siphonaptera|Leptopsyllidae|Leptopsylla|segnis|Leptopsylla segnis (Schonherr, 1811)	3
Cyanistes caeruleus (Linnaeus, 1758)	Animalia|Chordata|Aves|Passeriformes|Paridae|Cyanistes|caeruleus|Cyanistes caeruleus (Linnaeus, 1758)	3
Leptopsylla sciurobia (Wagner, 1934)	Animalia|Arthropoda|Insecta|Siphonaptera|Ceratophyllidae|Leptopsylla|sciurobia|Leptopsylla sciurobia (Wagner, 1934)	3
Gyrophthorus Hafellner & Sancho	Fungi|Ascomycota||||Gyrophthorus||Gyrophthorus Hafellner & Sancho	3
Gallinula chloropus (Linnaeus, 1758)	Animalia|Chordata|Aves|Gruiformes|Rallidae|Gallinula|chloropus|Gallinula chloropus (Linnaeus, 1758)	3
Verrucaria dufourii DC.	Fungi|Ascomycota|Eurotiomycetes|Verrucariales|Verrucariaceae|Parabagliettoa|dufourii|Verrucaria dufourii DC.	3
Leptogium (Ach.) Gray	Fungi|Ascomycota|Lecanoromycetes|Peltigerales|Collemataceae|Leptogium||Leptogium (Ach.) Gray	3
Lepraria humida Slav.-Bay. & Orange	Fungi|Ascomycota|Lecanoromycetes|Lecanorales|Stereocaulaceae|Lepraria|humida|Lepraria humida Slav.-Bay. & Orange	3
Palaeopsylla oxygonia Peus, 1965	Animalia|Arthropoda|Insecta|Siphonaptera|Hystrichopsyllidae|Palaeopsylla|oxygonia|Palaeopsylla oxygonia Peus, 1965	3
Physconia venusta (Ach.) Poelt	Fungi|Ascomycota|Lecanoromycetes|Teloschistales|Physciaceae|Physconia|venusta|Physconia venusta (Ach.) Poelt	3
Lecanora rupicola (L.) Zahlbr.	Fungi|Ascomycota|Lecanoromycetes|Lecanorales|Lecanoraceae|Lecanora|rupicola|Lecanora rupicola (L.) Zahlbr.	3
Lamium amplexicaule L.	Plantae|Magnoliophyta|Magnoliopsida|Lamiales|Lamiaceae|Lamium|amplexicaule|Lamium amplexicaule L.	3
Parus palustris Linnaeus, 1758	Animalia|Chordata|Aves|Passeriformes|Paridae|Poecile|palustris|Parus palustris Linnaeus, 1758	3
Gryllus campestris Linnaeus, 1758	Animalia|Arthropoda|Insecta|Orthoptera|Gryllidae|Gryllus|campestris|Gryllus campestris Linnaeus, 1758	3
Nucifraga caryocatactes (Linnaeus, 1758)	Animalia|Chordata|Aves|Passeriformes|Corvidae|Nucifraga|caryocatactes|Nucifraga caryocatactes (Linnaeus, 1758)	3
Bonasa bonasia	Animalia|Chordata|Aves|Galliformes|Phasianidae|Bonasa|Bonasa bonasia	3
Ramalina capitata (Ach.) Nyl.	Fungi|Ascomycota|Lecanoromycetes|Lecanorales|Ramalinaceae|Ramalina|capitata|Ramalina capitata (Ach.) Nyl.	3
Caloplaca variabilis (Pers.) Müll. Arg.	Fungi|Ascomycota|Lecanoromycetes|Teloschistales|Teloschistaceae|Caloplaca|variabilis|Caloplaca variabilis (Pers.) Müll. Arg.	3
Accipiter gentilis (Linnaeus, 1758)	Animalia|Chordata|Aves|Accipitriformes|Accipitridae|Accipiter|gentilis|Accipiter gentilis (Linnaeus, 1758)	3
Anacamptis morio (L.) R.M.Bateman, Pridgeon & M.W.Chase	Plantae|Magnoliophyta|Liliopsida|Asparagales|Orchidaceae|Anacamptis|morio|Anacamptis morio (L.) R.M.Bateman, Pridgeon & M.W.Chase	3
Adonis vernalis L.	Plantae|Magnoliophyta|Magnoliopsida|Ranunculales|Ranunculaceae|Adonis|vernalis|Adonis vernalis L.	3
Geranium sanguineum L.	Plantae|Tracheophyta|Magnoliopsida|Geraniales|Geraniaceae|Geranium|sanguineum|Geranium sanguineum L.	3
Callophrys rubi Linnaeus, 1758	Animalia|Arthropoda|Insecta|Lepidoptera|Lycaenidae|Callophrys|rubi|Callophrys rubi Linnaeus, 1758	3
Usnea intermedia (A. Massal.) Jatta	Fungi|Ascomycota|Lecanoromycetes|Lecanorales|Parmeliaceae|Usnea|intermedia|Usnea intermedia (A. Massal.) Jatta	3
Vinca major L.	Plantae|Magnoliophyta|Magnoliopsida|Gentianales|Apocynaceae|Vinca|major|Vinca major L.	3
Upupa epops Linnaeus, 1758	Animalia|Chordata|Aves|Bucerotiformes|Upupidae|Upupa|epops|Upupa epops Linnaeus, 1758	3
Praelapeirousia Wiontzek, 1934	Animalia|Mollusca|Bivalvia||Radiolitidae|Praelapeirousia||Praelapeirousia Wiontzek, 1934	3
Gyalecta foveolaris (Ach.) Schaer.	Fungi|Ascomycota|Lecanoromycetes|Ostropales|Gyalectaceae|Gyalecta|foveolaris|Gyalecta foveolaris (Ach.) Schaer.	3
Convallaria majalis L.	Plantae|Magnoliophyta|Liliopsida|Asparagales|Asparagaceae|Convallaria|majalis|Convallaria majalis L.	3
Physcia caesia (Hoffm.) Fürnr.	Fungi|Ascomycota|Lecanoromycetes|Teloschistales|Physciaceae|Physcia|caesia|Physcia caesia (Hoffm.) Fürnr.	3
Tichodroma muraria (Linnaeus, 1766)	Animalia|Chordata|Aves|Passeriformes|Tichodromidae|Tichodroma|muraria|Tichodroma muraria (Linnaeus, 1766)	3
Allium sphaerocephalon	Plantae|Magnoliophyta|Liliopsida|Asparagales|Alliaceae|Allium|Allium sphaerocephalon	3
Rhizocarpon umbilicatum (Ramond) Flagey	Fungi|Ascomycota|Lecanoromycetes|Lecanorales|Rhizocarpaceae|Rhizocarpon|umbilicatum|Rhizocarpon umbilicatum (Ramond) Flagey	3
Androsace hedreantha Griseb.	Plantae|Magnoliophyta|Magnoliopsida|Ericales|Primulaceae|Androsace|hedreantha|Androsace hedreantha Griseb.	3
Xanthoria polycarpa (Hoffm.) Th. Fr. ex Rieber	Fungi|Ascomycota|Lecanoromycetes|Teloschistales|Teloschistaceae|Xanthoria|polycarpa|Xanthoria polycarpa (Hoffm.) Th. Fr. ex Rieber	3
Pseudevernia furfuracea var. ceratea (Ach.) D. Hawksw.	Fungi|Ascomycota|Lecanoromycetes|Lecanorales|Parmeliaceae|Pseudevernia|furfuracea|Pseudevernia furfuracea var. ceratea (Ach.) D. Hawksw.	3
Cyclamen hederifolium Aiton	Plantae|Tracheophyta|Magnoliopsida|Ericales|Primulaceae|Cyclamen|hederifolium|Cyclamen hederifolium Aiton	3
Spinus spinus (Linnaeus, 1758)	Animalia|Chordata|Aves|Passeriformes|Fringillidae|Spinus|spinus|Spinus spinus (Linnaeus, 1758)	3
Rhadinopsylla integella Jordan & Rothschild, 1921	Animalia|Arthropoda|Insecta|Siphonaptera|Hystrichopsyllidae|Rhadinopsylla|integella|Rhadinopsylla integella Jordan & Rothschild, 1921	3
Placynthiella uliginosa (Schrad.) Coppins & P. James	Fungi|Ascomycota|Lecanoromycetes|Baeomycetales|Trapeliaceae|Placynthiella|uliginosa|Placynthiella uliginosa (Schrad.) Coppins & P. James	3
Diplotomma venustum Körb.	Fungi|Ascomycota|Lecanoromycetes|Teloschistales|Physciaceae|Diplotomma|venustum|Diplotomma venustum Körb.	3
Rhadinopsylla integella Jordan & Rothschild, 1921	Animalia|Arthropoda|Insecta|Siphonaptera|Ctenophthalmidae|Rhadinopsylla|integella|Rhadinopsylla integella Jordan & Rothschild, 1921	3
Eremophila alpestris (Linnaeus, 1758)	Animalia|Chordata|Aves|Passeriformes|Alaudidae|Eremophila|alpestris|Eremophila alpestris (Linnaeus, 1758)	2
Sherardia arvensis L.	Plantae|Magnoliophyta|Magnoliopsida|Gentianales|Rubiaceae|Sherardia|arvensis|Sherardia arvensis L.	2
Lecanora symmicta (Ach.) Ach.	Fungi|Ascomycota|Lecanoromycetes|Lecanorales|Lecanoraceae|Lecanora|symmicta|Lecanora symmicta (Ach.) Ach.	2
Thelidium auruntii (A. Massal.) Kremp.	Fungi|Ascomycota|Eurotiomycetes|Verrucariales|Verrucariaceae|Thelidium|auruntii|Thelidium auruntii (A. Massal.) Kremp.	2
Erythronium dens-canis L.	Plantae|Magnoliophyta|Liliopsida|Liliales|Liliaceae|Erythronium|dens-canis|Erythronium dens-canis L.	2
Toninia taurica (Szatala) Oksner	Fungi|Ascomycota|Lecanoromycetes|Lecanorales|Ramalinaceae|Toninia|taurica|Toninia taurica (Szatala) Oksner	2
Poa bulbosa L.	Plantae|Magnoliophyta|Liliopsida|Poales|Poaceae|Poa|bulbosa|Poa bulbosa L.	2
Agalenatea redii (Scopoli, 1763)	Animalia|Arthropoda|Arachnida|Araneae|Araneidae|Agalenatea|redii|Agalenatea redii (Scopoli, 1763)	2
Buellia uberior Anzi	Fungi|Ascomycota|Lecanoromycetes|Teloschistales|Physciaceae|Buellia|uberior|Buellia uberior Anzi	2
Delichon urbica (Linnaeus, 1758)	Animalia|Chordata|Aves|Passeriformes|Hirundinidae|Delichon|urbica|Delichon urbica (Linnaeus, 1758)	2
Melanohalea exasperatula (Nyl.) O. Blanco, A. Crespo, Divakar, Essl., D. Hawksw. & Lumbsch	Fungi|Ascomycota|Lecanoromycetes|Lecanorales|Parmeliaceae|Melanohalea|exasperatula|Melanohalea exasperatula (Nyl.) O. Blanco, A. Crespo, Divakar, Essl., D. Hawksw. & Lumbsch	2
Columba oenas Linnaeus, 1758	Animalia|Chordata|Aves|Columbiformes|Columbidae|Columba|oenas|Columba oenas Linnaeus, 1758	2
Crataegus monogyna Jacq.	Plantae|Tracheophyta|Magnoliopsida|Rosales|Rosaceae|Crataegus|monogyna|Crataegus monogyna Jacq.	2
Euphydryas aurinia (Rottemburg, 1775)	Animalia|Arthropoda|Insecta|Lepidoptera|Nymphalidae|Euphydryas|aurinia|Euphydryas aurinia (Rottemburg, 1775)	2
Anchusa officinalis L.	Plantae|Magnoliophyta|Magnoliopsida|Boraginales|Boraginaceae|Anchusa|officinalis|Anchusa officinalis L.	2
Collema cristatum (L.) Weber ex F.H.Wigg.	Fungi|Ascomycota|Lecanoromycetes|Peltigerales|Collemataceae|Collema|cristatum|Collema cristatum (L.) Weber ex F.H.Wigg.	2
Carduelis chloris (Linnaeus, 1758)	Animalia|Chordata|Aves|Passeriformes|Fringillidae|Carduelis|chloris|Carduelis chloris (Linnaeus, 1758)	2
Toninia diffracta (A. Massal.) Zahlbr.	Fungi|Ascomycota|Lecanoromycetes|Lecanorales|Ramalinaceae|Toninia|diffracta|Toninia diffracta (A. Massal.) Zahlbr.	2
Grimmia hartmanii W. P. Schimper, 1860	Plantae|Bryophyta|Bryopsida|Grimmiales|Grimmiaceae|Grimmia|hartmanii|Grimmia hartmanii W. P. Schimper, 1860	2
Regulus ignicapilla (Temminck, 1820)	Animalia|Chordata|Aves|Passeriformes|Regulidae|Regulus|ignicapilla|Regulus ignicapilla (Temminck, 1820)	2
Opatrum sabulosum (Linnaeus, 1761)	Animalia|Arthropoda|Insecta|Coleoptera|Tenebrionidae|Opatrum|sabulosum|Opatrum sabulosum (Linnaeus, 1761)	2
Ajuga chamaepitys (L.) Schreb.	Plantae|Tracheophyta|Magnoliopsida|Lamiales|Lamiaceae|Ajuga|chamaepitys|Ajuga chamaepitys (L.) Schreb.	2
Erucastrum nasturtiifolium (Poir.) O.E. Schulz	Plantae|Tracheophyta|Magnoliopsida|Brassicales|Brassicaceae|Erucastrum|nasturtiifolium|Erucastrum nasturtiifolium (Poir.) O.E. Schulz	2
Dina R. Blanchard, 1892	Animalia|Annelida|Clitellata|Arhynchobdellida|Erpobdellidae|Dina||Dina R. Blanchard, 1892	2
Bacidia herbarum (Stizenb.) Arnold	Fungi|Ascomycota|Lecanoromycetes|Lecanorales|Ramalinaceae|Bacidia|herbarum|Bacidia herbarum (Stizenb.) Arnold	2
Laburnum anagyroides Medik.	Plantae|Tracheophyta|Magnoliopsida|Fabales|Fabaceae|Laburnum|anagyroides|Laburnum anagyroides Medik.	2
Martes martes (Linnaeus, 1758)	Animalia|Chordata|Mammalia|Carnivora|Mustelidae|Martes|martes|Martes martes (Linnaeus, 1758)	2
Cerinthe minor L.	Plantae|Magnoliophyta|Magnoliopsida|Boraginales|Boraginaceae|Cerinthe|minor|Cerinthe minor L.	2
Lepraria alpina var. alpina	Fungi|Ascomycota|Lecanoromycetes|Lecanorales|Stereocaulaceae|Lepraria|alpina|Lepraria alpina var. alpina	2
Toninia taurica (Szatala) Oxner	Fungi|Ascomycota|Lecanoromycetes|Lecanorales|Ramalinaceae|Toninia|taurica|Toninia taurica (Szatala) Oxner	2
Catapyrenium daedaleum (Kremp.) Stein	Fungi|Ascomycota|Eurotiomycetes|Verrucariales|Verrucariaceae|Catapyrenium|daedaleum|Catapyrenium daedaleum (Kremp.) Stein	2
Palaeopsylla soricis (Dale, 1878)	Animalia|Arthropoda|Insecta|Siphonaptera|Ctenophthalmidae|Palaeopsylla|soricis|Palaeopsylla soricis (Dale, 1878)	2
Pseudopolyconites Milovanovic, 1935	Animalia|Mollusca|Bivalvia||Radiolitidae|Pseudopolyconites||Pseudopolyconites Milovanovic, 1935	2
Daonella Mojsisovics, 1874	Animalia|Mollusca|Bivalvia|Pterioida|Myalinidae|Daonella||Daonella Mojsisovics, 1874	2
Lanius senator Linnaeus, 1758	Animalia|Chordata|Aves|Passeriformes|Laniidae|Lanius|senator|Lanius senator Linnaeus, 1758	2
Diplotomma venustum (Körb.) Körb.	Fungi|Ascomycota|Lecanoromycetes|Teloschistales|Physciaceae|Diplotomma|venustum|Diplotomma venustum (Körb.) Körb.	2
Erucastrum nasturtiifolium (Poir.) O.E. Schulz	Plantae|Magnoliophyta|Magnoliopsida|Brassicales|Brassicaceae|Erucastrum|nasturtiifolium|Erucastrum nasturtiifolium (Poir.) O.E. Schulz	2
Lecanora dispersa (Pers.) Röhl., 1813	Fungi|Ascomycota|Lecanoromycetes|Lecanorales|Lecanoraceae|Lecanora|dispersa|Lecanora dispersa (Pers.) Röhl., 1813	2
Isoperla oxylepis balcanica Raušer, 1962	Animalia|Arthropoda|Insecta|Plecoptera|Perlodidae|Isoperla|oxylepis|Isoperla oxylepis balcanica Raušer, 1962	2
Polystichum lonchitis (L.) Roth	Plantae|Tracheophyta|Polypodiopsida|Polypodiales|Dryopteridaceae|Polystichum|lonchitis|Polystichum lonchitis (L.) Roth	2
Mantis religiosa (Linné, 1758)	Animalia|Arthropoda|Insecta|Mantodea|Mantidae|Mantis|religiosa|Mantis religiosa (Linné, 1758)	2
Lepus europaeus Pallas, 1778	Animalia|Chordata|Mammalia|Lagomorpha|Leporidae|Lepus|europaeus|Lepus europaeus Pallas, 1778	2
Anthyllis vulneraria L.	Plantae|Tracheophyta|Magnoliopsida|Fabales|Fabaceae|Anthyllis|vulneraria|Anthyllis vulneraria L.	2
Candona Baird, 1846	Animalia|Arthropoda|Ostracoda|Podocopida|Candonidae|Candona||Candona Baird, 1846	2
Pseudopolyconites Milovanovic, 1937	Animalia|Mollusca|Bivalvia||Radiolitidae|Pseudopolyconites||Pseudopolyconites Milovanovic, 1937	2
Porpidia macrocarpa (DC.) Hertel & A. J. Schwab	Fungi|Ascomycota|Lecanoromycetes|Lecanorales|Lecideaceae|Porpidia|macrocarpa|Porpidia macrocarpa (DC.) Hertel & A. J. Schwab	2
Isoperla oxylepis (Despax, 1936)	Animalia|Arthropoda|Insecta|Plecoptera|Perlodidae|Isoperla|oxylepis|Isoperla oxylepis (Despax, 1936)	2
Cerinthe minor L.	Plantae|Tracheophyta|Magnoliopsida|Boraginales|Boraginaceae|Cerinthe|minor|Cerinthe minor L.	2
Linum capitatum Kit. ex Schult.	Plantae|Tracheophyta|Magnoliopsida|Malpighiales|Linaceae|Linum|capitatum|Linum capitatum Kit. ex Schult.	2
Cladonia fimbriata (L.) Fr.	Fungi|Ascomycota|Lecanoromycetes|Lecanorales|Cladoniaceae|Cladonia|fimbriata|Cladonia fimbriata (L.) Fr.	2
Leuctra rosinae Kempny, 1900	Animalia|Arthropoda|Insecta|Plecoptera|Leuctridae|Leuctra|rosinae|Leuctra rosinae Kempny, 1900	2
Lecanora agardhiana subsp. agardhiana	Fungi|Ascomycota|Lecanoromycetes|Lecanorales|Lecanoraceae|Lecanora|agardhiana|Lecanora agardhiana subsp. agardhiana	2
Ajuga laxmannii (Murray) Benth.	Plantae|Tracheophyta|Magnoliopsida|Lamiales|Lamiaceae|Ajuga|laxmannii|Ajuga laxmannii (Murray) Benth.	2
Phacographa glaucomaria (Nyl.) Hafellner	Fungi|Ascomycota|Arthoniomycetes|Arthoniales|Roccellaceae|Phacographa|glaucomaria|Phacographa glaucomaria (Nyl.) Hafellner	2
Leuctra rauscheri Aubert, 1957	Animalia|Arthropoda|Insecta|Plecoptera|Leuctridae|Leuctra|rauscheri|Leuctra rauscheri Aubert, 1957	2
Melittis melissophyllum Thunb.	Plantae|Magnoliophyta|Magnoliopsida|Lamiales|Lamiaceae|Melittis|melissophyllum|Melittis melissophyllum Thunb.	2
Parus cristatus Linnaeus, 1758	Animalia|Chordata|Aves|Passeriformes|Paridae|Lophophanes|cristatus|Parus cristatus Linnaeus, 1758	2
Jasione laevis subsp. orbiculata (Griseb. ex Velen.) Tutin	Plantae|Tracheophyta|Magnoliopsida|Asterales|Campanulaceae|Jasione|laevis|Jasione laevis subsp. orbiculata (Griseb. ex Velen.) Tutin	2
Arthonia excentrica Th.Fr.	Fungi|Ascomycota|Arthoniomycetes|Arthoniales|Arthoniaceae|Arthonia|excentrica|Arthonia excentrica Th.Fr.	2
Carbonea atronivea (Arnold) Hertel	Fungi|Ascomycota|Lecanoromycetes|Lecanorales|Lecanoraceae|Carbonea|atronivea|Carbonea atronivea (Arnold) Hertel	2
Asperula taurina L.	Plantae|Tracheophyta|Magnoliopsida|Gentianales|Rubiaceae|Asperula|taurina|Asperula taurina L.	2
Catapyrenium Flotow, 1850	Fungi|Ascomycota|Eurotiomycetes|Verrucariales|Verrucariaceae|Catapyrenium||Catapyrenium Flotow, 1850	2
Leptogium imbricatum P. M. Jørg.	Fungi|Ascomycota|Lecanoromycetes|Peltigerales|Collemataceae|Leptogium|imbricatum|Leptogium imbricatum P. M. Jørg.	2
Parasitus Latreille	Animalia|Arthropoda|Arachnida|Mesostigmata|Parasitidae|Parasitus||Parasitus Latreille	2
Baeomyces rufus (Huds.) Rebent.	Fungi|Ascomycota|Lecanoromycetes|Baeomycetales|Baeomycetaceae|Baeomyces|rufus|Baeomyces rufus (Huds.) Rebent.	2
Lecanora mughicola Nyl.	Fungi|Ascomycota|Lecanoromycetes|Lecanorales|Lecanoraceae|Lecanora|mughicola|Lecanora mughicola Nyl.	2
Glossiphonia Johnson, 1816	Animalia|Annelida|Clitellata|Rhynchobdellida|Glossiphoniidae|Glossiphonia||Glossiphonia Johnson, 1816	2
Turdus torquatus Linnaeus, 1758	Animalia|Chordata|Aves|Passeriformes|Turdidae|Turdus|torquatus|Turdus torquatus Linnaeus, 1758	2
Caloplaca chalybaea (Fr.) Müll. Arg.	Fungi|Ascomycota|Lecanoromycetes|Teloschistales|Teloschistaceae|Caloplaca|chalybaea|Caloplaca chalybaea (Fr.) Müll. Arg.	2
Trifolium montanum L.	Plantae|Tracheophyta|Magnoliopsida|Fabales|Fabaceae|Trifolium|montanum|Trifolium montanum L.	2
Zerynthia polyxena (Denis & Schiffermüller, 1775)	Animalia|Arthropoda|Insecta|Lepidoptera|Papilionidae|Zerynthia|polyxena|Zerynthia polyxena (Denis & Schiffermüller, 1775)	2
Cantareus Risso, 1826	Animalia|Mollusca|Gastropoda|Stylommatophora|Helicidae|Cantareus||Cantareus Risso, 1826	2
Ajuga chamaepitys (L.) Schreb.	Plantae|Magnoliophyta|Magnoliopsida|Lamiales|Lamiaceae|Ajuga|chamaepitys|Ajuga chamaepitys (L.) Schreb.	2
Verbascum phoeniceum L.	Plantae|Tracheophyta|Magnoliopsida|Lamiales|Scrophulariaceae|Verbascum|phoeniceum|Verbascum phoeniceum L.	2
Protonemura auberti Illies, 1954	Animalia|Arthropoda|Insecta|Plecoptera|Nemouridae|Protonemura|auberti|Protonemura auberti Illies, 1954	2
Arthonia varians (Davies) Nyl.	Fungi|Ascomycota|Arthoniomycetes|Arthoniales|Arthoniaceae|Arthonia|varians|Arthonia varians (Davies) Nyl.	2
Erythronium dens-canis L.	Plantae|Tracheophyta|Liliopsida|Liliales|Liliaceae|Erythronium|dens-canis|Erythronium dens-canis L.	2
Cephalanthera damasonium (Mill.) Druce	Plantae|Magnoliophyta|Liliopsida|Asparagales|Orchidaceae|Cephalanthera|damasonium|Cephalanthera damasonium (Mill.) Druce	2
Mastodon Cuvier, 1817	Animalia|Chordata|Mammalia|Proboscidea|Gomphotheriidae|Mastodon||Mastodon Cuvier, 1817	2
Kuehnia Milovanovic, 1956	Animalia|Mollusca|Bivalvia||Radiolitidae|Kuehnia||Kuehnia Milovanovic, 1956	2
Nycticorax nycticorax (Linnaeus, 1758)	Animalia|Chordata|Aves|Pelecaniformes|Ardeidae|Nycticorax|nycticorax|Nycticorax nycticorax (Linnaeus, 1758)	2
Lonicera caprifolium L.	Plantae|Magnoliophyta|Magnoliopsida|Dipsacales|Caprifoliaceae|Lonicera|caprifolium|Lonicera caprifolium L.	2
Pyrgus malvae Linnaeus, 1758	Animalia|Arthropoda|Insecta|Lepidoptera|Hesperiidae|Pyrgus|malvae|Pyrgus malvae Linnaeus, 1758	2
Toninia cinereovirens (Schaer.) A. Massal.	Fungi|Ascomycota|Lecanoromycetes|Lecanorales|Ramalinaceae|Toninia|cinereovirens|Toninia cinereovirens (Schaer.) A. Massal.	2
Eupithecia insigniata Hübner, 1792	Animalia|Arthropoda|Insecta|Lepidoptera|Geometridae|Eupithecia|insigniata|Eupithecia insigniata Hübner, 1792	2
Melampyrum arvense L.	Plantae|Tracheophyta|Magnoliopsida|Lamiales|Orobanchaceae|Melampyrum|arvense|Melampyrum arvense L.	2
Zebrina Held, 1837	Animalia|Mollusca|Gastropoda|Pulmonata|Enidae|Zebrina||Zebrina Held, 1837	2
Martes foina (Erxleben, 1777)	Animalia|Chordata|Mammalia|Carnivora|Mustelidae|Martes|foina|Martes foina (Erxleben, 1777)	2
Aquila chrysaetos (Linnaeus, 1758)	Animalia|Chordata|Aves|Accipitriformes|Accipitridae|Aquila|chrysaetos|Aquila chrysaetos (Linnaeus, 1758)	2
Lacerta viridis	Animalia|Chordata|Reptilia|Squamata|Lacertidae|Lacerta|Lacerta viridis	2
Araschnia levana Linnaeus, 1758	Animalia|Arthropoda|Insecta|Lepidoptera|Nymphalidae|Araschnia|levana|Araschnia levana Linnaeus, 1758	2
Papaver dubium L.	Plantae|Magnoliophyta|Magnoliopsida|Ranunculales|Papaveraceae|Papaver|dubium|Papaver dubium L.	2
Ctenophthalmus ruris Jordan, 1929	Animalia|Arthropoda|Insecta|Siphonaptera|Hystrichopsyllidae|Ctenophthalmus|ruris|Ctenophthalmus ruris Jordan, 1929	2
Apatognathus Branson & Mehl, 1933	Animalia|Chordata||||Apatognathus||Apatognathus Branson & Mehl, 1933	2
Petasites albus Wirzen	Plantae|Tracheophyta|Magnoliopsida|Asterales|Asteraceae|Petasites|albus|Petasites albus Wirzen	2
Cladonia uncialis subsp. biuncialis (Hoffm.) M. Choisy	Fungi|Ascomycota|Lecanoromycetes|Lecanorales|Cladoniaceae|Cladonia|uncialis|Cladonia uncialis subsp. biuncialis (Hoffm.) M. Choisy	2
Tragopogon pratensis	Plantae|Tracheophyta|Magnoliopsida|Asterales|Asteraceae|Tragopogon|pratensis|Tragopogon pratensis	2
Dendrocopos minor (Linnaeus, 1758)	Animalia|Chordata|Aves|Piciformes|Picidae|Dendrocopos|minor|Dendrocopos minor (Linnaeus, 1758)	2
Salamandra salamandra (Linnaeus, 1758)	Animalia|Chordata|Amphibia|Caudata|Salamandridae|Salamandra|salamandra|Salamandra salamandra (Linnaeus, 1758)	2
Alchemilla crinita Buser	Plantae|Tracheophyta|Magnoliopsida|Rosales|Rosaceae|Alchemilla|crinita|Alchemilla crinita Buser	2
Loxia curvirostra Linnaeus, 1758	Animalia|Chordata|Aves|Passeriformes|Fringillidae|Loxia|curvirostra|Loxia curvirostra Linnaeus, 1758	2
Linum perenne L.	Plantae|Magnoliophyta|Magnoliopsida|Malpighiales|Linaceae|Linum|perenne|Linum perenne L.	2
Polysarcus denticauda (Charpentier, 1825)	Animalia|Arthropoda|Insecta|Orthoptera|Tettigoniidae|Polysarcus|denticauda|Polysarcus denticauda (Charpentier, 1825)	2
Arthonia Ach.	Fungi|Ascomycota|Arthoniomycetes|Arthoniales|Arthoniaceae|Arthonia||Arthonia Ach.	2
Hypena rostralis Linnaeus, 1758	Animalia|Arthropoda|Insecta|Lepidoptera|Noctuidae|Hypena|rostralis|Hypena rostralis Linnaeus, 1758	2
Carduelis chloris (Linnaeus, 1758)	Animalia|Chordata|Aves|Passeriformes|Fringillidae|Chloris|chloris|Carduelis chloris (Linnaeus, 1758)	2
Trapeliopsis wallrothii (Flörke ex Spreng.) Hertel & Gotth.Schneid.	Fungi|Ascomycota|Lecanoromycetes|Agyriales|Agyriaceae|Trapeliopsis|wallrothii|Trapeliopsis wallrothii (Flörke ex Spreng.) Hertel & Gotth.Schneid.	2
Peltigera praetextata (Flörke ex Sommerf.) Vain., 1899	Fungi|Ascomycota|Lecanoromycetes|Peltigerales|Peltigeraceae|Peltigera|praetextata|Peltigera praetextata (Flörke ex Sommerf.) Vain., 1899	2
Saxifraga rotundifolia L.	Plantae|Tracheophyta|Magnoliopsida|Saxifragales|Saxifragaceae|Saxifraga|rotundifolia|Saxifraga rotundifolia L.	2
Helianthemum Mill.	Plantae|Tracheophyta|Magnoliopsida|Malvales|Cistaceae|Helianthemum||Helianthemum Mill.	2
Caloplaca percrocata (Arnold) J. Steiner	Fungi|Ascomycota|Lecanoromycetes|Teloschistales|Teloschistaceae|Caloplaca|percrocata|Caloplaca percrocata (Arnold) J. Steiner	2
Lathyrus aphaca L.	Plantae|Tracheophyta|Magnoliopsida|Fabales|Fabaceae|Lathyrus|aphaca|Lathyrus aphaca L.	2
Psorinia conglomerata (Ach.) Gotth. Schneid.	Fungi|Ascomycota|Lecanoromycetes|Lecanorales|Stereocaulaceae|Stereocaulon|conglomerata|Psorinia conglomerata (Ach.) Gotth. Schneid.	2
Cecidonia xenophana (Körb.) Triebel & Rambold	Fungi|Ascomycota|Lecanoromycetes|Lecanorales|Lecideaceae|Cecidonia|xenophana|Cecidonia xenophana (Körb.) Triebel & Rambold	2
Podarcis muralis (Laurenti, 1768)	Animalia|Chordata|Reptilia|Squamata|Lacertidae|Podarcis|muralis|Podarcis muralis (Laurenti, 1768)	2
Roundya	Animalia|Chordata||||Roundya||Roundya	2
Lonicera caprifolium L.	Plantae|Tracheophyta|Magnoliopsida|Dipsacales|Caprifoliaceae|Lonicera|caprifolium|Lonicera caprifolium L.	2
Chelidonium majus L.	Plantae|Tracheophyta|Magnoliopsida|Ranunculales|Papaveraceae|Chelidonium|majus|Chelidonium majus L.	2
Caloplaca macrocarpa (Anzi) Zahlbr.	Fungi|Ascomycota|Lecanoromycetes|Teloschistales|Teloschistaceae|Caloplaca|macrocarpa|Caloplaca macrocarpa (Anzi) Zahlbr.	2
Physcia albinea (Ach.) Nyl.	Fungi|Ascomycota|Lecanoromycetes|Teloschistales|Physciaceae|Physcia|albinea|Physcia albinea (Ach.) Nyl.	2
Rhizocarpon alpicola (Wahlenb.) Rabenh., 1861	Fungi|Ascomycota|Lecanoromycetes|Lecanorales|Rhizocarpaceae|Rhizocarpon|alpicola|Rhizocarpon alpicola (Wahlenb.) Rabenh., 1861	2
Neotinea tridentata (Scop.) R.M.Bateman, Pridgeon & M.W.Chase	Plantae|Magnoliophyta|Liliopsida|Asparagales|Orchidaceae|Neotinea|tridentata|Neotinea tridentata (Scop.) R.M.Bateman, Pridgeon & M.W.Chase	2
Phasianus colchicus Linnaeus, 1758	Animalia|Chordata|Aves|Galliformes|Phasianidae|Phasianus|colchicus|Phasianus colchicus Linnaeus, 1758	2
Ctenophthalmus agyrtes serbicus Wagner, 1930	Animalia|Arthropoda|Insecta|Siphonaptera|Hystrichopsyllidae|Ctenophthalmus|agyrtes|Ctenophthalmus agyrtes serbicus Wagner, 1930	2
Uropoda Latreille	Animalia|Arthropoda|Arachnida|Mesostigmata|Uropodidae|Uropoda||Uropoda Latreille	2
Lepidium campestre (L.) W.T. Aiton	Plantae|Tracheophyta|Magnoliopsida|Brassicales|Brassicaceae|Lepidium|campestre|Lepidium campestre (L.) W.T. Aiton	2
Physcia aipolia (Ehrh. ex Humb.) Fürnr.	Fungi|Ascomycota|Lecanoromycetes|Teloschistales|Physciaceae|Physcia|aipolia|Physcia aipolia (Ehrh. ex Humb.) Fürnr.	2
Dichrostigma flavipes (Stein, 1863)	Animalia|Arthropoda|Insecta|Raphidioptera|Raphidiidae|Dichrostigma|flavipes|Dichrostigma flavipes (Stein, 1863)	2
Monticola saxatilis (Linnaeus, 1766)	Animalia|Chordata|Aves|Passeriformes|Muscicapidae|Monticola|saxatilis|Monticola saxatilis (Linnaeus, 1766)	2
Placidium A. Massal.	Fungi|Ascomycota|Eurotiomycetes|Verrucariales|Verrucariaceae|Placidium||Placidium A. Massal.	2
Sporastatia polyspora (Nyl.) Grummann	Fungi|Ascomycota|Lecanoromycetes|Lecanorales|Catillariaceae|Sporastatia|polyspora|Sporastatia polyspora (Nyl.) Grummann	2
Caloplaca saxicola (Hoffm.) Nordin	Fungi|Ascomycota|Lecanoromycetes|Teloschistales|Teloschistaceae|Caloplaca|saxicola|Caloplaca saxicola (Hoffm.) Nordin	2
Squamarina cartilaginea (With.) P. James	Fungi|Ascomycota|Lecanoromycetes|Lecanorales|Stereocaulaceae|Squamarina|cartilaginea|Squamarina cartilaginea (With.) P. James	2
Porpidia tuberculosa (Sm.) Hertel & Knoph	Fungi|Ascomycota|Lecanoromycetes|Lecanorales|Lecideaceae|Porpidia|tuberculosa|Porpidia tuberculosa (Sm.) Hertel & Knoph	2
Melittis melissophyllum L.	Plantae|Tracheophyta|Magnoliopsida|Lamiales|Lamiaceae|Melittis|melissophyllum|Melittis melissophyllum L.	2
Aspicilia Massal.	Fungi|Ascomycota|Lecanoromycetes|Pertusariales|Megasporaceae|Aspicilia||Aspicilia Massal.	2
Cinclus cinclus (Linnaeus, 1758)	Animalia|Chordata|Aves|Passeriformes|Cinclidae|Cinclus|cinclus|Cinclus cinclus (Linnaeus, 1758)	2
Nymphalis polychloros Linnaeus, 1758	Animalia|Arthropoda|Insecta|Lepidoptera|Nymphalidae|Nymphalis|polychloros|Nymphalis polychloros Linnaeus, 1758	2
Dendrocopos syriacus (Hemprich & Ehrenberg, 1833)	Animalia|Chordata|Aves|Piciformes|Picidae|Dendrocopos|syriacus|Dendrocopos syriacus (Hemprich & Ehrenberg, 1833)	2
Trichia varia (Pers. ex J.F. Gmel.) Pers., 1794	Protozoa|Mycetozoa|Myxomycetes|Trichiales|Trichiaceae|Trichia|varia|Trichia varia (Pers. ex J.F. Gmel.) Pers., 1794	2
Tropinota squalida (Scopoli, 1763)	Animalia|Arthropoda|Insecta|Coleoptera|Cetoniidae|Tropinota|squalida|Tropinota squalida (Scopoli, 1763)	2
Grimmia ramondii Margadant, 1972	Plantae|Bryophyta|Bryopsida|Grimmiales|Grimmiaceae|Grimmia|ramondii|Grimmia ramondii Margadant, 1972	2
Ctenophthalmus agyrtes graecus Jordan, 1926	Animalia|Arthropoda|Insecta|Siphonaptera|Hystrichopsyllidae|Ctenophthalmus|agyrtes|Ctenophthalmus agyrtes graecus Jordan, 1926	2
Dermatocarpon intestiniforme (Körb.) Hasse	Fungi|Ascomycota|Eurotiomycetes|Verrucariales|Verrucariaceae|Dermatocarpon|intestiniforme|Dermatocarpon intestiniforme (Körb.) Hasse	2
Collema polycarpon Hoffm.	Fungi|Ascomycota|Lecanoromycetes|Peltigerales|Collemataceae|Collema|polycarpon|Collema polycarpon Hoffm.	2
Muscari commutatum Guss.	Plantae|Tracheophyta|Liliopsida|Asparagales|Asparagaceae|Muscari|commutatum|Muscari commutatum Guss.	2
Porpidia crustulata (Ach.) Hertel & Knoph	Fungi|Ascomycota|Lecanoromycetes|Lecanorales|Lecideaceae|Porpidia|crustulata|Porpidia crustulata (Ach.) Hertel & Knoph	2
Cladonia macilenta Hoffm.	Fungi|Ascomycota|Lecanoromycetes|Lecanorales|Cladoniaceae|Cladonia|macilenta|Cladonia macilenta Hoffm.	2
Dinocras megacephala (Klapálek, 1907)	Animalia|Arthropoda|Insecta|Plecoptera|Perlidae|Dinocras|megacephala|Dinocras megacephala (Klapálek, 1907)	2
Cirsium vulgare (Savi) Petr.	Plantae|Tracheophyta|Magnoliopsida|Asterales|Asteraceae|Cirsium|vulgare|Cirsium vulgare (Savi) Petr.	2
Melitaea cinxia	Animalia|Arthropoda|Insecta|Lepidoptera|Nymphalidae|Melitaea|Melitaea cinxia	2
Phalacrocorax pygmaeus (Pallas, 1773)	Animalia|Chordata|Aves|Suliformes|Phalacrocoracidae|Phalacrocorax|pygmaeus|Phalacrocorax pygmaeus (Pallas, 1773)	2
Hypogymnia farinacea Zopf	Fungi|Ascomycota|Lecanoromycetes|Lecanorales|Parmeliaceae|Hypogymnia|farinacea|Hypogymnia farinacea Zopf	2
Capreolus capreolus (Linnaeus, 1758)	Animalia|Chordata|Mammalia|Artiodactyla|Cervidae|Capreolus|capreolus|Capreolus capreolus (Linnaeus, 1758)	2
Falco peregrinus Tunstall, 1771	Animalia|Chordata|Aves|Falconiformes|Falconidae|Falco|peregrinus|Falco peregrinus Tunstall, 1771	2
Globularia punctata Lapeyr.	Plantae|Tracheophyta|Magnoliopsida|Lamiales|Plantaginaceae|Globularia|punctata|Globularia punctata Lapeyr.	2
Anemone nemorosa L.	Plantae|Magnoliophyta|Magnoliopsida|Ranunculales|Ranunculaceae|Anemone|nemorosa|Anemone nemorosa L.	2
Globularia punctata Lapeyr.	Plantae|Magnoliophyta|Magnoliopsida|Lamiales|Plantaginaceae|Globularia|punctata|Globularia punctata Lapeyr.	2
Polycoccum sporastatiae (Anzi) Arnold	Fungi|Ascomycota|Dothideomycetes|Pleosporales|Dacampiaceae|Polycoccum|sporastatiae|Polycoccum sporastatiae (Anzi) Arnold	2
Anemone ranunculoides L.	Plantae|Tracheophyta|Magnoliopsida|Ranunculales|Ranunculaceae|Anemone|ranunculoides|Anemone ranunculoides L.	2
Campylaea Beck, 1837	Animalia|Mollusca|Gastropoda|Stylommatophora|Helicidae|Campylaea||Campylaea Beck, 1837	2
Poecilimon affinis subsp. affinis	Animalia|Arthropoda|Insecta|Orthoptera|Tettigoniidae|Poecilimon|affinis|Poecilimon affinis subsp. affinis	2
Stereocaulon saxatile H. Magn.	Fungi|Ascomycota|Lecanoromycetes|Lecanorales|Stereocaulaceae|Stereocaulon|saxatile|Stereocaulon saxatile H. Magn.	2
Sylvia curruca (Linnaeus, 1758)	Animalia|Chordata|Aves|Passeriformes|Sylviidae|Sylvia|curruca|Sylvia curruca (Linnaeus, 1758)	2
Nemoura cinerea (Retzius, 1783)	Animalia|Arthropoda|Insecta|Plecoptera|Nemouridae|Nemoura|cinerea|Nemoura cinerea (Retzius, 1783)	2
Verbascum phoeniceum L.	Plantae|Magnoliophyta|Magnoliopsida|Lamiales|Scrophulariaceae|Verbascum|phoeniceum|Verbascum phoeniceum L.	2
Linum capitatum Griseb. ex Planch.	Plantae|Magnoliophyta|Magnoliopsida|Malpighiales|Linaceae|Linum|capitatum|Linum capitatum Griseb. ex Planch.	2
Cladonia chlorophaea (Flörke ex Sommerf.) Spreng.	Fungi|Ascomycota|Lecanoromycetes|Lecanorales|Cladoniaceae|Cladonia|chlorophaea|Cladonia chlorophaea (Flörke ex Sommerf.) Spreng.	2
Iris reichenbachii Heuff.	Plantae|Magnoliophyta|Liliopsida|Asparagales|Iridaceae|Iris|reichenbachii|Iris reichenbachii Heuff.	2
Lecidea atrobrunnea (Ramond) Schaer.	Fungi|Ascomycota|Lecanoromycetes|Lecanorales|Lecideaceae|Lecidea|atrobrunnea|Lecidea atrobrunnea (Ramond) Schaer.	2
Labrax elongatus (Geoffroy Saint-Hilaire, 1817)	Animalia|Chordata|Actinopterygii|Perciformes|Moronidae|Dicentrarchus|elongatus|Labrax elongatus (Geoffroy Saint-Hilaire, 1817)	2
Linum perenne L.	Plantae|Tracheophyta|Magnoliopsida|Malpighiales|Linaceae|Linum|perenne|Linum perenne L.	2
Athelia arachnoidea (Berk.) Jülich, 1972	Fungi|Basidiomycota|Agaricomycetes|Atheliales|Atheliaceae|Athelia|arachnoidea|Athelia arachnoidea (Berk.) Jülich, 1972	2
Argynnis adippe	Animalia|Arthropoda|Insecta|Lepidoptera|Nymphalidae|Argynnis|Argynnis adippe	2
Cichorium intybus	Plantae|Tracheophyta|Magnoliopsida|Asterales|Asteraceae|Cichorium|intybus|Cichorium intybus	2
Anchusa officinalis L.	Plantae|Tracheophyta|Magnoliopsida|Boraginales|Boraginaceae|Anchusa|officinalis|Anchusa officinalis L.	2
Asperula taurina L.	Plantae|Magnoliophyta|Magnoliopsida|Gentianales|Rubiaceae|Asperula|taurina|Asperula taurina L.	2
Polyommatus icarus	Animalia|Arthropoda|Insecta|Lepidoptera|Lycaenidae|Polyommatus|Polyommatus icarus	2
Acarospora glaucocarpa (Ach.) Körb.	Fungi|Ascomycota|Lecanoromycetes|Acarosporales|Acarosporaceae|Acarospora|glaucocarpa|Acarospora glaucocarpa (Ach.) Körb.	2
Crataegus monogyna Jacq.	Plantae|Magnoliophyta|Magnoliopsida|Rosales|Rosaceae|Crataegus|monogyna|Crataegus monogyna Jacq.	2
Lecidea silacea (Hoffm.) Ach., 1803	Fungi|Ascomycota|Lecanoromycetes|Lecanorales|Lecideaceae|Lecidea|silacea|Lecidea silacea (Hoffm.) Ach., 1803	2
Catapyrenium Flot.	Fungi|Ascomycota|Eurotiomycetes|Verrucariales|Verrucariaceae|Catapyrenium||Catapyrenium Flot.	2
Eupholidoptera chabrieri schmidti (Fieber, 1861)	Animalia|Arthropoda|Insecta|Orthoptera|Tettigoniidae|Eupholidoptera|chabrieri|Eupholidoptera chabrieri schmidti (Fieber, 1861)	2
Chelidonium majus L.	Plantae|Magnoliophyta|Magnoliopsida|Ranunculales|Papaveraceae|Chelidonium|majus|Chelidonium majus L.	2
Euphorbia cyparissias L.	Plantae|Magnoliophyta|Magnoliopsida|Malpighiales|Euphorbiaceae|Euphorbia|cyparissias|Euphorbia cyparissias L.	2
Anemone ranunculoides L.	Plantae|Magnoliophyta|Magnoliopsida|Ranunculales|Ranunculaceae|Anemone|ranunculoides|Anemone ranunculoides L.	2
Lecanora bicincta Ramond	Fungi|Ascomycota|Lecanoromycetes|Lecanorales|Lecanoraceae|Lecanora|bicincta|Lecanora bicincta Ramond	2
Muscari commutatum Guss.	Plantae|Magnoliophyta|Liliopsida|Asparagales|Asparagaceae|Muscari|commutatum|Muscari commutatum Guss.	2
Lanius excubitor Linnaeus, 1758	Animalia|Chordata|Aves|Passeriformes|Laniidae|Lanius|excubitor|Lanius excubitor Linnaeus, 1758	2
Petasites albus A.Gray	Plantae|Magnoliophyta|Magnoliopsida|Asterales|Asteraceae|Petasites|albus|Petasites albus A.Gray	2
Xanthoparmelia stenophylla (Ach.) Ahti & D.Hawksw.	Fungi|Ascomycota|Lecanoromycetes|Lecanorales|Parmeliaceae|Xanthoparmelia|stenophylla|Xanthoparmelia stenophylla (Ach.) Ahti & D.Hawksw.	2
Doloploca punctulana Schiffermüller, 1776	Animalia|Arthropoda|Insecta|Lepidoptera|Tortricidae|Doloploca|punctulana|Doloploca punctulana Schiffermüller, 1776	2
Bilimbia accedens Arnold	Fungi|Ascomycota|Lecanoromycetes|||Bilimbia|accedens|Bilimbia accedens Arnold	2
Miliaria calandra (Linnaeus, 1758)	Animalia|Chordata|Aves|Passeriformes|Emberizidae|Emberiza|calandra|Miliaria calandra (Linnaeus, 1758)	2
Trapeliopsis wallrothii (Flörke) Hertel & Gotth. Schneid.	Fungi|Ascomycota|Lecanoromycetes|Baeomycetales|Trapeliaceae|Trapeliopsis|wallrothii|Trapeliopsis wallrothii (Flörke) Hertel & Gotth. Schneid.	2
Parmeliopsis hyperopta (Ach.) Vain.	Fungi|Ascomycota|Lecanoromycetes|Lecanorales|Parmeliaceae|Parmeliopsis|hyperopta|Parmeliopsis hyperopta (Ach.) Vain.	2
Tragopogon pratensis L.	Plantae|Magnoliophyta|Magnoliopsida|Asterales|Asteraceae|Tragopogon|pratensis|Tragopogon pratensis L.	2
Cladonia stygia (Fr.) Ruoss	Fungi|Ascomycota|Lecanoromycetes|Lecanorales|Cladoniaceae|Cladonia|stygia|Cladonia stygia (Fr.) Ruoss	2
Panemeria tenebrata Scopoli, 1763	Animalia|Arthropoda|Insecta|Lepidoptera|Noctuidae|Panemeria|tenebrata|Panemeria tenebrata Scopoli, 1763	2
Rhizocarpon ferax H.Magn.	Fungi|Ascomycota|Lecanoromycetes|Lecanorales|Rhizocarpaceae|Rhizocarpon|ferax|Rhizocarpon ferax H.Magn.	2
Arthrorhaphis citrinella (Ach.) Poelt	Fungi|Ascomycota|Lecanoromycetes|Lecanorales|Arthrorhaphidaceae|Arthrorhaphis|citrinella|Arthrorhaphis citrinella (Ach.) Poelt	2
Ochrolechia szatalaënsis Verseghy	Fungi|Ascomycota|Lecanoromycetes|Pertusariales|Ochrolechiaceae|Ochrolechia|szatalaënsis|Ochrolechia szatalaënsis Verseghy	2
Lecania fuscella (Schaer.) A.Massal.	Fungi|Ascomycota|Lecanoromycetes|Lecanorales|Ramalinaceae|Lecania|fuscella|Lecania fuscella (Schaer.) A.Massal.	2
Leuctra nigra (Olivier, 1811)	Animalia|Arthropoda|Insecta|Plecoptera|Leuctridae|Leuctra|nigra|Leuctra nigra (Olivier, 1811)	2
Clauzadea metzleri (Körb.) Clauzade & Cl. Roux ex D. Hawksw.	Fungi|Ascomycota|Lecanoromycetes|Lecanorales|Lecideaceae|Clauzadea|metzleri|Clauzadea metzleri (Körb.) Clauzade & Cl. Roux ex D. Hawksw.	2
Rallus aquaticus Linnaeus, 1758	Animalia|Chordata|Aves|Gruiformes|Rallidae|Rallus|aquaticus|Rallus aquaticus Linnaeus, 1758	2
Lanius minor Gmelin, 1788	Animalia|Chordata|Aves|Passeriformes|Laniidae|Lanius|minor|Lanius minor Gmelin, 1788	2
Ficedula semitorquata (Homeyer, 1885)	Animalia|Chordata|Aves|Passeriformes|Muscicapidae|Ficedula|semitorquata|Ficedula semitorquata (Homeyer, 1885)	2
Grimmia funalis Bruch & W. P. Schimper in B.S.G., 1845	Plantae|Bryophyta|Bryopsida|Grimmiales|Grimmiaceae|Grimmia|funalis|Grimmia funalis Bruch & W. P. Schimper in B.S.G., 1845	2
Eurydema dominulus (Scopoli, 1763)	Animalia|Arthropoda|Insecta|Hemiptera|Pentatomidae|Eurydema|dominulus|Eurydema dominulus (Scopoli, 1763)	2
Diploschistes scruposus (Schreb.) Norman	Fungi|Ascomycota|Lecanoromycetes|Ostropales|Graphidaceae|Diploschistes|scruposus|Diploschistes scruposus (Schreb.) Norman	2
Vicia villosa Roth	Plantae|Tracheophyta|Magnoliopsida|Fabales|Fabaceae|Vicia|villosa|Vicia villosa Roth	2
Leuctra inermis Kempny, 1899	Animalia|Arthropoda|Insecta|Plecoptera|Leuctridae|Leuctra|inermis|Leuctra inermis Kempny, 1899	2
Bournonia Fischer, 1887	Animalia|Mollusca|Bivalvia||Radiolitidae|Bournonia||Bournonia Fischer, 1887	2
Stigmidium pumilum (Lettau) Matzer & Hafellner, 1990	Fungi|Ascomycota|Dothideomycetes|Capnodiales|Mycosphaerellaceae|Stigmidium|pumilum|Stigmidium pumilum (Lettau) Matzer & Hafellner, 1990	2
Sherardia arvensis L.	Plantae|Tracheophyta|Magnoliopsida|Gentianales|Rubiaceae|Sherardia|arvensis|Sherardia arvensis L.	2
Iris reichenbachii Heuff.	Plantae|Tracheophyta|Liliopsida|Asparagales|Iridaceae|Iris|reichenbachii|Iris reichenbachii Heuff.	2
Ligdia adustata Schiffermüller, 1775	Animalia|Arthropoda|Insecta|Lepidoptera|Geometridae|Ligdia|adustata|Ligdia adustata Schiffermüller, 1775	2
Euphydryas aurinia (Rottemburg, 1775)	Animalia|Arthropoda|Insecta|Lepidoptera|Nymphalidae|Eurodryas|aurinia|Euphydryas aurinia (Rottemburg, 1775)	2
Melanargia galathea Linnaeus, 1758	Animalia|Arthropoda|Insecta|Lepidoptera|Nymphalidae|Melanargia|galathea|Melanargia galathea Linnaeus, 1758	2
Papaver dubium L.	Plantae|Tracheophyta|Magnoliopsida|Ranunculales|Papaveraceae|Papaver|dubium|Papaver dubium L.	2
Cladonia arbuscula subsp. squarrosa (Wallr.) Ruoss	Fungi|Ascomycota|Lecanoromycetes|Lecanorales|Cladoniaceae|Cladonia|arbuscula|Cladonia arbuscula subsp. squarrosa (Wallr.) Ruoss	2
Cephalanthera damasonium (Mill.) Druce	Plantae|Tracheophyta|Liliopsida|Asparagales|Orchidaceae|Cephalanthera|damasonium|Cephalanthera damasonium (Mill.) Druce	2
Helianthemum nummularium (L.) Mill.	Plantae|Magnoliophyta|Magnoliopsida|Malvales|Cistaceae|Helianthemum|nummularium|Helianthemum nummularium (L.) Mill.	2
Euphydryas Scudder, 1872	Animalia|Arthropoda|Insecta|Lepidoptera|Nymphalidae|Euphydryas||Euphydryas Scudder, 1872	2
Colomerus vitis (Pagenstecher, 1857)	Animalia|Arthropoda|Arachnida|Prostigmata|Eriophyidae|Colomerus|vitis|Colomerus vitis (Pagenstecher, 1857)	2
Vicia villosa Roth	Plantae|Magnoliophyta|Magnoliopsida|Fabales|Fabaceae|Vicia|villosa|Vicia villosa Roth	2
Lecidella achristotera (Nyl.) Hertel & Leuckert	Fungi|Ascomycota|Lecanoromycetes|Lecanorales|Lecanoraceae|Lecidella|achristotera|Lecidella achristotera (Nyl.) Hertel & Leuckert	2
Egretta garzetta (Linnaeus, 1766)	Animalia|Chordata|Aves|Pelecaniformes|Ardeidae|Egretta|garzetta|Egretta garzetta (Linnaeus, 1766)	2
Xylographa parallela (Ach.) Fr.	Fungi|Ascomycota|Lecanoromycetes|Baeomycetales|Trapeliaceae|Xylographa|parallela|Xylographa parallela (Ach.) Fr.	2
Leptogium intermedium (Arnold) Arnold	Fungi|Ascomycota|Lecanoromycetes|Peltigerales|Collemataceae|Leptogium|intermedium|Leptogium intermedium (Arnold) Arnold	2
Siphonoperla torrentium (Pictet, F.J., 1841)	Animalia|Arthropoda|Insecta|Plecoptera|Chloroperlidae|Siphonoperla|torrentium|Siphonoperla torrentium (Pictet, F.J., 1841)	2
Cladonia gracilis subsp. elongata (Wulfen) Vain.	Fungi|Ascomycota|Lecanoromycetes|Lecanorales|Cladoniaceae|Cladonia|gracilis|Cladonia gracilis subsp. elongata (Wulfen) Vain.	2
Xanthoria contortuplicata (Ach.) Boistel	Fungi|Ascomycota|Lecanoromycetes|Lecanorales|Parmeliaceae|Parmelia|contortuplicata|Xanthoria contortuplicata (Ach.) Boistel	2
Lecanora saligna (Schrad.) Zahlbr.	Fungi|Ascomycota|Lecanoromycetes|Lecanorales|Lecanoraceae|Lecanora|saligna|Lecanora saligna (Schrad.) Zahlbr.	2
Alchemilla L.	Plantae|Tracheophyta|Magnoliopsida|Rosales|Rosaceae|Alchemilla||Alchemilla L.	2
Hordeum vulgare L.	Plantae|Tracheophyta|Liliopsida|Poales|Poaceae|Hordeum|vulgare|Hordeum vulgare L.	2
Buellia erubescens Arnold	Fungi|Ascomycota|Lecanoromycetes|Teloschistales|Physciaceae|Buellia|erubescens|Buellia erubescens Arnold	2
Cantareus aspersa (Müller, 1774)	Animalia|Mollusca|Gastropoda|Stylommatophora|Helicidae|Helix|aspersa|Cantareus aspersa (Müller, 1774)	2
Gowardia nigricans (Ach.) Halonen, Myllys, Velmala & Hyvärinen	Fungi|Ascomycota|Lecanoromycetes|Lecanorales|Parmeliaceae|Alectoria|nigricans|Gowardia nigricans (Ach.) Halonen, Myllys, Velmala & Hyvärinen	2
Prioniodella Bassler, 1925	Animalia|Annelida||||Prioniodella||Prioniodella Bassler, 1925	2
Schaereria fuscocinerea (Nyl.) Clauzade & Cl. Roux	Fungi|Ascomycota|Lecanoromycetes|Agyriales|Schaereriaceae|Schaereria|fuscocinerea|Schaereria fuscocinerea (Nyl.) Clauzade & Cl. Roux	2
Muellerella Hepp, 1862	Fungi|Ascomycota|Eurotiomycetes|Verrucariales|Verrucariaceae|Muellerella||Muellerella Hepp, 1862	2
Toninia squalida (Ach.) A. Massal.	Fungi|Ascomycota|Lecanoromycetes|Lecanorales|Ramalinaceae|Toninia|squalida|Toninia squalida (Ach.) A. Massal.	2
Candelariella reflexa (Nyl.) Lettau	Fungi|Ascomycota|Lecanoromycetes|Candelariales|Candelariaceae|Candelariella|reflexa|Candelariella reflexa (Nyl.) Lettau	2
Podarcis tauricus Pallas, 1814	Animalia|Chordata|Reptilia|Squamata|Lacertidae|Podarcis|tauricus|Podarcis tauricus Pallas, 1814	2
Pernis apivorus (Linnaeus, 1758)	Animalia|Chordata|Aves|Accipitriformes|Accipitridae|Pernis|apivorus|Pernis apivorus (Linnaeus, 1758)	2
Medicago arabica (L.) Huds.	Plantae|Tracheophyta|Magnoliopsida|Fabales|Fabaceae|Medicago|arabica|Medicago arabica (L.) Huds.	2
Caloplaca herbidella (Hue) H. Magn.	Fungi|Ascomycota|Lecanoromycetes|Teloschistales|Teloschistaceae|Caloplaca|herbidella|Caloplaca herbidella (Hue) H. Magn.	2
Picus canus Gmelin, 1788	Animalia|Chordata|Aves|Piciformes|Picidae|Picus|canus|Picus canus Gmelin, 1788	2
Zebrina detrita (O.F. Müller, 1774)	Animalia|Mollusca|Gastropoda|Stylommatophora|Enidae|Zebrina|detrita|Zebrina detrita (O.F. Müller, 1774)	2
Opatrum sabulosum (L., 1761)	Animalia|Arthropoda|Insecta|Coleoptera|Tenebrionidae|Opatrum|sabulosum|Opatrum sabulosum (L., 1761)	2
Grimmia trichophylla Greville, 1824	Plantae|Bryophyta|Bryopsida|Grimmiales|Grimmiaceae|Grimmia|trichophylla|Grimmia trichophylla Greville, 1824	2
Erinaceus concolor Martin, 1838	Animalia|Chordata|Mammalia|Erinaceomorpha|Erinaceidae|Erinaceus|concolor|Erinaceus concolor Martin, 1838	2
Allancastria cerisyi Godart, 1822	Animalia|Arthropoda|Insecta|Lepidoptera|Papilionidae|Allancastria|cerisyi|Allancastria cerisyi Godart, 1822	2
Canis lupus Linnaeus, 1758	Animalia|Chordata|Mammalia|Carnivora|Canidae|Canis|lupus|Canis lupus Linnaeus, 1758	2
Vicia lutea L.	Plantae|Tracheophyta|Magnoliopsida|Fabales|Fabaceae|Vicia|lutea|Vicia lutea L.	2
Anthocharis cardamines (Linnaeus, 1758)	Animalia|Arthropoda|Insecta|Lepidoptera|Pieridae|Anthocharis|cardamines|Anthocharis cardamines (Linnaeus, 1758)	2
Rinodina immersa (Körb.) Zahlbr.	Fungi|Ascomycota|Lecanoromycetes|Teloschistales|Physciaceae|Rinodina|immersa|Rinodina immersa (Körb.) Zahlbr.	2
Limnephilus bipunctatus Curtis, 1834	Animalia|Arthropoda|Insecta|Trichoptera|Limnephilidae|Limnephilus|bipunctatus|Limnephilus bipunctatus Curtis, 1834	2
Anemone nemorosa L.	Plantae|Tracheophyta|Magnoliopsida|Ranunculales|Ranunculaceae|Anemone|nemorosa|Anemone nemorosa L.	2
Trichia varia (Pers. ex J.F.Gmel.) Pers., 1794	Protozoa|Mycetozoa|Myxomycetes|Trichiales|Trichiaceae|Trichia|varia|Trichia varia (Pers. ex J.F.Gmel.) Pers., 1794	2
Podarcis tauricus (Pallas, 1814)	Animalia|Chordata|Reptilia|Squamata|Lacertidae|Podarcis|tauricus|Podarcis tauricus (Pallas, 1814)	2
Alchemilla flabellata Buser	Plantae|Tracheophyta|Magnoliopsida|Rosales|Rosaceae|Alchemilla|flabellata|Alchemilla flabellata Buser	2
Ajuga laxmanni Benth.	Plantae|Magnoliophyta|Magnoliopsida|Lamiales|Lamiaceae|Ajuga|laxmanni|Ajuga laxmanni Benth.	2
Tropinota hirta (Poda, 1761)	Animalia|Arthropoda|Insecta|Coleoptera|Cetoniidae|Tropinota|hirta|Tropinota hirta (Poda, 1761)	2
Caloplaca cerina var. chloroleuca (Sm.) Th. Fr.	Fungi|Ascomycota|Lecanoromycetes|Teloschistales|Teloschistaceae|Caloplaca|cerina|Caloplaca cerina var. chloroleuca (Sm.) Th. Fr.	2
Polygonatum odoratum (Mill.) Druce	Plantae|Magnoliophyta|Liliopsida|Asparagales|Asparagaceae|Polygonatum|odoratum|Polygonatum odoratum (Mill.) Druce	2
Lecania suavis (Müll. Arg.) Mig.	Fungi|Ascomycota|Lecanoromycetes|Lecanorales|Ramalinaceae|Lecania|suavis|Lecania suavis (Müll. Arg.) Mig.	2
Palaeopsylla similis similis Dampf, 1910	Animalia|Arthropoda|Insecta|Siphonaptera|Ctenophthalmidae|Palaeopsylla|similis|Palaeopsylla similis similis Dampf, 1910	1
Lecanora admontensis Zahlbr.	Fungi|Ascomycota|Lecanoromycetes|Lecanorales|Lecanoraceae|Lecanora|admontensis|Lecanora admontensis Zahlbr.	1
Neotinea ustulata (L.) R.M.Bateman, Pridgeon & M.W.Chase	Plantae|Magnoliophyta|Liliopsida|Asparagales|Orchidaceae|Neotinea|ustulata|Neotinea ustulata (L.) R.M.Bateman, Pridgeon & M.W.Chase	1
Trifolium resupinatum L.	Plantae|Magnoliophyta|Magnoliopsida|Fabales|Fabaceae|Trifolium|resupinatum|Trifolium resupinatum L.	1
Trifolium pannonicum Jacq.	Plantae|Magnoliophyta|Magnoliopsida|Fabales|Fabaceae|Trifolium|pannonicum|Trifolium pannonicum Jacq.	1
Vanessa cardui (Linnaeus, 1758)	Animalia|Arthropoda|Insecta|Lepidoptera|Nymphalidae|Vanessa|cardui|Vanessa cardui (Linnaeus, 1758)	1
Aegolius funereus (Linnaeus, 1758)	Animalia|Chordata|Aves|Strigiformes|Strigidae|Aegolius|funereus|Aegolius funereus (Linnaeus, 1758)	1
Poecile palustris (Linnaeus, 1758)	Animalia|Chordata|Aves|Passeriformes|Paridae|Poecile|palustris|Poecile palustris (Linnaeus, 1758)	1
Neoendothyra Reitlinger, 1965	Protozoa|Sarcomastigophora||||Neoendothyra||Neoendothyra Reitlinger, 1965	1
Morimus asper (Sulzer, 1776)	Animalia|Arthropoda|Insecta|Coleoptera|Cerambycidae|Morimus|asper|Morimus asper (Sulzer, 1776)	1
Fragaria vesca L.	Plantae|Magnoliophyta|Magnoliopsida|Rosales|Rosaceae|Fragaria|vesca|Fragaria vesca L.	1
Alchemilla lanuginosa Rothm.	Plantae|Tracheophyta|Magnoliopsida|Rosales|Rosaceae|Alchemilla|lanuginosa|Alchemilla lanuginosa Rothm.	1
Pisum elatius M.Bieb.	Plantae|Magnoliophyta|Magnoliopsida|Fabales|Fabaceae|Pisum|elatius|Pisum elatius M.Bieb.	1
Plantago media L.	Plantae|Magnoliophyta|Magnoliopsida|Lamiales|Plantaginaceae|Plantago|media|Plantago media L.	1
Caloplaca ammiospila (Wahlenb.) H. Olivier	Fungi|Ascomycota|Lecanoromycetes|Teloschistales|Teloschistaceae|Caloplaca|ammiospila|Caloplaca ammiospila (Wahlenb.) H. Olivier	1
Lathyrus aphaca L.	Plantae|Magnoliophyta|Magnoliopsida|Fabales|Fabaceae|Lathyrus|aphaca|Lathyrus aphaca L.	1
Polypodium vulgare auct. non L.	Plantae|Pteridophyta|Polypodiopsida|Polypodiales|Polypodiaceae|Polypodium|vulgare|Polypodium vulgare auct. non L.	1
Ajuga genevensis L.	Plantae|Tracheophyta|Magnoliopsida|Lamiales|Lamiaceae|Ajuga|genevensis|Ajuga genevensis L.	1
Viola elatior Wimm.	Plantae|Magnoliophyta|Magnoliopsida|Malpighiales|Violaceae|Viola|elatior|Viola elatior Wimm.	1
Carduus thoermeri Weinm.	Plantae|Magnoliophyta|Magnoliopsida|Asterales|Asteraceae||thoermeri|Carduus thoermeri Weinm.	1
Helleborus viridis L.	Plantae|Magnoliophyta|Magnoliopsida|Ranunculales|Ranunculaceae|Helleborus|viridis|Helleborus viridis L.	1
Pulmonaria mollis Wulfen ex Hornem.	Plantae|Tracheophyta|Magnoliopsida|Boraginales|Boraginaceae|Pulmonaria|mollis|Pulmonaria mollis Wulfen ex Hornem.	1
Viburnum lantana L.	Plantae|Tracheophyta|Magnoliopsida|Dipsacales|Adoxaceae|Viburnum|lantana|Viburnum lantana L.	1
Ononis spinosa L.	Plantae|Tracheophyta|Magnoliopsida|Fabales|Fabaceae|Ononis|spinosa|Ononis spinosa L.	1
Ajuga genevensis L.	Plantae|Magnoliophyta|Magnoliopsida|Lamiales|Lamiaceae|Ajuga|genevensis|Ajuga genevensis L.	1
Euphorbia glabriflora Vis.	Plantae|Tracheophyta|Magnoliopsida|Malpighiales|Euphorbiaceae|Euphorbia|glabriflora|Euphorbia glabriflora Vis.	1
Veronica officinalis L.	Plantae|Tracheophyta|Magnoliopsida|Lamiales|Plantaginaceae|Veronica|officinalis|Veronica officinalis L.	1
Onobrychis Mill.	Plantae|Magnoliophyta|Magnoliopsida|Fabales|Fabaceae|Onobrychis||Onobrychis Mill.	1
Cardamine bulbifera (L.) Crantz	Plantae|Magnoliophyta|Magnoliopsida|Brassicales|Brassicaceae|Cardamine|bulbifera|Cardamine bulbifera (L.) Crantz	1
Astragalus onobrychis L.	Plantae|Tracheophyta|Magnoliopsida|Fabales|Fabaceae|Astragalus|onobrychis|Astragalus onobrychis L.	1
Halacsya sendtneri Dörfl.	Plantae|Magnoliophyta|Magnoliopsida|Boraginales|Boraginaceae|Halacsya|sendtneri|Halacsya sendtneri Dörfl.	1
Lecanora dispersa (Pers.) Sommerf.	Fungi|Ascomycota|Lecanoromycetes|Lecanorales|Lecanoraceae|Lecanora|dispersa|Lecanora dispersa (Pers.) Sommerf.	1
Veronica prostrata L.	Plantae|Tracheophyta|Magnoliopsida|Lamiales|Plantaginaceae|Veronica|prostrata|Veronica prostrata L.	1
Circaetus gallicus (Gmelin, 1788)	Animalia|Chordata|Aves|Accipitriformes|Accipitridae|Circaetus|gallicus|Circaetus gallicus (Gmelin, 1788)	1
Astragalus onobrychis L.	Plantae|Magnoliophyta|Magnoliopsida|Fabales|Fabaceae|Astragalus|onobrychis|Astragalus onobrychis L.	1
Paraceratites trinodosus (Mojsisovics, 1882)	Animalia|Mollusca|Cephalopoda||Ceratitidae|Paraceratites|trinodosus|Paraceratites trinodosus (Mojsisovics, 1882)	1
Phleum phleoides (L.) H.Karst.	Plantae|Tracheophyta|Liliopsida|Poales|Poaceae|Phleum|phleoides|Phleum phleoides (L.) H.Karst.	1
Trifolium ochroleucon Huds.	Plantae|Tracheophyta|Magnoliopsida|Fabales|Fabaceae|Trifolium|ochroleucon|Trifolium ochroleucon Huds.	1
Arum italicum Mill.	Plantae|Magnoliophyta|Liliopsida|Alismatales|Araceae|Arum|italicum|Arum italicum Mill.	1
Lecanora allophana (Ach.) Nyl.	Fungi|Ascomycota|Lecanoromycetes|Lecanorales|Lecanoraceae|Lecanora|allophana|Lecanora allophana (Ach.) Nyl.	1
Monoclea W.J. Hooker, 1820	Plantae|Marchantiophyta|Marchantiopsida|Marchantiales|Monocleaceae|Monoclea||Monoclea W.J. Hooker, 1820	1
Tephromela atra (Huds.) Hafellner	Fungi|Ascomycota|Lecanoromycetes|Lecanorales|Mycoblastaceae|Tephromela|atra|Tephromela atra (Huds.) Hafellner	1
Primula vulgaris Hill	Plantae|Tracheophyta|Magnoliopsida|Ericales|Primulaceae|Primula|vulgaris|Primula vulgaris Hill	1
Orlaya grandiflora (L.) Hoffm.	Plantae|Magnoliophyta|Magnoliopsida|Apiales|Apiaceae|Orlaya|grandiflora|Orlaya grandiflora (L.) Hoffm.	1
Paeonia peregrina Ten.	Plantae|Magnoliophyta|Magnoliopsida|Saxifragales|Paeoniaceae|Paeonia|peregrina|Paeonia peregrina Ten.	1
Melanelia stygia (L.) Essl.	Fungi|Ascomycota|Lecanoromycetes|Lecanorales|Parmeliaceae|Melanelia|stygia|Melanelia stygia (L.) Essl.	1
Lathyrus laxiflorus (Desf.) Kuntze	Plantae|Magnoliophyta|Magnoliopsida|Fabales|Fabaceae|Lathyrus|laxiflorus|Lathyrus laxiflorus (Desf.) Kuntze	1
Asio otus (Linnaeus, 1758)	Animalia|Chordata|Aves|Strigiformes|Strigidae|Asio|otus|Asio otus (Linnaeus, 1758)	1
Psorodonotus fieberi macedonicus Ramme, 1931	Animalia|Arthropoda|Insecta|Orthoptera|Tettigoniidae|Psorodonotus|fieberi|Psorodonotus fieberi macedonicus Ramme, 1931	1
Psorodonotus fieberi (Frivaldszky, 1853)	Animalia|Arthropoda|Insecta|Orthoptera|Tettigoniidae|Psorodonotus|fieberi|Psorodonotus fieberi (Frivaldszky, 1853)	1
Alyssum markgrafii O.E. Schulz ex Markgr.	Plantae|Tracheophyta|Magnoliopsida|Brassicales|Brassicaceae|Alyssum|markgrafii|Alyssum markgrafii O.E. Schulz ex Markgr.	1
Lecanora allophana Nyl.	Fungi|Ascomycota|Lecanoromycetes|Lecanorales|Lecanoraceae|Lecanora|allophana|Lecanora allophana Nyl.	1
Psorinia conglomerata (Ach.) Gotth. Schneid.	Fungi|Ascomycota|Lecanoromycetes|Lecanorales|Lecanoraceae|Psorinia|conglomerata|Psorinia conglomerata (Ach.) Gotth. Schneid.	1
Gyps fulvus (Hablizl, 1783)	Animalia|Chordata|Aves|Accipitriformes|Accipitridae|Gyps|fulvus|Gyps fulvus (Hablizl, 1783)	1
Vaccinites cornuvaccium Bronn, 1984	Animalia|Mollusca|Bivalvia||Hippuritidae|Vaccinites|cornuvaccium|Vaccinites cornuvaccium Bronn, 1984	1
Onosma pseudoarenaria Schur	Plantae|Magnoliophyta|Magnoliopsida|Boraginales|Boraginaceae|Onosma|pseudoarenaria|Onosma pseudoarenaria Schur	1
Tetrastes bonasia	Animalia|Chordata|Aves|Galliformes|Phasianidae|Tetrastes|Tetrastes bonasia	1
Phleum phleoides (L.) H.Karst.	Plantae|Magnoliophyta|Liliopsida|Poales|Poaceae|Phleum|phleoides|Phleum phleoides (L.) H.Karst.	1
Saxicola rubicola (Linnaeus, 1758)	Animalia|Chordata|Aves|Passeriformes|Muscicapidae|Saxicola|rubicola|Saxicola rubicola (Linnaeus, 1758)	1
Vicia sativa L.	Plantae|Magnoliophyta|Magnoliopsida|Fabales|Fabaceae|Vicia|sativa|Vicia sativa L.	1
Poa glauca subsp. frearitis	Plantae|Magnoliophyta|Liliopsida|Poales|Poaceae|Poa|glauca|Poa glauca subsp. frearitis	1
Ophrys holoserica (Burm. f.) Greuter	Plantae|Magnoliophyta|Liliopsida|Asparagales|Orchidaceae|Ophrys|holoserica|Ophrys holoserica (Burm. f.) Greuter	1
Astragalus australis (L.) Lam.	Plantae|Tracheophyta|Magnoliopsida|Fabales|Fabaceae|Astragalus|australis|Astragalus australis (L.) Lam.	1
Juniperus communis var. communis	Plantae|Tracheophyta|Pinopsida|Pinales|Cupressaceae|Juniperus|communis|Juniperus communis var. communis	1
Poa L.	Plantae|Tracheophyta|Liliopsida|Poales|Poaceae|Poa||Poa L.	1
Cladonia P. Browne, 1756	Fungi|Ascomycota|Lecanoromycetes|Lecanorales|Cladoniaceae|Cladonia||Cladonia P. Browne, 1756	1
Oedipoda caerulescens (Linnaeus, C.N., 1758)	Animalia|Arthropoda|Insecta|Orthoptera|Acrididae|Oedipoda|caerulescens|Oedipoda caerulescens (Linnaeus, C.N., 1758)	1
Celastrina argiolus (Linnaeus, 1758)	Animalia|Arthropoda|Insecta|Lepidoptera|Lycaenidae|Celastrina|argiolus|Celastrina argiolus (Linnaeus, 1758)	1
Lecanora circumborealis Brodo & Vitik.	Fungi|Ascomycota|Lecanoromycetes|Lecanorales|Lecanoraceae|Lecanora|circumborealis|Lecanora circumborealis Brodo & Vitik.	1
Pisum elatius M.Bieb.	Plantae|Tracheophyta|Magnoliopsida|Fabales|Fabaceae|Pisum|elatius|Pisum elatius M.Bieb.	1
Thalictrum aquilegiifolium L.	Plantae|Tracheophyta|Magnoliopsida|Ranunculales|Ranunculaceae|Thalictrum|aquilegiifolium|Thalictrum aquilegiifolium L.	1
Digitalis ferruginea	Plantae|Magnoliophyta|Magnoliopsida|Lamiales|Plantaginaceae|Digitalis|Digitalis ferruginea	1
Tetrao urogallus Linnaeus, 1758	Animalia|Chordata|Aves|Galliformes|Phasianidae|Tetrao|urogallus|Tetrao urogallus Linnaeus, 1758	1
Lithospermum arvense L.	Plantae|Magnoliophyta|Magnoliopsida|Boraginales|Boraginaceae|Buglossoides|arvense|Lithospermum arvense L.	1
Rumex L.	Plantae|Magnoliophyta|Magnoliopsida|Caryophyllales|Polygonaceae|Rumex||Rumex L.	1
Collema flaccidulum (Flagey) Zahlbr.	||||||flaccidulum|Collema flaccidulum (Flagey) Zahlbr.	1
Caloplaca dalmatica (A. Massal.) H. Olivier, 1909	Fungi|Ascomycota|Lecanoromycetes|Teloschistales|Teloschistaceae|Caloplaca|dalmatica|Caloplaca dalmatica (A. Massal.) H. Olivier, 1909	1
Acrocephalus scirpaceus (Hermann, 1804)	Animalia|Chordata|Aves|Passeriformes|Sylviidae|Acrocephalus|scirpaceus|Acrocephalus scirpaceus (Hermann, 1804)	1
Circus macrourus (S. G. Gmelin, 1770)	Animalia|Chordata|Aves|Accipitriformes|Accipitridae|Circus|macrourus|Circus macrourus (S. G. Gmelin, 1770)	1
Erinaceus roumanicus Barrett-Hamilton, 1900	Animalia|Chordata|Mammalia|Erinaceomorpha|Erinaceidae|Erinaceus|roumanicus|Erinaceus roumanicus Barrett-Hamilton, 1900	1
Pyrrhosoma nymphula Sulzer, 1776	Animalia|Arthropoda|Insecta|Odonata|Coenagrionidae|Pyrrhosoma|nymphula|Pyrrhosoma nymphula Sulzer, 1776	1
Thamnogalla crombiei (Mudd) D.Hawksw.	Fungi|Ascomycota|Lecanoromycetes|Ostropales|Odontotremataceae|Thamnogalla|crombiei|Thamnogalla crombiei (Mudd) D.Hawksw.	1
Fumaria officinalis L.	Plantae|Magnoliophyta|Magnoliopsida|Ranunculales|Papaveraceae|Fumaria|officinalis|Fumaria officinalis L.	1
Lathyrus laxiflorus (Desf.) Kuntze	Plantae|Tracheophyta|Magnoliopsida|Fabales|Fabaceae|Lathyrus|laxiflorus|Lathyrus laxiflorus (Desf.) Kuntze	1
Corydalis cava (L.) Schweigger & Koerte	Plantae|Tracheophyta|Magnoliopsida|Ranunculales|Papaveraceae|Corydalis|cava|Corydalis cava (L.) Schweigger & Koerte	1
Onobrychis viciifolia Scop.	Plantae|Tracheophyta|Magnoliopsida|Fabales|Fabaceae|Onobrychis|viciifolia|Onobrychis viciifolia Scop.	1
Potentilla recta L.	Plantae|Tracheophyta|Magnoliopsida|Rosales|Rosaceae|Potentilla|recta|Potentilla recta L.	1
Linum campanulatum L.	Plantae|Tracheophyta|Magnoliopsida|Malpighiales|Linaceae|Linum|campanulatum|Linum campanulatum L.	1
Carduus thoermeri Weinm.	Plantae|Tracheophyta|Magnoliopsida|Asterales|Asteraceae|Carduus|thoermeri|Carduus thoermeri Weinm.	1
Melitaea athalia (Rottemburg, 1775)	Animalia|Arthropoda|Insecta|Lepidoptera|Nymphalidae|Mellicta|athalia|Melitaea athalia (Rottemburg, 1775)	1
Asparagus tenuifolius Lam.	Plantae|Tracheophyta|Liliopsida|Asparagales|Asparagaceae|Asparagus|tenuifolius|Asparagus tenuifolius Lam.	1
Cynoglossum officinale L.	Plantae|Magnoliophyta|Magnoliopsida|Boraginales|Boraginaceae|Cynoglossum|officinale|Cynoglossum officinale L.	1
Onobrychis alba (Waldst. & Kit.) Desv.	Plantae|Magnoliophyta|Magnoliopsida|Fabales|Fabaceae|Onobrychis|alba|Onobrychis alba (Waldst. & Kit.) Desv.	1
Caprimulgus europaeus Linnaeus, 1758	Animalia|Chordata|Aves|Caprimulgiformes|Caprimulgidae|Caprimulgus|europaeus|Caprimulgus europaeus Linnaeus, 1758	1
Daphne mezereum L.	Plantae|Magnoliophyta|Magnoliopsida|Malvales|Thymelaeaceae|Daphne|mezereum|Daphne mezereum L.	1
Primula veris L.	Plantae|Magnoliophyta|Magnoliopsida|Ericales|Primulaceae|Primula|veris|Primula veris L.	1
Vicia grandiflora Scop.	Plantae|Magnoliophyta|Magnoliopsida|Fabales|Fabaceae|Vicia|grandiflora|Vicia grandiflora Scop.	1
Gnaptor Brullé in Bory de St. Vincent, 1832	Animalia|Arthropoda|Insecta|Coleoptera|Tenebrionidae|Gnaptor||Gnaptor Brullé in Bory de St. Vincent, 1832	1
Anas querquedula Linnaeus, 1758	Animalia|Chordata|Aves|Anseriformes|Anatidae|Anas|querquedula|Anas querquedula Linnaeus, 1758	1
Ctenophthalmus Kolenati, 1856	Animalia|Arthropoda|Insecta|Siphonaptera|Hystrichopsyllidae|Ctenophthalmus||Ctenophthalmus Kolenati, 1856	1
Muscicapa striata (Pallas, 1764)	Animalia|Chordata|Aves|Passeriformes|Muscicapidae|Muscicapa|striata|Muscicapa striata (Pallas, 1764)	1
Parus montanus Conrad, 1827	Animalia|Chordata|Aves|Passeriformes|Paridae|Poecile|montanus|Parus montanus Conrad, 1827	1
Aeropus sibiricus subsp. graecus Uvarov, 1931	Animalia|Arthropoda|Insecta|Orthoptera|Acrididae|Gomphocerus|sibiricus|Aeropus sibiricus subsp. graecus Uvarov, 1931	1
Acinos alpinus (L.) Moench	Plantae|Tracheophyta|Magnoliopsida|Lamiales|Lamiaceae|Clinopodium|alpinus|Acinos alpinus (L.) Moench	1
Collema Weber ex F.H.Wigg.	Fungi|Ascomycota|Lecanoromycetes|Peltigerales|Collemataceae|Collema||Collema Weber ex F.H.Wigg.	1
Lamium purpureum L.	Plantae|Tracheophyta|Magnoliopsida|Lamiales|Lamiaceae|Lamium|purpureum|Lamium purpureum L.	1
Collema cristatum (L.) F.H. Wigg.	Fungi|Ascomycota|Lecanoromycetes|Peltigerales|Collemataceae|Collema|cristatum|Collema cristatum (L.) F.H. Wigg.	1
Silene vulgaris (Moench) Garcke	Plantae|Magnoliophyta|Magnoliopsida|Caryophyllales|Caryophyllaceae|Silene|vulgaris|Silene vulgaris (Moench) Garcke	1
Helix aspersa Muller, 1774	Animalia|Mollusca|Gastropoda|Stylommatophora|Helicidae|Helix|aspersa|Helix aspersa Muller, 1774	1
Arethusana arethusa	Animalia|Arthropoda|Insecta|Lepidoptera|Nymphalidae|Arethusana|Arethusana arethusa	1
Dactylorhiza cordigera (Fr.) Soó	Plantae|Magnoliophyta|Liliopsida|Asparagales|Orchidaceae|Dactylorhiza|cordigera|Dactylorhiza cordigera (Fr.) Soó	1
Platanthera bifolia (L.) Rich.	Plantae|Magnoliophyta|Liliopsida|Asparagales|Orchidaceae|Platanthera|bifolia|Platanthera bifolia (L.) Rich.	1
Monoclea Hook.	Plantae|Marchantiophyta|Marchantiopsida|Marchantiales|Monocleaceae|Monoclea||Monoclea Hook.	1
Dorycnium pentaphyllum subsp. herbaceum (Vill.) Rouy	Plantae|Tracheophyta|Magnoliopsida|Fabales|Fabaceae|Dorycnium|pentaphyllum|Dorycnium pentaphyllum subsp. herbaceum (Vill.) Rouy	1
Saxicola rubicola (Linnaeus, 1766)	Animalia|Chordata|Aves|Passeriformes|Muscicapidae|Saxicola|rubicola|Saxicola rubicola (Linnaeus, 1766)	1
Gonioctena (Spartomena) fornicata (Bruggemann, 1873)	Animalia|Arthropoda|Insecta|Coleoptera|Chrysomelidae|Gonioctena|fornicata|Gonioctena (Spartomena) fornicata (Bruggemann, 1873)	1
Vanessa cardui (Linnaeus, 1758)	Animalia|Arthropoda|Insecta|Lepidoptera|Nymphalidae|Cynthia|cardui|Vanessa cardui (Linnaeus, 1758)	1
Thlaspi perfoliatum L.	Plantae|Magnoliophyta|Magnoliopsida|Brassicales|Brassicaceae|Microthlaspi|perfoliatum|Thlaspi perfoliatum L.	1
Bombina variegata (Linnaeus, 1758)	Animalia|Chordata|Amphibia|Anura|Bombinatoridae|Bombina|variegata|Bombina variegata (Linnaeus, 1758)	1
Carlina acaulis subsp. acaulis	Plantae|Tracheophyta|Magnoliopsida|Asterales|Asteraceae|Carlina|acaulis|Carlina acaulis subsp. acaulis	1
Viburnum lantana L.	Plantae|Magnoliophyta|Magnoliopsida|Dipsacales|Adoxaceae|Viburnum|lantana|Viburnum lantana L.	1
Alliaria petiolata (M.Bieb.) Cavara & Grande	Plantae|Magnoliophyta|Magnoliopsida|Brassicales|Brassicaceae|Alliaria|petiolata|Alliaria petiolata (M.Bieb.) Cavara & Grande	1
Neotinea ustulata (L.) R.M.Bateman, Pridgeon & M.W.Chase	Plantae|Tracheophyta|Liliopsida|Asparagales|Orchidaceae|Neotinea|ustulata|Neotinea ustulata (L.) R.M.Bateman, Pridgeon & M.W.Chase	1
Aremonia agrimonoides (L.) DC.	Plantae|Tracheophyta|Magnoliopsida|Rosales|Rosaceae|Aremonia|agrimonoides|Aremonia agrimonoides (L.) DC.	1
Ochrolechia szatalaensis Verseghy	Fungi|Ascomycota|Lecanoromycetes|Pertusariales|Ochrolechiaceae|Ochrolechia|szatalaensis|Ochrolechia szatalaensis Verseghy	1
Eryngium campestre L.	Plantae|Magnoliophyta|Magnoliopsida|Apiales|Apiaceae|Eryngium|campestre|Eryngium campestre L.	1
Argiope bruennichi (Scopoli, 1772)	Animalia|Arthropoda|Arachnida|Araneae|Araneidae|Argiope|bruennichi|Argiope bruennichi (Scopoli, 1772)	1
Seseli montanum L.	Plantae|Magnoliophyta|Magnoliopsida|Apiales|Apiaceae|Seseli|montanum|Seseli montanum L.	1
Saxifraga rotundifolia L.	Plantae|Magnoliophyta|Magnoliopsida|Saxifragales|Saxifragaceae|Saxifraga|rotundifolia|Saxifraga rotundifolia L.	1
Cardamine enneaphyllos (L.) Crantz	Plantae|Tracheophyta|Magnoliopsida|Brassicales|Brassicaceae|Cardamine|enneaphyllos|Cardamine enneaphyllos (L.) Crantz	1
Anas crecca Linnaeus, 1758	Animalia|Chordata|Aves|Anseriformes|Anatidae|Anas|crecca|Anas crecca Linnaeus, 1758	1
Platycleis ebneri (Ramme, 1926)	Animalia|Arthropoda|Insecta|Orthoptera|Tettigoniidae|Modestana|ebneri|Platycleis ebneri (Ramme, 1926)	1
Luzula campestris (L.) DC.	Plantae|Tracheophyta|Liliopsida|Poales|Juncaceae|Luzula|campestris|Luzula campestris (L.) DC.	1
Eupholidoptera chabrieri (Charpentier, 1825)	Animalia|Arthropoda|Insecta|Orthoptera|Tettigoniidae|Eupholidoptera|chabrieri|Eupholidoptera chabrieri (Charpentier, 1825)	1
Bulgarica (Strigilecula) vetusta gracilior S.H.F. Jaeckel, 1954	Animalia|Mollusca|Gastropoda|Stylommatophora|Clausiliidae|Bulgarica|vetusta|Bulgarica (Strigilecula) vetusta gracilior S.H.F. Jaeckel, 1954	1
Allium sphaerocephalon	Plantae|Magnoliophyta|Liliopsida|Asparagales|Amaryllidaceae|Allium|Allium sphaerocephalon	1
Lunaria rediviva L.	Plantae|Magnoliophyta|Magnoliopsida|Brassicales|Brassicaceae|Lunaria|rediviva|Lunaria rediviva L.	1
Carduus nutans Boiss. ex Nyman	Plantae|Magnoliophyta|Magnoliopsida|Asterales|Asteraceae||nutans|Carduus nutans Boiss. ex Nyman	1
Aethionema saxatile (L.) W.T. Aiton	Plantae|Tracheophyta|Magnoliopsida|Brassicales|Brassicaceae|Aethionema|saxatile|Aethionema saxatile (L.) W.T. Aiton	1
Laburnum anagyroides Medik.	Plantae|Magnoliophyta|Magnoliopsida|Fabales|Fabaceae|Laburnum|anagyroides|Laburnum anagyroides Medik.	1
Alyssum bertolonii Desv.	Plantae|Tracheophyta|Magnoliopsida|Brassicales|Brassicaceae|Alyssum|bertolonii|Alyssum bertolonii Desv.	1
Melitaea athalia (Rottemburg, 1775)	Animalia|Arthropoda|Insecta|Lepidoptera|Nymphalidae|Melitaea|athalia|Melitaea athalia (Rottemburg, 1775)	1
Hippurites colliciatus Woodward, 1855	Animalia|Mollusca|Bivalvia||Hippuritidae|Hippurites|colliciatus|Hippurites colliciatus Woodward, 1855	1
Grimmia anomala Hampe in W. P. Schimper, 1876	Plantae|Bryophyta|Bryopsida|Grimmiales|Grimmiaceae|Grimmia|anomala|Grimmia anomala Hampe in W. P. Schimper, 1876	1
Vinca herbacea Waldst. & Kit.	Plantae|Magnoliophyta|Magnoliopsida|Gentianales|Apocynaceae|Vinca|herbacea|Vinca herbacea Waldst. & Kit.	1
Brintesia circe (Fabricius, 1775)	Animalia|Arthropoda|Insecta|Lepidoptera|Nymphalidae|Satyrus|circe|Brintesia circe (Fabricius, 1775)	1
Onobrychis Mill.	Plantae|Tracheophyta|Magnoliopsida|Fabales|Fabaceae|Onobrychis||Onobrychis Mill.	1
Thamnolia vermicularis var. subuliformis (Ehrh.) Schaer.	Fungi|Ascomycota|Lecanoromycetes|Pertusariales|Icmadophilaceae|Thamnolia|vermicularis|Thamnolia vermicularis var. subuliformis (Ehrh.) Schaer.	1
Androsace L.	Plantae|Magnoliophyta|Magnoliopsida|Ericales|Primulaceae|Androsace||Androsace L.	1
Poa glauca subsp. frearitis (Orph. ex Halácsy) H.Scholz	Plantae|Tracheophyta|Liliopsida|Poales|Poaceae|Poa|glauca|Poa glauca subsp. frearitis (Orph. ex Halácsy) H.Scholz	1
Jynx torquilla Linnaeus, 1758	Animalia|Chordata|Aves|Piciformes|Picidae|Jynx|torquilla|Jynx torquilla Linnaeus, 1758	1
Pinus heldreichii H. Christ	Plantae|Pinophyta|Pinopsida|Pinales|Pinaceae|Pinus|heldreichii|Pinus heldreichii H. Christ	1
Anser anser (Linnaeus, 1758)	Animalia|Chordata|Aves|Anseriformes|Anatidae|Anser|anser|Anser anser (Linnaeus, 1758)	1
Aeropus sibiricus graecus Uvarov, 1931	Animalia|Arthropoda|Insecta|Orthoptera|Acrididae|Gomphocerus|sibiricus|Aeropus sibiricus graecus Uvarov, 1931	1
Campanula scheuchzeri Vill.	Plantae|Magnoliophyta|Magnoliopsida|Asterales|Campanulaceae|Campanula|scheuchzeri|Campanula scheuchzeri Vill.	1
Parus caeruleus Linnaeus, 1758	Animalia|Chordata|Aves|Passeriformes|Paridae|Parus|caeruleus|Parus caeruleus Linnaeus, 1758	1
Aspicilia contorta (Hoffm.) Kremp.	Fungi|Ascomycota|Lecanoromycetes|Pertusariales|Megasporaceae|Aspicilia|contorta|Aspicilia contorta (Hoffm.) Kremp.	1
Dactylorhiza majalis (Rchb.) P.F.Hunt & Summerh.	Plantae|Magnoliophyta|Liliopsida|Asparagales|Orchidaceae|Dactylorhiza|majalis|Dactylorhiza majalis (Rchb.) P.F.Hunt & Summerh.	1
Reseda lutea L.	Plantae|Tracheophyta|Magnoliopsida|Brassicales|Resedaceae|Reseda|lutea|Reseda lutea L.	1
Ptyonoprogne rupestris (Scopoli, 1769)	Animalia|Chordata|Aves|Passeriformes|Hirundinidae|Ptyonoprogne|rupestris|Ptyonoprogne rupestris (Scopoli, 1769)	1
Coccinula quatuordecimpustulata (L., 1758)	Animalia|Arthropoda|Insecta|Coleoptera|Coccinellidae|Coccinula|quatuordecimpustulata|Coccinula quatuordecimpustulata (L., 1758)	1
Gonioctena Chevrolat, 1836	Animalia|Arthropoda|Insecta|Coleoptera|Chrysomelidae|Gonioctena||Gonioctena Chevrolat, 1836	1
Linum tenuifolium L.	Plantae|Tracheophyta|Magnoliopsida|Malpighiales|Linaceae|Linum|tenuifolium|Linum tenuifolium L.	1
Lunaria rediviva L.	Plantae|Tracheophyta|Magnoliopsida|Brassicales|Brassicaceae|Lunaria|rediviva|Lunaria rediviva L.	1
Cardamine bulbifera (L.) Crantz	Plantae|Tracheophyta|Magnoliopsida|Brassicales|Brassicaceae|Cardamine|bulbifera|Cardamine bulbifera (L.) Crantz	1
Sedum atratum L.	Plantae|Tracheophyta|Magnoliopsida|Saxifragales|Crassulaceae|Sedum|atratum|Sedum atratum L.	1
Helleborus odorus Waldst. & Kit. ex Willd.	Plantae|Tracheophyta|Magnoliopsida|Ranunculales|Ranunculaceae|Helleborus|odorus|Helleborus odorus Waldst. & Kit. ex Willd.	1
Pseudopanthera macularia Linnaeus, 1758	Animalia|Arthropoda|Insecta|Lepidoptera|Geometridae|Pseudopanthera|macularia|Pseudopanthera macularia Linnaeus, 1758	1
Pyrrhocorax pyrrhocorax (Linnaeus, 1758)	Animalia|Chordata|Aves|Passeriformes|Corvidae|Pyrrhocorax|pyrrhocorax|Pyrrhocorax pyrrhocorax (Linnaeus, 1758)	1
Vaccinites archiaci (Munier-Chalmas, 1892)	Animalia|Mollusca|Bivalvia||Hippuritidae|Vaccinites|archiaci|Vaccinites archiaci (Munier-Chalmas, 1892)	1
Caloplaca dalmatica (A. Massal.) H. Olivier	Fungi|Ascomycota|Lecanoromycetes|Teloschistales|Teloschistaceae|Caloplaca|dalmatica|Caloplaca dalmatica (A. Massal.) H. Olivier	1
Melanelixia glabra (Schaer.) O. Blanco, A. Crespo, Divakar, Essl., D. Hawksw. & Lumbsch	Fungi|Ascomycota|Lecanoromycetes|Lecanorales|Parmeliaceae|Melanelixia|glabra|Melanelixia glabra (Schaer.) O. Blanco, A. Crespo, Divakar, Essl., D. Hawksw. & Lumbsch	1
Anchusa undulata L.	Plantae|Tracheophyta|Magnoliopsida|Boraginales|Boraginaceae|Anchusa|undulata|Anchusa undulata L.	1
Endococcus Nyl.	Fungi|Ascomycota|Dothideomycetes|||Endococcus||Endococcus Nyl.	1
Lamium garganicum L.	Plantae|Magnoliophyta|Magnoliopsida|Lamiales|Lamiaceae|Lamium|garganicum|Lamium garganicum L.	1
Lamium maculatum (L.) L.	Plantae|Tracheophyta|Magnoliopsida|Lamiales|Lamiaceae|Lamium|maculatum|Lamium maculatum (L.) L.	1
Orchidaceae Juss.	Plantae|Magnoliophyta|Liliopsida|Asparagales|Orchidaceae|||Orchidaceae Juss.	1
Hypogymnia physodes (L.) Nyl., 1896	Fungi|Ascomycota|Lecanoromycetes|Lecanorales|Parmeliaceae|Hypogymnia|physodes|Hypogymnia physodes (L.) Nyl., 1896	1
Dactylorhiza cordigera (Fr.) Soó	Plantae|Tracheophyta|Liliopsida|Asparagales|Orchidaceae|Dactylorhiza|cordigera|Dactylorhiza cordigera (Fr.) Soó	1
Hypogymnia physodes (L.) Nyl.	Fungi|Ascomycota|Lecanoromycetes|Lecanorales|Parmeliaceae|Hypogymnia|physodes|Hypogymnia physodes (L.) Nyl.	1
Hepatica nobilis Schreb.	Plantae|Magnoliophyta|Magnoliopsida|Ranunculales|Ranunculaceae|Anemone|nobilis|Hepatica nobilis Schreb.	1
Lapeirousia Bayle, 1878	Animalia|Mollusca|Bivalvia||Radiolitidae|Lapeirousia||Lapeirousia Bayle, 1878	1
Pinus mugo Turra	Plantae|Pinophyta|Pinopsida|Pinales|Pinaceae|Pinus|mugo|Pinus mugo Turra	1
Lecanora agardhiana Ach.	Fungi|Ascomycota|Lecanoromycetes|Lecanorales|Lecanoraceae|Lecanora|agardhiana|Lecanora agardhiana Ach.	1
Bubo bubo (Linnaeus, 1758)	Animalia|Chordata|Aves|Strigiformes|Strigidae|Bubo|bubo|Bubo bubo (Linnaeus, 1758)	1
Erodium cicutarium	Plantae|Tracheophyta|Magnoliopsida|Geraniales|Geraniaceae|Erodium|cicutarium|Erodium cicutarium	1
Rhizocarpon ferax H. Magn.	Fungi|Ascomycota|Lecanoromycetes|Lecanorales|Rhizocarpaceae|Rhizocarpon|ferax|Rhizocarpon ferax H. Magn.	1
Certhia brachydactyla C. L. Brehm, 1820	Animalia|Chordata|Aves|Passeriformes|Certhiidae|Certhia|brachydactyla|Certhia brachydactyla C. L. Brehm, 1820	1
Carduus nutans Boiss. ex Nyman	Plantae|Tracheophyta|Magnoliopsida|Asterales|Asteraceae|Carduus|nutans|Carduus nutans Boiss. ex Nyman	1
Tringa ochropus Linnaeus, 1758	Animalia|Chordata|Aves|Charadriiformes|Scolopacidae|Tringa|ochropus|Tringa ochropus Linnaeus, 1758	1
Gallinago gallinago (Linnaeus, 1758)	Animalia|Chordata|Aves|Charadriiformes|Scolopacidae|Gallinago|gallinago|Gallinago gallinago (Linnaeus, 1758)	1
Onobrychis alba (Waldst. & Kit.) Desv.	Plantae|Tracheophyta|Magnoliopsida|Fabales|Fabaceae|Onobrychis|alba|Onobrychis alba (Waldst. & Kit.) Desv.	1
Geranium lucidum L.	Plantae|Magnoliophyta|Magnoliopsida|Geraniales|Geraniaceae|Geranium|lucidum|Geranium lucidum L.	1
Alchemilla velebitica (Janch.) Degen	Plantae|Tracheophyta|Magnoliopsida|Rosales|Rosaceae|Alchemilla|velebitica|Alchemilla velebitica (Janch.) Degen	1
Trifolium fragiferum L.	Plantae|Magnoliophyta|Magnoliopsida|Fabales|Fabaceae|Trifolium|fragiferum|Trifolium fragiferum L.	1
Aythya ferina (Linnaeus, 1758)	Animalia|Chordata|Aves|Anseriformes|Anatidae|Aythya|ferina|Aythya ferina (Linnaeus, 1758)	1
Geranium sanguineum L.	Plantae|Magnoliophyta|Magnoliopsida|Geraniales|Geraniaceae|Geranium|sanguineum|Geranium sanguineum L.	1
Lacertidae Bonaparte, 1831	Animalia|Chordata|Reptilia|Squamata|Lacertidae|||Lacertidae Bonaparte, 1831	1
Primula veris Linnaeus	Plantae|Tracheophyta|Magnoliopsida|Ericales|Primulaceae|Primula|veris|Primula veris Linnaeus	1
Stellaria holostea L.	Plantae|Magnoliophyta|Magnoliopsida|Caryophyllales|Caryophyllaceae|Stellaria|holostea|Stellaria holostea L.	1
Inachis io (Linnaeus, 1758)	Animalia|Arthropoda|Insecta|Lepidoptera|Nymphalidae|Aglais|io|Inachis io (Linnaeus, 1758)	1
Sesleria coerulans Friv.	Plantae|Magnoliophyta|Liliopsida|Poales|Poaceae|Sesleria|coerulans|Sesleria coerulans Friv.	1
Agrostemma githago L.	Plantae|Magnoliophyta|Magnoliopsida|Caryophyllales|Caryophyllaceae|Agrostemma|githago|Agrostemma githago L.	1
Traunsteinera globosa (L.) Rchb.	Plantae|Tracheophyta|Liliopsida|Asparagales|Orchidaceae|Traunsteinera|globosa|Traunsteinera globosa (L.) Rchb.	1
Hippolais pallida (Hemprich & Ehrenberg, 1833)	Animalia|Chordata|Aves|Passeriformes|Acrocephalidae|Iduna|pallida|Hippolais pallida (Hemprich & Ehrenberg, 1833)	1
Fumana procumbens (Dunal) Gren. & Godr.	Plantae|Tracheophyta|Magnoliopsida|Malvales|Cistaceae|Fumana|procumbens|Fumana procumbens (Dunal) Gren. & Godr.	1
Coccinula quatuordecimpustulata (Linnaeus, 1758)	Animalia|Arthropoda|Insecta|Coleoptera|Coccinellidae|Coccinula|quatuordecimpustulata|Coccinula quatuordecimpustulata (Linnaeus, 1758)	1
Asparagus tenuifolius Lam.	Plantae|Magnoliophyta|Liliopsida|Asparagales|Asparagaceae|Asparagus|tenuifolius|Asparagus tenuifolius Lam.	1
Alchemilla L.	Plantae|Magnoliophyta|Magnoliopsida|Rosales|Rosaceae|Alchemilla||Alchemilla L.	1
Tyta luctuosa Schiffermüller, 1776	Animalia|Arthropoda|Insecta|Lepidoptera|Noctuidae|Tyta|luctuosa|Tyta luctuosa Schiffermüller, 1776	1
Megaspora verrucosa var. mutabilis (Ach.) Nimis & Cl. Roux	Fungi|Ascomycota|Lecanoromycetes|Pertusariales|Megasporaceae|Megaspora|verrucosa|Megaspora verrucosa var. mutabilis (Ach.) Nimis & Cl. Roux	1
Xanthoria contortuplicata (Ach.) Boistel	Fungi|Ascomycota|Lecanoromycetes|Teloschistales|Teloschistaceae|Xanthoria|contortuplicata|Xanthoria contortuplicata (Ach.) Boistel	1
Melilotus officinalis (L.) Pall.	Plantae|Tracheophyta|Magnoliopsida|Fabales|Fabaceae|Melilotus|officinalis|Melilotus officinalis (L.) Pall.	1
Pulmonaria mollis Wolff ex Heller	Plantae|Magnoliophyta|Magnoliopsida|Boraginales|Boraginaceae|Pulmonaria|mollis|Pulmonaria mollis Wolff ex Heller	1
Ophrys holoserica (Burm. f.) Greuter	Plantae|Tracheophyta|Liliopsida|Asparagales|Orchidaceae|Ophrys|holoserica|Ophrys holoserica (Burm. f.) Greuter	1
Colutea arborescens L.	Plantae|Tracheophyta|Magnoliopsida|Fabales|Fabaceae|Colutea|arborescens|Colutea arborescens L.	1
Potentilla recta L.	Plantae|Magnoliophyta|Magnoliopsida|Rosales|Rosaceae|Potentilla|recta|Potentilla recta L.	1
Veronica prostrata L.	Plantae|Magnoliophyta|Magnoliopsida|Lamiales|Plantaginaceae|Veronica|prostrata|Veronica prostrata L.	1
Endococcus Nyl.	Fungi|Ascomycota|Dothideomycetes|Dothideales||Endococcus||Endococcus Nyl.	1
Tephromela atra (Huds.) Hafellner, 1983	Fungi|Ascomycota|Lecanoromycetes|Lecanorales|Mycoblastaceae|Tephromela|atra|Tephromela atra (Huds.) Hafellner, 1983	1
Phylloscopus collybita (Vieillot, 1817)	Animalia|Chordata|Aves|Passeriformes|Sylviidae|Phylloscopus|collybita|Phylloscopus collybita (Vieillot, 1817)	1
Euphorbia amygdaloides L.	Plantae|Tracheophyta|Magnoliopsida|Malpighiales|Euphorbiaceae|Euphorbia|amygdaloides|Euphorbia amygdaloides L.	1
Lamium garganicum L.	Plantae|Tracheophyta|Magnoliopsida|Lamiales|Lamiaceae|Lamium|garganicum|Lamium garganicum L.	1
Peucedanum officinale L.	Plantae|Tracheophyta|Magnoliopsida|Apiales|Apiaceae|Peucedanum|officinale|Peucedanum officinale L.	1
Cyclamen graecum Link	Plantae|Magnoliophyta|Magnoliopsida|Ericales|Primulaceae|Cyclamen|graecum|Cyclamen graecum Link	1
Allium sphaerocephalon L.	Plantae|Tracheophyta|Liliopsida|Asparagales|Amaryllidaceae|Allium|sphaerocephalon|Allium sphaerocephalon L.	1
Cynoglossum officinale L.	Plantae|Tracheophyta|Magnoliopsida|Boraginales|Boraginaceae|Cynoglossum|officinale|Cynoglossum officinale L.	1
Alyssum bertolonii Desv.	Plantae|Magnoliophyta|Magnoliopsida|Brassicales|Brassicaceae|Alyssum|bertolonii|Alyssum bertolonii Desv.	1
Anchusa undulata L.	Plantae|Magnoliophyta|Magnoliopsida|Boraginales|Boraginaceae|Anchusa|undulata|Anchusa undulata L.	1
Lecania fuscella (Schaer.) A. Massal.	Fungi|Ascomycota|Lecanoromycetes|Lecanorales|Ramalinaceae|Lecania|fuscella|Lecania fuscella (Schaer.) A. Massal.	1
Iris sibirica L.	Plantae|Tracheophyta|Liliopsida|Asparagales|Iridaceae|Iris|sibirica|Iris sibirica L.	1
Thlaspi perfoliatum L.	Plantae|Tracheophyta|Magnoliopsida|Brassicales|Brassicaceae|Microthlaspi|perfoliatum|Thlaspi perfoliatum L.	1
Carduelis spinus (Linnaeus, 1758)	Animalia|Chordata|Aves|Passeriformes|Fringillidae|Spinus|spinus|Carduelis spinus (Linnaeus, 1758)	1
Anchusa L.	Plantae|Tracheophyta|Magnoliopsida|Boraginales|Boraginaceae|Anchusa||Anchusa L.	1
Traunsteinera globosa (L.) Rchb.	Plantae|Magnoliophyta|Liliopsida|Asparagales|Orchidaceae|Traunsteinera|globosa|Traunsteinera globosa (L.) Rchb.	1
Ranunculus ficaria L.	Plantae|Tracheophyta|Magnoliopsida|Ranunculales|Ranunculaceae|Ranunculus|ficaria|Ranunculus ficaria L.	1
Caloplaca australis (Arnold) Zahlbr.	Fungi|Ascomycota|Lecanoromycetes|Teloschistales|Teloschistaceae|Caloplaca|australis|Caloplaca australis (Arnold) Zahlbr.	1
Meandrospira Loeblich & Tappan, 1946	Chromista|Foraminifera|Tubothalamea|Miliolida|Cornuspiridae|Meandrospira||Meandrospira Loeblich & Tappan, 1946	1
Trifolium fragiferum L.	Plantae|Tracheophyta|Magnoliopsida|Fabales|Fabaceae|Trifolium|fragiferum|Trifolium fragiferum L.	1
Limodorum abortivum (L.) Sw.	Plantae|Tracheophyta|Liliopsida|Asparagales|Orchidaceae|Limodorum|abortivum|Limodorum abortivum (L.) Sw.	1
Euphorbia amygdaloides L.	Plantae|Magnoliophyta|Magnoliopsida|Malpighiales|Euphorbiaceae|Euphorbia|amygdaloides|Euphorbia amygdaloides L.	1
Brintesia circe (Fabricius, 1775)	Animalia|Arthropoda|Insecta|Lepidoptera|Nymphalidae|Brintesia|circe|Brintesia circe (Fabricius, 1775)	1
Alchemilla catachnoa Rothm.	Plantae|Tracheophyta|Magnoliopsida|Rosales|Rosaceae|Alchemilla|catachnoa|Alchemilla catachnoa Rothm.	1
Pulmonaria officinalis L.	Plantae|Tracheophyta|Magnoliopsida|Boraginales|Boraginaceae|Pulmonaria|officinalis|Pulmonaria officinalis L.	1
Colutea arborescens L.	Plantae|Magnoliophyta|Magnoliopsida|Fabales|Fabaceae|Colutea|arborescens|Colutea arborescens L.	1
Peltigera praetextata (Flörke ex Sommerf.) Zopf	Fungi|Ascomycota|Lecanoromycetes|Peltigerales|Peltigeraceae|Peltigera|praetextata|Peltigera praetextata (Flörke ex Sommerf.) Zopf	1
Veronica chamaedrys L.	Plantae|Magnoliophyta|Magnoliopsida|Lamiales|Plantaginaceae|Veronica|chamaedrys|Veronica chamaedrys L.	1
Primula J. Hill, 1756	Plantae|Magnoliophyta|Magnoliopsida|Ericales|Primulaceae|Primula||Primula J. Hill, 1756	1
Quercus cerris L.	Plantae|Tracheophyta|Magnoliopsida|Fagales|Fagaceae|Quercus|cerris|Quercus cerris L.	1
Aremonia agrimonoides (L.) DC.	Plantae|Magnoliophyta|Magnoliopsida|Rosales|Rosaceae|Aremonia|agrimonoides|Aremonia agrimonoides (L.) DC.	1
Gnaptor spinimanus (Pallas, 1781)	Animalia|Arthropoda|Insecta|Coleoptera|Tenebrionidae|Gnaptor|spinimanus|Gnaptor spinimanus (Pallas, 1781)	1
Cladonia coccifera (L.) Willd.	Fungi|Ascomycota|Lecanoromycetes|Lecanorales|Cladoniaceae|Cladonia|coccifera|Cladonia coccifera (L.) Willd.	1
Lithospermum arvense Thunb.	Plantae|Tracheophyta|Magnoliopsida|Boraginales|Boraginaceae|Lithospermum|arvense|Lithospermum arvense Thunb.	1
Corydalis cava Schweigg. & Kort.	Plantae|Magnoliophyta|Magnoliopsida|Ranunculales|Papaveraceae|Corydalis|cava|Corydalis cava Schweigg. & Kort.	1
Lamium maculatum L.	Plantae|Magnoliophyta|Magnoliopsida|Lamiales|Lamiaceae|Lamium|maculatum|Lamium maculatum L.	1
Jasione laevis subsp. orbiculata	Plantae|Magnoliophyta|Magnoliopsida|Asterales|Campanulaceae|Jasione|laevis|Jasione laevis subsp. orbiculata	1
Paeonia peregrina Miller	Plantae|Tracheophyta|Magnoliopsida|Saxifragales|Paeoniaceae|Paeonia|peregrina|Paeonia peregrina Miller	1
Lepidium campestre (L.) W.T. Aiton	Plantae|Magnoliophyta|Magnoliopsida|Brassicales|Brassicaceae|Lepidium|campestre|Lepidium campestre (L.) W.T. Aiton	1
Lamium purpureum L.	Plantae|Magnoliophyta|Magnoliopsida|Lamiales|Lamiaceae|Lamium|purpureum|Lamium purpureum L.	1
Alchemilla serbica (Paulin) Pawl.	Plantae|Tracheophyta|Magnoliopsida|Rosales|Rosaceae|Alchemilla|serbica|Alchemilla serbica (Paulin) Pawl.	1
Vinca herbacea Waldst. & Kit.	Plantae|Tracheophyta|Magnoliopsida|Gentianales|Apocynaceae|Vinca|herbacea|Vinca herbacea Waldst. & Kit.	1
Vicia lutea L.	Plantae|Magnoliophyta|Magnoliopsida|Fabales|Fabaceae|Vicia|lutea|Vicia lutea L.	1
Toninia A. Massal.	Fungi|Ascomycota|Lecanoromycetes|Lecanorales|Ramalinaceae|Toninia||Toninia A. Massal.	1
Veronica serpyllifolia var. serpyllifolia	Plantae|Magnoliophyta|Magnoliopsida|Lamiales|Plantaginaceae|Veronica|serpyllifolia|Veronica serpyllifolia var. serpyllifolia	1
Melilotus officinalis (L.) Pall.	Plantae|Magnoliophyta|Magnoliopsida|Fabales|Fabaceae|Melilotus|officinalis|Melilotus officinalis (L.) Pall.	1
Lepraria alpina var. alpina (B. de Lesd.) Tretiach & Baruffo	Fungi|Ascomycota|Lecanoromycetes|Lecanorales|Stereocaulaceae|Lepraria|alpina|Lepraria alpina var. alpina (B. de Lesd.) Tretiach & Baruffo	1
Trifolium pannonicum Jacq.	Plantae|Tracheophyta|Magnoliopsida|Fabales|Fabaceae|Trifolium|pannonicum|Trifolium pannonicum Jacq.	1
Larus canus Linnaeus, 1758	Animalia|Chordata|Aves|Charadriiformes|Laridae|Larus|canus|Larus canus Linnaeus, 1758	1
Spinacia oleracea L.	Plantae|Tracheophyta|Magnoliopsida|Caryophyllales|Amaranthaceae|Spinacia|oleracea|Spinacia oleracea L.	1
Onobrychis viciifolia Scop.	Plantae|Magnoliophyta|Magnoliopsida|Fabales|Fabaceae|Onobrychis|viciifolia|Onobrychis viciifolia Scop.	1
Lappula squarrosa (Retz.) Dumort.	Plantae|Magnoliophyta|Magnoliopsida|Boraginales|Boraginaceae|Lappula|squarrosa|Lappula squarrosa (Retz.) Dumort.	1
Chrysolina herbacea (Duftschmid, 1825)	Animalia|Arthropoda|Insecta|Coleoptera|Chrysomelidae|Chrysolina|herbacea|Chrysolina herbacea (Duftschmid, 1825)	1
Onosma pseudoarenaria Schur	Plantae|Tracheophyta|Magnoliopsida|Boraginales|Boraginaceae|Onosma|pseudoarenaria|Onosma pseudoarenaria Schur	1
Androsace komovensis Schönsw. & Schneew.	Plantae|Tracheophyta|Magnoliopsida|Ericales|Primulaceae|Androsace|komovensis|Androsace komovensis Schönsw. & Schneew.	1
Medicago arabica (L.) Huds.	Plantae|Magnoliophyta|Magnoliopsida|Fabales|Fabaceae|Medicago|arabica|Medicago arabica (L.) Huds.	1
Veronica officinalis L.	Plantae|Magnoliophyta|Magnoliopsida|Lamiales|Plantaginaceae|Veronica|officinalis|Veronica officinalis L.	1
Cardamine enneaphyllos (L.) Crantz	Plantae|Magnoliophyta|Magnoliopsida|Brassicales|Brassicaceae|Cardamine|enneaphyllos|Cardamine enneaphyllos (L.) Crantz	1
Polyblastia albida Arnold	Fungi|Ascomycota|Eurotiomycetes|Verrucariales|Verrucariaceae|Polyblastia|albida|Polyblastia albida Arnold	1
Tragopogon orientalis L.	Plantae|Magnoliophyta|Magnoliopsida|Asterales|Asteraceae|Tragopogon|orientalis|Tragopogon orientalis L.	1
Lappula squarrosa (Retz.) Dumort.	Plantae|Tracheophyta|Magnoliopsida|Boraginales|Boraginaceae|Lappula|squarrosa|Lappula squarrosa (Retz.) Dumort.	1
Pimpinella major Huds.	Plantae|Tracheophyta|Magnoliopsida|Apiales|Apiaceae|Pimpinella|major|Pimpinella major Huds.	1
Alyssum markgrafii O.E. Schulz ex Markgr.	Plantae|Magnoliophyta|Magnoliopsida|Brassicales|Brassicaceae|Alyssum|markgrafii|Alyssum markgrafii O.E. Schulz ex Markgr.	1
Cyclamen graecum Link	Plantae|Tracheophyta|Magnoliopsida|Ericales|Primulaceae|Cyclamen|graecum|Cyclamen graecum Link	1
Alchemilla acutiloba Opiz	Plantae|Tracheophyta|Magnoliopsida|Rosales|Rosaceae|Alchemilla|acutiloba|Alchemilla acutiloba Opiz	1
Araneus diadematus Clerck, 1757	Animalia|Arthropoda|Arachnida|Araneae|Araneidae|Araneus|diadematus|Araneus diadematus Clerck, 1757	1
Cornus mas L.	Plantae|Magnoliophyta|Magnoliopsida|Cornales|Cornaceae|Cornus|mas|Cornus mas L.	1
Trifolium montanum L.	Plantae|Magnoliophyta|Magnoliopsida|Fabales|Fabaceae|Trifolium|montanum|Trifolium montanum L.	1
Poecile montanus (Conrad von Baldenstein, 1827)	Animalia|Chordata|Aves|Passeriformes|Paridae|Poecile|montanus|Poecile montanus (Conrad von Baldenstein, 1827)	1
Bellis perennis L.	Plantae|Magnoliophyta|Magnoliopsida|Asterales|Asteraceae|Bellis|perennis|Bellis perennis L.	1
Vicia grandiflora Scop.	Plantae|Tracheophyta|Magnoliopsida|Fabales|Fabaceae|Vicia|grandiflora|Vicia grandiflora Scop.	1
Sedum atratum Bast.	Plantae|Magnoliophyta|Magnoliopsida|Saxifragales|Crassulaceae|Sedum|atratum|Sedum atratum Bast.	1
Polypodium vulgare L.	Plantae|Tracheophyta|Polypodiopsida|Polypodiales|Polypodiaceae|Polypodium|vulgare|Polypodium vulgare L.	1
Geranium lucidum L.	Plantae|Tracheophyta|Magnoliopsida|Geraniales|Geraniaceae|Geranium|lucidum|Geranium lucidum L.	1
Bulgarica O. Boettger, 1877	Animalia|Mollusca|Gastropoda|Stylommatophora|Clausiliidae|Bulgarica||Bulgarica O. Boettger, 1877	1
Lecanora semipallida H. Magn.	Fungi|Ascomycota|Lecanoromycetes|Lecanorales|Lecanoraceae|Lecanora|semipallida|Lecanora semipallida H. Magn.	1
Pulmonaria officinalis L.	Plantae|Magnoliophyta|Magnoliopsida|Boraginales|Boraginaceae|Pulmonaria|officinalis|Pulmonaria officinalis L.	1
Erodium cicutarium (L.) L'Hér. ex Ait.	Plantae|Magnoliophyta|Magnoliopsida|Geraniales|Geraniaceae|Erodium|cicutarium|Erodium cicutarium (L.) L'Hér. ex Ait.	1
Vicia pannonica Crantz	Plantae|Tracheophyta|Magnoliopsida|Fabales|Fabaceae|Vicia|pannonica|Vicia pannonica Crantz	1
Seseli L.	Plantae|Tracheophyta|Magnoliopsida|Apiales|Apiaceae|Seseli||Seseli L.	1
Thamnogalla crombiei (Mudd) D. Hawksw., 1980	Fungi|Ascomycota||||Thamnogalla|crombiei|Thamnogalla crombiei (Mudd) D. Hawksw., 1980	1
Oedipoda caerulescens (Linnaeus, 1758)	Animalia|Arthropoda|Insecta|Orthoptera|Acrididae|Oedipoda|caerulescens|Oedipoda caerulescens (Linnaeus, 1758)	1
Caloplaca ammiospila (Ach.) H. Olivier	Fungi|Ascomycota|Lecanoromycetes|Teloschistales|Teloschistaceae|Caloplaca|ammiospila|Caloplaca ammiospila (Ach.) H. Olivier	1
Euphorbia glabriflora Vis.	Plantae|Magnoliophyta|Magnoliopsida|Malpighiales|Euphorbiaceae|Euphorbia|glabriflora|Euphorbia glabriflora Vis.	1
Zebrina Held, 1837	Animalia|Mollusca|Gastropoda|Stylommatophora|Enidae|Zebrina||Zebrina Held, 1837	1
Saxicola torquatus (Linnaeus, 1766)	Animalia|Chordata|Aves|Passeriformes|Muscicapidae|Saxicola|torquatus|Saxicola torquatus (Linnaeus, 1766)	1
Prunella collaris (Scopoli, 1769)	Animalia|Chordata|Aves|Passeriformes|Prunellidae|Prunella|collaris|Prunella collaris (Scopoli, 1769)	1
Tussilago farfara L.	Plantae|Tracheophyta|Magnoliopsida|Asterales|Asteraceae|Tussilago|farfara|Tussilago farfara L.	1
Crex crex (Linnaeus, 1758)	Animalia|Chordata|Aves|Gruiformes|Rallidae|Crex|crex|Crex crex (Linnaeus, 1758)	1
Melilotus albus Medik.	Plantae|Tracheophyta|Magnoliopsida|Fabales|Fabaceae|Melilotus|albus|Melilotus albus Medik.	1
Veronica austriaca subsp. jacquinii (Baumg.) Eb.Fisch.	Plantae|Magnoliophyta|Magnoliopsida|Lamiales|Plantaginaceae|Veronica|austriaca|Veronica austriaca subsp. jacquinii (Baumg.) Eb.Fisch.	1
Parentucellia latifolia	Plantae|Tracheophyta|Magnoliopsida|Lamiales|Orobanchaceae|Parentucellia|latifolia|Parentucellia latifolia	1
Grimmia anomala Schimp.	Plantae|Bryophyta|Bryopsida|Grimmiales|Grimmiaceae|Grimmia|anomala|Grimmia anomala Schimp.	1
Anthemis cretica (L.) Nyman	Plantae|Tracheophyta|Magnoliopsida|Asterales|Asteraceae|Anthemis|cretica|Anthemis cretica (L.) Nyman	1
Phaeostigma notata (Fabricius, 1781)	Animalia|Arthropoda|Insecta|Raphidioptera|Raphidiidae|Phaeostigma|notata|Phaeostigma notata (Fabricius, 1781)	1
Stellaria holostea L.	Plantae|Tracheophyta|Magnoliopsida|Caryophyllales|Caryophyllaceae|Stellaria|holostea|Stellaria holostea L.	1
Trifolium ochroleucon Huds.	Plantae|Magnoliophyta|Magnoliopsida|Fabales|Fabaceae|Trifolium|ochroleucon|Trifolium ochroleucon Huds.	1
Eryngium campestre L.	Plantae|Tracheophyta|Magnoliopsida|Apiales|Apiaceae|Eryngium|campestre|Eryngium campestre L.	1
Fragaria vesca L.	Plantae|Tracheophyta|Magnoliopsida|Rosales|Rosaceae|Fragaria|vesca|Fragaria vesca L.	1
Veronica serpyllifolia subsp. serpyllifolia	Plantae|Tracheophyta|Magnoliopsida|Lamiales|Plantaginaceae|Veronica|serpyllifolia|Veronica serpyllifolia subsp. serpyllifolia	1
Medicago falcata L.	Plantae|Tracheophyta|Magnoliopsida|Fabales|Fabaceae|Medicago|falcata|Medicago falcata L.	1
Astrantia major L.	Plantae|Tracheophyta|Magnoliopsida|Apiales|Apiaceae|Astrantia|major|Astrantia major L.	1
Vaccinites vredenburgi Kuehn, 1932	Animalia|Mollusca|Bivalvia||Hippuritidae|Vaccinites|vredenburgi|Vaccinites vredenburgi Kuehn, 1932	1
Medicago lupulina L.	Plantae|Tracheophyta|Magnoliopsida|Fabales|Fabaceae|Medicago|lupulina|Medicago lupulina L.	1
Paraceratites Hyatt in Eastman-Zittel, 1900	Animalia|Mollusca|Cephalopoda||Ceratitidae|Paraceratites||Paraceratites Hyatt in Eastman-Zittel, 1900	1
Asplenium ceterach L.	Plantae|Pteridophyta|Polypodiopsida|Polypodiales|Aspleniaceae|Asplenium|ceterach|Asplenium ceterach L.	1
Hippurites colliciatus	Animalia|Mollusca|Bivalvia||Hippuritidae|Hippurites|colliciatus|Hippurites colliciatus	1
Ena subtilis (Rossmassler, 1837)	Animalia|Mollusca|Gastropoda|Pulmonata|Enidae|Ena|subtilis|Ena subtilis (Rossmassler, 1837)	1
Platycleis ebneri ebneri (Ramme, 1926)	Animalia|Arthropoda|Insecta|Orthoptera|Tettigoniidae|Platycleis|ebneri|Platycleis ebneri ebneri (Ramme, 1926)	1
Salvia argentea L.	Plantae|Tracheophyta|Magnoliopsida|Lamiales|Lamiaceae|Salvia|argentea|Salvia argentea L.	1
Orobanche gracilis Sm.	Plantae|Tracheophyta|Magnoliopsida|Lamiales|Orobanchaceae|Orobanche|gracilis|Orobanche gracilis Sm.	1
Oenanthe hispanica (Linnaeus, 1758)	Animalia|Chordata|Aves|Passeriformes|Muscicapidae|Oenanthe|hispanica|Oenanthe hispanica (Linnaeus, 1758)	1
Helleborus odorus Waldst. & Kit. ex Willd.	Plantae|Magnoliophyta|Magnoliopsida|Ranunculales|Ranunculaceae|Helleborus|odorus|Helleborus odorus Waldst. & Kit. ex Willd.	1
Scilla bifolia L.	Plantae|Tracheophyta|Liliopsida|Asparagales|Asparagaceae|Scilla|bifolia|Scilla bifolia L.	1
Silene vulgaris (Moench) Garcke	Plantae|Tracheophyta|Magnoliopsida|Caryophyllales|Caryophyllaceae|Silene|vulgaris|Silene vulgaris (Moench) Garcke	1
Sylvia cantillans (Pallas, 1764)	Animalia|Chordata|Aves|Passeriformes|Sylviidae|Sylvia|cantillans|Sylvia cantillans (Pallas, 1764)	1
Parentucellia latifolia (L.) Caruel	Plantae|Magnoliophyta|Magnoliopsida|Lamiales|Orobanchaceae|Parentucellia|latifolia|Parentucellia latifolia (L.) Caruel	1
Medicago lupulina L.	Plantae|Magnoliophyta|Magnoliopsida|Fabales|Fabaceae|Medicago|lupulina|Medicago lupulina L.	1
Helleborus viridis L.	Plantae|Tracheophyta|Magnoliopsida|Ranunculales|Ranunculaceae|Helleborus|viridis|Helleborus viridis L.	1
Anthemis cretica (L.) Nyman	Plantae|Magnoliophyta|Magnoliopsida|Asterales|Asteraceae|Anthemis|cretica|Anthemis cretica (L.) Nyman	1
Natrix tessellata Laurenti, 1768	Animalia|Chordata|Reptilia|Squamata|Colubridae|Natrix|tessellata|Natrix tessellata Laurenti, 1768	1
Lacerta viridis (Laurenti, 1768)	Animalia|Chordata|Reptilia|Squamata|Lacertidae|Lacerta|viridis|Lacerta viridis (Laurenti, 1768)	1
Ctenophthalmus Kolenati, 1857	Animalia|Arthropoda|Insecta|Siphonaptera|Hystrichopsyllidae|Ctenophthalmus||Ctenophthalmus Kolenati, 1857	1
Alchemilla xanthochlora Rothm.	Plantae|Tracheophyta|Magnoliopsida|Rosales|Rosaceae|Alchemilla|xanthochlora|Alchemilla xanthochlora Rothm.	1
Pyrrhocorax graculus (Linnaeus, 1766)	Animalia|Chordata|Aves|Passeriformes|Corvidae|Pyrrhocorax|graculus|Pyrrhocorax graculus (Linnaeus, 1766)	1
Vicia pannonica Crantz	Plantae|Magnoliophyta|Magnoliopsida|Fabales|Fabaceae|Vicia|pannonica|Vicia pannonica Crantz	1
Lacerta viridis Laurenti, 1768	Animalia|Chordata|Reptilia|Squamata|Lacertidae|Lacerta|viridis|Lacerta viridis Laurenti, 1768	1
Motacilla flava Linnaeus, 1758	Animalia|Chordata|Aves|Passeriformes|Motacillidae|Motacilla|flava|Motacilla flava Linnaeus, 1758	1
Orlaya grandiflora (L.) Hoffm.	Plantae|Tracheophyta|Magnoliopsida|Apiales|Apiaceae|Orlaya|grandiflora|Orlaya grandiflora (L.) Hoffm.	1
Adonis flammea Jacq.	Plantae|Tracheophyta|Magnoliopsida|Ranunculales|Ranunculaceae|Adonis|flammea|Adonis flammea Jacq.	1
Helix Linnaeus, 1758	Animalia|Mollusca|Gastropoda|Stylommatophora|Helicidae|Helix||Helix Linnaeus, 1758	1
Anchusa azurea Mill.	Plantae|Magnoliophyta|Magnoliopsida|Boraginales|Boraginaceae|Anchusa|azurea|Anchusa azurea Mill.	1
Pinus heldreichii H. Christ	Plantae|Tracheophyta|Pinopsida|Pinales|Pinaceae|Pinus|heldreichii|Pinus heldreichii H. Christ	1
Fumaria officinalis L.	Plantae|Tracheophyta|Magnoliopsida|Ranunculales|Papaveraceae|Fumaria|officinalis|Fumaria officinalis L.	1
Acrocephalus scirpaceus (Hermann, 1804)	Animalia|Chordata|Aves|Passeriformes|Acrocephalidae|Acrocephalus|scirpaceus|Acrocephalus scirpaceus (Hermann, 1804)	1
Caloplaca cerina (Ehrh. ex Hedw.) Th. Fr., 1861	Fungi|Ascomycota|Lecanoromycetes|Teloschistales|Teloschistaceae|Caloplaca|cerina|Caloplaca cerina (Ehrh. ex Hedw.) Th. Fr., 1861	1
Lathraea squamaria L.	Plantae|Tracheophyta|Magnoliopsida|Lamiales|Orobanchaceae|Lathraea|squamaria|Lathraea squamaria L.	1
Vaccinites vesiculosus (Woodward, 1855)	Animalia|Mollusca|Bivalvia||Hippuritidae|Vaccinites|vesiculosus|Vaccinites vesiculosus (Woodward, 1855)	1
Athene noctua (Scopoli, 1769)	Animalia|Chordata|Aves|Strigiformes|Strigidae|Athene|noctua|Athene noctua (Scopoli, 1769)	1
Dryopteris villarii	Plantae|Pteridophyta|Polypodiopsida|Polypodiales|Dryopteridaceae|Dryopteris|villarii|Dryopteris villarii	1
Scolopax rusticola Linnaeus, 1758	Animalia|Chordata|Aves|Charadriiformes|Scolopacidae|Scolopax|rusticola|Scolopax rusticola Linnaeus, 1758	1
Tussilago farfara L.	Plantae|Magnoliophyta|Magnoliopsida|Asterales|Asteraceae|Tussilago|farfara|Tussilago farfara L.	1
Hordeum vulgare subsp. vulgare	Plantae|Tracheophyta|Liliopsida|Poales|Poaceae|Hordeum|vulgare|Hordeum vulgare subsp. vulgare	1
Vaccinites sulcatus Defrance, 1821	Animalia|Mollusca|Bivalvia||Hippuritidae|Vaccinites|sulcatus|Vaccinites sulcatus Defrance, 1821	1
Leontodon autumnalis L.	Plantae|Tracheophyta|Magnoliopsida|Asterales|Asteraceae|Scorzoneroides|autumnalis|Leontodon autumnalis L.	1
Natrix tessellata (Laurenti, 1768)	Animalia|Chordata|Reptilia|Squamata|Colubridae|Natrix|tessellata|Natrix tessellata (Laurenti, 1768)	1
Tragopogon orientalis L.	Plantae|Tracheophyta|Magnoliopsida|Asterales|Asteraceae|Tragopogon|orientalis|Tragopogon orientalis L.	1
Halacsya sendtneri (Boiss.) Dörfl.	Plantae|Tracheophyta|Magnoliopsida|Boraginales|Boraginaceae|Halacsya|sendtneri|Halacsya sendtneri (Boiss.) Dörfl.	1
Xanthoparmelia stenophylla (Ach.) Ahti & D. Hawksw.	Fungi|Ascomycota|Lecanoromycetes|Lecanorales|Parmeliaceae|Xanthoparmelia|stenophylla|Xanthoparmelia stenophylla (Ach.) Ahti & D. Hawksw.	1
Dactylorhiza majalis (Rchb.) P.F.Hunt & Summerh.	Plantae|Tracheophyta|Liliopsida|Asparagales|Orchidaceae|Dactylorhiza|majalis|Dactylorhiza majalis (Rchb.) P.F.Hunt & Summerh.	1
Juniperus communis L.	Plantae|Tracheophyta|Pinopsida|Pinales|Cupressaceae|Juniperus|communis|Juniperus communis L.	1
Zygaena loti Denis & Schiffermüller, 1775	Animalia|Arthropoda|Insecta|Lepidoptera|Zygaenidae|Zygaena|loti|Zygaena loti Denis & Schiffermüller, 1775	1
Juniperus communis var. communis	Plantae|Pinophyta|Pinopsida|Pinales|Cupressaceae|Juniperus|communis|Juniperus communis var. communis	1
Carlina acaulis L. subsp. acaulis	Plantae|Magnoliophyta|Magnoliopsida|Asterales|Asteraceae|Carlina|acaulis|Carlina acaulis L. subsp. acaulis	1
Campanula scheuchzeri Vill.	Plantae|Tracheophyta|Magnoliopsida|Asterales|Campanulaceae|Campanula|scheuchzeri|Campanula scheuchzeri Vill.	1
Senecio nemorensis L.	Plantae|Tracheophyta|Magnoliopsida|Asterales|Asteraceae|Senecio|nemorensis|Senecio nemorensis L.	1
Lecanora semipallida H.Magn	Fungi|Ascomycota|Lecanoromycetes|Lecanorales|Lecanoraceae|Lecanora|semipallida|Lecanora semipallida H.Magn	1
Rumex L.	Plantae|Tracheophyta|Magnoliopsida|Caryophyllales|Polygonaceae|Rumex||Rumex L.	1
Parmeliopsis hyperopta (Ach.) Arnold	Fungi|Ascomycota|Lecanoromycetes|Lecanorales|Parmeliaceae|Parmeliopsis|hyperopta|Parmeliopsis hyperopta (Ach.) Arnold	1
Hyoscyamus reticulatus L.	Plantae|Tracheophyta|Magnoliopsida|Solanales|Solanaceae|Hyoscyamus|reticulatus|Hyoscyamus reticulatus L.	1
Bonasa bonasia (Linnaeus, 1758)	Animalia|Chordata|Aves|Galliformes|Phasianidae|Tetrastes|bonasia|Bonasa bonasia (Linnaeus, 1758)	1
Asplenium ceterach L.	Plantae|Tracheophyta|Polypodiopsida|Polypodiales|Aspleniaceae|Asplenium|ceterach|Asplenium ceterach L.	1
Cladonia coccifera (L.) Willd., 1787	Fungi|Ascomycota|Lecanoromycetes|Lecanorales|Cladoniaceae|Cladonia|coccifera|Cladonia coccifera (L.) Willd., 1787	1
Lecanora marginata (Schaer.) Hertel & Rambold	Fungi|Ascomycota|Lecanoromycetes|Lecanorales|Lecanoraceae|Lecanora|marginata|Lecanora marginata (Schaer.) Hertel & Rambold	1
Caloplaca sinapisperma (Lam. & DC.) Maheu & Gillet	Fungi|Ascomycota|Lecanoromycetes|Teloschistales|Teloschistaceae|Caloplaca|sinapisperma|Caloplaca sinapisperma (Lam. & DC.) Maheu & Gillet	1
Toninia A.Massal.	Fungi|Ascomycota|Lecanoromycetes|Lecanorales|Ramalinaceae|Toninia||Toninia A.Massal.	1
Daonella moussoni (Merian, 1853)	Animalia|Mollusca|Bivalvia|Pterioida|Halobiidae|Daonella|moussoni|Daonella moussoni (Merian, 1853)	1
Diaphora mendica (Clerck, 1759)	Animalia|Arthropoda|Insecta|Lepidoptera|Arctiidae|Diaphora|mendica|Diaphora mendica (Clerck, 1759)	1
Trifolium incarnatum L.	Plantae|Tracheophyta|Magnoliopsida|Fabales|Fabaceae|Trifolium|incarnatum|Trifolium incarnatum L.	1
Periparus ater (Linnaeus, 1758)	Animalia|Chordata|Aves|Passeriformes|Paridae|Periparus|ater|Periparus ater (Linnaeus, 1758)	1
Rhizocarpon alpicola (Anzi) Rabenh.	Fungi|Ascomycota|Lecanoromycetes|Lecanorales|Rhizocarpaceae|Rhizocarpon|alpicola|Rhizocarpon alpicola (Anzi) Rabenh.	1
Milvus migrans (Boddaert, 1783)	Animalia|Chordata|Aves|Accipitriformes|Accipitridae|Milvus|migrans|Milvus migrans (Boddaert, 1783)	1
Bryonora castanea var. castanea	Fungi|Ascomycota|Lecanoromycetes|Lecanorales|Lecanoraceae|Bryonora|castanea|Bryonora castanea var. castanea	1
Trifolium resupinatum L.	Plantae|Tracheophyta|Magnoliopsida|Fabales|Fabaceae|Trifolium|resupinatum|Trifolium resupinatum L.	1
Pinus mugo Turra	Plantae|Tracheophyta|Pinopsida|Pinales|Pinaceae|Pinus|mugo|Pinus mugo Turra	1
Caloplaca sinapisperma (Lam. & DC.) Maheu & A. Gillet	Fungi|Ascomycota|Lecanoromycetes|Teloschistales|Teloschistaceae|Caloplaca|sinapisperma|Caloplaca sinapisperma (Lam. & DC.) Maheu & A. Gillet	1
Morimus asper funereus Mulsant, 1862	Animalia|Arthropoda|Insecta|Coleoptera|Cerambycidae|Morimus|asper|Morimus asper funereus Mulsant, 1862	1
Plantago media L.	Plantae|Tracheophyta|Magnoliopsida|Lamiales|Plantaginaceae|Plantago|media|Plantago media L.	1
Daonella Mojsisovics, 1874	Animalia|Mollusca|Bivalvia||Myalinidae|Daonella||Daonella Mojsisovics, 1874	1
Pimpinella major (L.) Huds.	Plantae|Magnoliophyta|Magnoliopsida|Apiales|Apiaceae|Pimpinella|major|Pimpinella major (L.) Huds.	1
Lapeirousia zitteli Douvillé, 1913	Animalia|Mollusca|Bivalvia||Radiolitidae|Lapeirousia|zitteli|Lapeirousia zitteli Douvillé, 1913	1
Vicia sativa L.	Plantae|Tracheophyta|Magnoliopsida|Fabales|Fabaceae|Vicia|sativa|Vicia sativa L.	1
Lycaena phlaeas (Linnaeus, 1761)	Animalia|Arthropoda|Insecta|Lepidoptera|Lycaenidae|Lycaena|phlaeas|Lycaena phlaeas (Linnaeus, 1761)	1
Fraxinus ornus L.	Plantae|Tracheophyta|Magnoliopsida|Lamiales|Oleaceae|Fraxinus|ornus|Fraxinus ornus L.	1
Platanthera bifolia (L.) Rich.	Plantae|Tracheophyta|Liliopsida|Asparagales|Orchidaceae|Platanthera|bifolia|Platanthera bifolia (L.) Rich.	1
Veronica austriaca subsp. jacquinii (Baumg.) Eb. Fischer	Plantae|Tracheophyta|Magnoliopsida|Lamiales|Plantaginaceae|Veronica|austriaca|Veronica austriaca subsp. jacquinii (Baumg.) Eb. Fischer	1
Foeniculum vulgare Mill.	Plantae|Tracheophyta|Magnoliopsida|Apiales|Apiaceae|Foeniculum|vulgare|Foeniculum vulgare Mill.	1
Hyoscyamus reticulatus L.	Plantae|Magnoliophyta|Magnoliopsida|Solanales|Solanaceae|Hyoscyamus|reticulatus|Hyoscyamus reticulatus L.	1
Chrysolina herbacea (Duft., 1825)	Animalia|Arthropoda|Insecta|Coleoptera|Chrysomelidae|Chrysolina|herbacea|Chrysolina herbacea (Duft., 1825)	1
Hieraaetus pennatus (Gmelin, 1788)	Animalia|Chordata|Aves|Accipitriformes|Accipitridae|Hieraaetus|pennatus|Hieraaetus pennatus (Gmelin, 1788)	1
Spinacia oleracea L.	Plantae|Magnoliophyta|Magnoliopsida|Caryophyllales|Chenopodiaceae|Spinacia|oleracea|Spinacia oleracea L.	1
Bryoria fuscescens (Gyeln.) Brodo & D. Hawksw.	Fungi|Ascomycota|Lecanoromycetes|Lecanorales|Parmeliaceae|Bryoria|fuscescens|Bryoria fuscescens (Gyeln.) Brodo & D. Hawksw.	1
Inula conyza (Griess.) DC.	Plantae|Tracheophyta|Magnoliopsida|Asterales|Asteraceae|Inula|conyza|Inula conyza (Griess.) DC.	1
Melilotus albus Medik.	Plantae|Magnoliophyta|Magnoliopsida|Fabales|Fabaceae|Melilotus|albus|Melilotus albus Medik.	1
Phoenicurus ochruros subsp. gibraltariensis (J.F. Gmelin, 1789)	Animalia|Chordata|Aves|Passeriformes|Muscicapidae|Phoenicurus|ochruros|Phoenicurus ochruros subsp. gibraltariensis (J.F. Gmelin, 1789)	1
Silene italica (L.) Pers.	Plantae|Tracheophyta|Magnoliopsida|Caryophyllales|Caryophyllaceae|Silene|italica|Silene italica (L.) Pers.	1
Meandrospira Loeblich & Tappan, 1946	Chromista||||Cornuspiridae|Meandrospira||Meandrospira Loeblich & Tappan, 1946	1
Anthyllis vulneraria L.	Plantae|Magnoliophyta|Magnoliopsida|Fabales|Fabaceae|Anthyllis|vulneraria|Anthyllis vulneraria L.	1
Alchemilla heterotricha Rothm.	Plantae|Tracheophyta|Magnoliopsida|Rosales|Rosaceae|Alchemilla|heterotricha|Alchemilla heterotricha Rothm.	1
Salvia argentea L.	Plantae|Magnoliophyta|Magnoliopsida|Lamiales|Lamiaceae|Salvia|argentea|Salvia argentea L.	1
Coenagrion puella Linnaeus, 1758	Animalia|Arthropoda|Insecta|Odonata|Coenagrionidae|Coenagrion|puella|Coenagrion puella Linnaeus, 1758	1
Lecidea silacea (Hoffm.) Ach.	Fungi|Ascomycota|Lecanoromycetes|Lecanorales|Lecideaceae|Lecidea|silacea|Lecidea silacea (Hoffm.) Ach.	1
Filipendula vulgaris Moench	Plantae|Tracheophyta|Magnoliopsida|Rosales|Rosaceae|Filipendula|vulgaris|Filipendula vulgaris Moench	1
Diaphora mendica (Clerck, 1759)	Animalia|Arthropoda|Insecta|Lepidoptera|Arctiidae|Spilosoma|mendica|Diaphora mendica (Clerck, 1759)	1
Caloplaca cerina (Ehrh. ex Hedw.) Th.Fr.	Fungi|Ascomycota|Lecanoromycetes|Teloschistales|Teloschistaceae|Caloplaca|cerina|Caloplaca cerina (Ehrh. ex Hedw.) Th.Fr.	1
Quercus cerris L.	Plantae|Magnoliophyta|Magnoliopsida|Fagales|Fagaceae|Quercus|cerris|Quercus cerris L.	1
Hepatica nobilis Schreb.	Plantae|Tracheophyta|Magnoliopsida|Ranunculales|Ranunculaceae|Hepatica|nobilis|Hepatica nobilis Schreb.	1
Aethionema saxatile (L.) W.T. Aiton	Plantae|Magnoliophyta|Magnoliopsida|Brassicales|Brassicaceae|Aethionema|saxatile|Aethionema saxatile (L.) W.T. Aiton	1
Caloplaca australis (Arnold) Zahlbr.	Fungi|Ascomycota|Lecanoromycetes|Teloschistales|Teloschistaceae|Fulgensia|australis|Caloplaca australis (Arnold) Zahlbr.	1
Euclidia glyphica Linnaeus, 1758	Animalia|Arthropoda|Insecta|Lepidoptera|Noctuidae|Euclidia|glyphica|Euclidia glyphica Linnaeus, 1758	1
Viola elatior Fries	Plantae|Tracheophyta|Magnoliopsida|Malpighiales|Violaceae|Viola|elatior|Viola elatior Fries	1
Fraxinus ornus L.	Plantae|Magnoliophyta|Magnoliopsida|Lamiales|Oleaceae|Fraxinus|ornus|Fraxinus ornus L.	1
Parnassia palustris L.	Plantae|Tracheophyta|Magnoliopsida|Celastrales|Celastraceae|Parnassia|palustris|Parnassia palustris L.	1
Rosaceae	Plantae|Tracheophyta|Magnoliopsida|Rosales|Rosaceae|||Rosaceae	1
Daphne mezereum L.	Plantae|Tracheophyta|Magnoliopsida|Malvales|Thymelaeaceae|Daphne|mezereum|Daphne mezereum L.	1
Cornu aspersum (O. F. Müller, 1774)	Animalia|Mollusca|Gastropoda|Stylommatophora|Helicidae|Helix|aspersum|Cornu aspersum (O. F. Müller, 1774)	1
Origanum vulgare L.	Plantae|Tracheophyta|Magnoliopsida|Lamiales|Lamiaceae|Origanum|vulgare|Origanum vulgare L.	1
Arum italicum Mill.	Plantae|Tracheophyta|Liliopsida|Alismatales|Araceae|Arum|italicum|Arum italicum Mill.	1
Cornus mas L.	Plantae|Tracheophyta|Magnoliopsida|Cornales|Cornaceae|Cornus|mas|Cornus mas L.	1
Dryopteris villarii (Bell) Woynar ex Schinz & Thell.	Plantae|Tracheophyta|Polypodiopsida|Polypodiales|Dryopteridaceae|Dryopteris|villarii|Dryopteris villarii (Bell) Woynar ex Schinz & Thell.	1
Scopula ornata Scopoli, 1793	Animalia|Arthropoda|Insecta|Lepidoptera|Geometridae|Scopula|ornata|Scopula ornata Scopoli, 1793	1
Peucedanum officinale L.	Plantae|Magnoliophyta|Magnoliopsida|Apiales|Apiaceae|Peucedanum|officinale|Peucedanum officinale L.	1
Celastrina argiolus Linnaeus, 1758	Animalia|Arthropoda|Insecta|Lepidoptera|Lycaenidae|Celastrina|argiolus|Celastrina argiolus Linnaeus, 1758	1
Agrostemma githago L.	Plantae|Tracheophyta|Magnoliopsida|Caryophyllales|Caryophyllaceae|Agrostemma|githago|Agrostemma githago L.	1
Alliaria petiolata (M.Bieb.) Cavara & Grande	Plantae|Tracheophyta|Magnoliopsida|Brassicales|Brassicaceae|Alliaria|petiolata|Alliaria petiolata (M.Bieb.) Cavara & Grande	1
Primula vulgaris Huds.	Plantae|Magnoliophyta|Magnoliopsida|Ericales|Primulaceae|Primula|vulgaris|Primula vulgaris Huds.	1
Hirundo daurica Linnaeus, 1771	Animalia|Chordata|Aves|Passeriformes|Hirundinidae|Cecropis|daurica|Hirundo daurica Linnaeus, 1771	1
Adonis flammea Schleich. ex Steud.	Plantae|Magnoliophyta|Magnoliopsida|Ranunculales|Ranunculaceae|Adonis|flammea|Adonis flammea Schleich. ex Steud.	1
Passer hispaniolensis (Temminck, 1820)	Animalia|Chordata|Aves|Passeriformes|Passeridae|Passer|hispaniolensis|Passer hispaniolensis (Temminck, 1820)	1
Parus palustris Linnaeus, 1758	Animalia|Chordata|Aves|Passeriformes|Paridae|Parus|palustris|Parus palustris Linnaeus, 1758	1
Cladonia P. Browne	Fungi|Ascomycota|Lecanoromycetes|Lecanorales|Cladoniaceae|Cladonia||Cladonia P. Browne	1
Linaria vulgaris Mill.	Plantae|Tracheophyta|Magnoliopsida|Lamiales|Plantaginaceae|Linaria|vulgaris|Linaria vulgaris Mill.	1
Erigeron L.	Plantae|Tracheophyta|Magnoliopsida|Asterales|Asteraceae|Erigeron||Erigeron L.	1
Lycaena phlaeas Linnaeus, 1761	Animalia|Arthropoda|Insecta|Lepidoptera|Lycaenidae|Lycaena|phlaeas|Lycaena phlaeas Linnaeus, 1761	1
Physa acuta Draparnaud, 1805	Animalia|Mollusca|Gastropoda|Basommatophora|Physidae|Physella|acuta|Physa acuta Draparnaud, 1805	1
Cataglyphis nodus (Brullé, 1832)	Animalia|Arthropoda|Insecta|Hymenoptera|Formicidae|Cataglyphis|nodus|Cataglyphis nodus (Brullé, 1832)	1
Juniperus communis L.	Plantae|Pinophyta|Pinopsida|Pinales|Cupressaceae|Juniperus|communis|Juniperus communis L.	1
Montifringilla nivalis (Linnaeus, 1766)	Animalia|Chordata|Aves|Passeriformes|Passeridae|Montifringilla|nivalis|Montifringilla nivalis (Linnaeus, 1766)	1
Hypericum rumeliacum Boiss.	Plantae|Tracheophyta|Magnoliopsida|Malpighiales|Hypericaceae|Hypericum|rumeliacum|Hypericum rumeliacum Boiss.	1
Asteraceae	Plantae|Magnoliophyta|Magnoliopsida|Asterales|Asteraceae|Cirsium|Asteraceae	1
Sisyphus schaefferi (Linnaeus, 1758)	Animalia|Arthropoda|Insecta|Coleoptera|Scarabaeidae|Sisyphus|schaefferi|Sisyphus schaefferi (Linnaeus, 1758)	1
Lactuca pancicii (Vis.) N.Kilian & Greuter	Plantae|Tracheophyta|Magnoliopsida|Asterales|Asteraceae|Lactuca|pancicii|Lactuca pancicii (Vis.) N.Kilian & Greuter	1
Aspicilia contorta subsp. hoffmanniana S. Ekman & Fröberg ex R. Sant.	Fungi|Ascomycota|Lecanoromycetes|Pertusariales|Megasporaceae|Aspicilia|contorta|Aspicilia contorta subsp. hoffmanniana S. Ekman & Fröberg ex R. Sant.	1
Chroicocephalus ridibundus (Linnaeus, 1766)	Animalia|Chordata|Aves|Charadriiformes|Laridae|Chroicocephalus|ridibundus|Chroicocephalus ridibundus (Linnaeus, 1766)	1
Ranunculus ficaria L.	Plantae|Magnoliophyta|Magnoliopsida|Ranunculales|Ranunculaceae|Ranunculus|ficaria|Ranunculus ficaria L.	1
Alchemilla serbica (Fritsch) Pawl.	Plantae|Magnoliophyta|Magnoliopsida|Rosales|Rosaceae|Alchemilla|serbica|Alchemilla serbica (Fritsch) Pawl.	1
Orobanche gracilis Bess. ex Ledeb.	Plantae|Magnoliophyta|Magnoliopsida|Lamiales|Orobanchaceae|Orobanche|gracilis|Orobanche gracilis Bess. ex Ledeb.	1
Sesleria coerulans Friv.	Plantae|Tracheophyta|Liliopsida|Poales|Poaceae|Sesleria|coerulans|Sesleria coerulans Friv.	1
Melampyrum arvense L.	Plantae|Magnoliophyta|Magnoliopsida|Lamiales|Orobanchaceae|Melampyrum|arvense|Melampyrum arvense L.	1
Veronica chamaedrys L.	Plantae|Tracheophyta|Magnoliopsida|Lamiales|Plantaginaceae|Veronica|chamaedrys|Veronica chamaedrys L.	1
Phaeostigma notatum (Fabricius, 1781)	Animalia|Arthropoda|Insecta|Raphidioptera|Raphidiidae|Phaeostigma|notatum|Phaeostigma notatum (Fabricius, 1781)	1
Bellis perennis L.	Plantae|Tracheophyta|Magnoliopsida|Asterales|Asteraceae|Bellis|perennis|Bellis perennis L.	1