taxonName	taxonPath	recordCount
Pteronotus parnellii (Gray, 1843)	Animalia|Chordata|Mammalia|Chiroptera|Mormoopidae|Pteronotus|parnellii|Pteronotus parnellii (Gray, 1843)	48
Sturnira lilium (E. Geoffroy, 1810)	Animalia|Chordata|Mammalia|Chiroptera|Phyllostomidae|Sturnira|lilium|Sturnira lilium (E. Geoffroy, 1810)	48
Brachyphylla cavernarum Gray, 1834	Animalia|Chordata|Mammalia|Chiroptera|Phyllostomidae|Brachyphylla|cavernarum|Brachyphylla cavernarum Gray, 1834	44
Artibeus schwartzi Jones, 1978	Animalia|Chordata|Mammalia|Chiroptera|Phyllostomidae|Artibeus|schwartzi|Artibeus schwartzi Jones, 1978	29
Artibeus Leach, 1821	Animalia|Chordata|Mammalia|Chiroptera|Phyllostomidae|Artibeus||Artibeus Leach, 1821	29
Glossophaga longirostris Miller, 1898	Animalia|Chordata|Mammalia|Chiroptera|Phyllostomidae|Glossophaga|longirostris|Glossophaga longirostris Miller, 1898	26
Monophyllus plethodon Miller, 1900	Animalia|Chordata|Mammalia|Chiroptera|Phyllostomidae|Monophyllus|plethodon|Monophyllus plethodon Miller, 1900	26
Wasmannia auropunctata (Roger, 1863)	Animalia|Arthropoda|Insecta|Hymenoptera|Formicidae|Wasmannia|auropunctata|Wasmannia auropunctata (Roger, 1863)	22
Eulampis jugularis (Linnaeus, 1766)	Animalia|Chordata|Aves|Apodiformes|Trochilidae|Eulampis|jugularis|Eulampis jugularis (Linnaeus, 1766)	21
Prionopelta antillana Forel, 1909	Animalia|Arthropoda|Insecta|Hymenoptera|Formicidae|Prionopelta|antillana|Prionopelta antillana Forel, 1909	20
Catharopeza bishopi (Lawrence, 1878)	Animalia|Chordata|Aves|Passeriformes|Parulidae|Catharopeza|bishopi|Catharopeza bishopi (Lawrence, 1878)	19
Ardops nichollsi (Thomas, 1891)	Animalia|Chordata|Mammalia|Chiroptera|Phyllostomidae|Ardops|nichollsi|Ardops nichollsi (Thomas, 1891)	18
Elaenia flavogaster (Thunberg, 1822)	Animalia|Chordata|Aves|Passeriformes|Tyrannidae|Elaenia|flavogaster|Elaenia flavogaster (Thunberg, 1822)	17
Orthorhyncus cristatus subsp. ornatus Gould, 1861	Animalia|Chordata|Aves|Apodiformes|Trochilidae|Orthorhyncus|cristatus|Orthorhyncus cristatus subsp. ornatus Gould, 1861	16
Allenia fusca (M端ller, 1776)	Animalia|Chordata|Aves|Passeriformes|Mimidae|Allenia|fusca|Allenia fusca (M端ller, 1776)	15
Pilotrichum procerum Mitten, 1869	Plantae|Bryophyta|Bryopsida|Hookeriales|Daltoniaceae|Pilotrichum|procerum|Pilotrichum procerum Mitten, 1869	14
Pheidole Westwood, 1839	Animalia|Arthropoda|Insecta|Hymenoptera|Formicidae|Pheidole||Pheidole Westwood, 1839	13
Cinclocerthia ruficauda (Gould, 1836)	Animalia|Chordata|Aves|Passeriformes|Mimidae|Cinclocerthia|ruficauda|Cinclocerthia ruficauda (Gould, 1836)	13
Coereba flaveola (Linnaeus, 1758)	Animalia|Chordata|Aves|Passeriformes|Coerebidae|Coereba|flaveola|Coereba flaveola (Linnaeus, 1758)	13
Cyphomyrmex minutus Mayr, 1862	Animalia|Arthropoda|Insecta|Hymenoptera|Formicidae|Cyphomyrmex|minutus|Cyphomyrmex minutus Mayr, 1862	12
Macromitrium perichaetiale C. M端ller, 1845	Plantae|Bryophyta|Bryopsida|Orthotrichales|Orthotrichaceae|Macromitrium|perichaetiale|Macromitrium perichaetiale C. M端ller, 1845	12
Homalothecium luteolum Jaeger, 1878	Plantae|Bryophyta|Bryopsida|Hypnales|Brachytheciaceae|Homalothecium|luteolum|Homalothecium luteolum Jaeger, 1878	12
Pheidole moerens Wheeler, 1908	Animalia|Arthropoda|Insecta|Hymenoptera|Formicidae|Pheidole|moerens|Pheidole moerens Wheeler, 1908	12
Bubulcus ibis (Linnaeus, 1758)	Animalia|Chordata|Aves|Pelecaniformes|Ardeidae|Bubulcus|ibis|Bubulcus ibis (Linnaeus, 1758)	10
Leucomium strumosum Mitten, 1869	Plantae|Bryophyta|Bryopsida|Hypnales|Hypnaceae|Leucomium|strumosum|Leucomium strumosum Mitten, 1869	10
Pheidole antillana	Animalia|Arthropoda|Insecta|Hymenoptera|Formicidae|Pheidole|antillana|Pheidole antillana	9
Elaenia flavogaster subsp. flavogaster	Animalia|Chordata|Aves|Passeriformes|Tyrannidae|Elaenia|flavogaster|Elaenia flavogaster subsp. flavogaster	9
Loxigilla noctis (Linnaeus, 1766)	Animalia|Chordata|Aves|Passeriformes|Emberizidae|Loxigilla|noctis|Loxigilla noctis (Linnaeus, 1766)	9
Elaenia flavogaster flavogaster	Animalia|Chordata|Aves|Passeriformes|Tyrannidae|Elaenia|flavogaster|Elaenia flavogaster flavogaster	9
Anochetus mayri Emery, 1884	Animalia|Arthropoda|Insecta|Hymenoptera|Formicidae|Anochetus|mayri|Anochetus mayri Emery, 1884	8
Pilotrichum divaricatum Mitten, 1869	Plantae|Bryophyta|Bryopsida|Hookeriales|Daltoniaceae|Pilotrichum|divaricatum|Pilotrichum divaricatum Mitten, 1869	8
Solenopsis geminata (Fabricius, 1804)	Animalia|Arthropoda|Insecta|Hymenoptera|Formicidae|Solenopsis|geminata|Solenopsis geminata (Fabricius, 1804)	8
Orthorhyncus cristatus ornatus Gould, 1861	Animalia|Chordata|Aves|Apodiformes|Trochilidae|Orthorhyncus|cristatus|Orthorhyncus cristatus ornatus Gould, 1861	8
Micronycteris Gray, 1866	Animalia|Chordata|Mammalia|Chiroptera|Phyllostomidae|Micronycteris||Micronycteris Gray, 1866	8
Columbina passerina (Linnaeus, 1758)	Animalia|Chordata|Aves|Columbiformes|Columbidae|Columbina|passerina|Columbina passerina (Linnaeus, 1758)	8
Tangara cucullata (Swainson, 1834)	Animalia|Chordata|Aves|Passeriformes|Thraupidae|Tangara|cucullata|Tangara cucullata (Swainson, 1834)	8
Argia concinna Rambur, 1842	Animalia|Arthropoda|Insecta|Odonata|Coenagrionidae|Argia|concinna|Argia concinna Rambur, 1842	8
Allenia fusca (Statius Muller, 1776)	Animalia|Chordata|Aves|Passeriformes|Mimidae|Allenia|fusca|Allenia fusca (Statius Muller, 1776)	8
Turdus nudigenis Lafresnaye, 1848	Animalia|Chordata|Aves|Passeriformes|Turdidae|Turdus|nudigenis|Turdus nudigenis Lafresnaye, 1848	7
Loxigilla noctis subsp. crissalis (Ridgway, 1898)	Animalia|Chordata|Aves|Passeriformes|Thraupidae|Loxigilla|noctis|Loxigilla noctis subsp. crissalis (Ridgway, 1898)	7
Loxigilla noctis crissalis (Ridgway, 1898)	Animalia|Chordata|Aves|Passeriformes|Emberizidae|Loxigilla|noctis|Loxigilla noctis crissalis (Ridgway, 1898)	7
Cinclocerthia ruficauda subsp. tenebrosa	Animalia|Chordata|Aves|Passeriformes|Mimidae|Cinclocerthia|ruficauda|Cinclocerthia ruficauda subsp. tenebrosa	7
Cinclocerthia ruficauda tenebrosa	Animalia|Chordata|Aves|Passeriformes|Mimidae|Cinclocerthia|ruficauda|Cinclocerthia ruficauda tenebrosa	7
Crotophaga ani Linnaeus, 1758	Animalia|Chordata|Aves|Cuculiformes|Cuculidae|Crotophaga|ani|Crotophaga ani Linnaeus, 1758	7
Buteogallus anthracinus (Deppe, 1830)	Animalia|Chordata|Aves|Accipitriformes|Accipitridae|Buteogallus|anthracinus|Buteogallus anthracinus (Deppe, 1830)	6
Fregata magnificens Mathews, 1914	Animalia|Chordata|Aves|Suliformes|Fregatidae|Fregata|magnificens|Fregata magnificens Mathews, 1914	6
Tyrannus dominicensis (Gmelin, 1788)	Animalia|Chordata|Aves|Passeriformes|Tyrannidae|Tyrannus|dominicensis|Tyrannus dominicensis (Gmelin, 1788)	6
Myadestes genibarbis Swainson, 1838	Animalia|Chordata|Aves|Passeriformes|Turdidae|Myadestes|genibarbis|Myadestes genibarbis Swainson, 1838	6
Amazona guildingii (Vigors, 1837)	Animalia|Chordata|Aves|Psittaciformes|Psittacidae|Amazona|guildingii|Amazona guildingii (Vigors, 1837)	6
Zenaida auriculata (Des Murs, 1847)	Animalia|Chordata|Aves|Columbiformes|Columbidae|Zenaida|auriculata|Zenaida auriculata (Des Murs, 1847)	6
Strumigenys rogeri Emery, 1890	Animalia|Arthropoda|Insecta|Hymenoptera|Formicidae|Strumigenys|rogeri|Strumigenys rogeri Emery, 1890	6
Camponotus conspicuus subsp. sharpi Forel, 1893	Animalia|Arthropoda|Insecta|Hymenoptera|Formicidae|Camponotus|conspicuus|Camponotus conspicuus subsp. sharpi Forel, 1893	6
Camponotus conspicuus sharpi Forel, 1893	Animalia|Arthropoda|Insecta|Hymenoptera|Formicidae|Camponotus|conspicuus|Camponotus conspicuus sharpi Forel, 1893	6
Plagiochila rutilans Lindenb.	Plantae|Marchantiophyta|Jungermanniopsida|Jungermanniales|Plagiochilaceae|Plagiochila|rutilans|Plagiochila rutilans Lindenb.	5
Tiaris bicolor (Linnaeus, 1766)	Animalia|Chordata|Aves|Passeriformes|Emberizidae|Tiaris|bicolor|Tiaris bicolor (Linnaeus, 1766)	5
Elaenia martinica (Linnaeus, 1766)	Animalia|Chordata|Aves|Passeriformes|Tyrannidae|Elaenia|martinica|Elaenia martinica (Linnaeus, 1766)	5
Toxorhynchites Theobald, 1901	Animalia|Arthropoda|Insecta|Diptera|Culicidae|Toxorhynchites||Toxorhynchites Theobald, 1901	4
Buteo platypterus (Vieillot, 1823)	Animalia|Chordata|Aves|Accipitriformes|Accipitridae|Buteo|platypterus|Buteo platypterus (Vieillot, 1823)	4
Wyeomyia Theobald, 1901	Animalia|Arthropoda|Insecta|Diptera|Culicidae|Wyeomyia||Wyeomyia Theobald, 1901	4
Artibeus jamaicensis Leach, 1821	Animalia|Chordata|Mammalia|Chiroptera|Phyllostomidae|Artibeus|jamaicensis|Artibeus jamaicensis Leach, 1821	4
Vireo altiloquus (Vieillot, 1808)	Animalia|Chordata|Aves|Passeriformes|Vireonidae|Vireo|altiloquus|Vireo altiloquus (Vieillot, 1808)	4
Danaea nodosa (L.) Sm.	Plantae|Tracheophyta|Marattiopsida|Marattiales|Marattiaceae|Danaea|nodosa|Danaea nodosa (L.) Sm.	4
Linepithema iniquum (Mayr, 1870)	Animalia|Arthropoda|Insecta|Hymenoptera|Formicidae|Linepithema|iniquum|Linepithema iniquum (Mayr, 1870)	4
Danaea alata Sm.	Plantae|Tracheophyta|Marattiopsida|Marattiales|Marattiaceae|Danaea|alata|Danaea alata Sm.	4
Roccella tinctoria DC.	Fungi|Ascomycota|Arthoniomycetes|Arthoniales|Roccellaceae|Rocella|tinctoria|Roccella tinctoria DC.	4
Sicydium plumieri (Bloch, 1786)	Animalia|Chordata|Actinopterygii|Perciformes|Gobiidae|Sicydium|plumieri|Sicydium plumieri (Bloch, 1786)	4
Pheidole jelskii	Animalia|Arthropoda|Insecta|Hymenoptera|Formicidae|Pheidole|jelskii|Pheidole jelskii	4
Cyclolejeunea convexistipa (Lehm. & Lindenb.) A.Evans	Plantae|Marchantiophyta|Jungermanniopsida|Porellales|Lejeuneaceae|Cyclolejeunea|convexistipa|Cyclolejeunea convexistipa (Lehm. & Lindenb.) A.Evans	4
Quiscalus lugubris Swainson, 1838	Animalia|Chordata|Aves|Passeriformes|Icteridae|Quiscalus|lugubris|Quiscalus lugubris Swainson, 1838	4
Myiarchus nugator Riley, 1904	Animalia|Chordata|Aves|Passeriformes|Tyrannidae|Myiarchus|nugator|Myiarchus nugator Riley, 1904	4
	|||||||	4
Mimus gilvus (Vieillot, 1808)	Animalia|Chordata|Aves|Passeriformes|Mimidae|Mimus|gilvus|Mimus gilvus (Vieillot, 1808)	4
Egretta caerulea (Linnaeus, 1758)	Animalia|Chordata|Aves|Pelecaniformes|Ardeidae|Egretta|caerulea|Egretta caerulea (Linnaeus, 1758)	4
Caloplaca flavorubescens (Huds.) J. R. Laundon	Fungi|Ascomycota|Lecanoromycetes|Teloschistales|Teloschistaceae|Caloplaca|flavorubescens|Caloplaca flavorubescens (Huds.) J. R. Laundon	4
Pyxine coco谷s (Sw.) Nyl.	Fungi|Ascomycota|Lecanoromycetes|Teloschistales|Physciaceae|Pyxine|coco谷s|Pyxine coco谷s (Sw.) Nyl.	4
Toxorhynchites Theobald	Animalia|Arthropoda|Insecta|Diptera|Culicidae|Toxorhynchites||Toxorhynchites Theobald	4
Rattus Fischer, 1803	Animalia|Chordata|Mammalia|Rodentia|Muridae|Rattus||Rattus Fischer, 1803	3
Plagiochila (Dum.) Dum.	Plantae|Marchantiophyta|Jungermanniopsida|Jungermanniales|Plagiochilaceae|Plagiochila||Plagiochila (Dum.) Dum.	3
Parmelia costaricensis Nyl.	Fungi|Ascomycota|Lecanoromycetes|Lecanorales|Parmeliaceae|Remototrachyna|costaricensis|Parmelia costaricensis Nyl.	3
Coereba flaveola atrata (Lawrence, 1878)	Animalia|Chordata|Aves|Passeriformes|Coerebidae|Coereba|flaveola|Coereba flaveola atrata (Lawrence, 1878)	3
Plagiochila tenuis Lindenb.	Plantae|Marchantiophyta|Jungermanniopsida|Jungermanniales|Plagiochilaceae|Plagiochila|tenuis|Plagiochila tenuis Lindenb.	3
Sticherus ferrugineus (Desv.) J.Gonzales	Plantae|Tracheophyta|Polypodiopsida|Gleicheniales|Gleicheniaceae|Sticherus|ferrugineus|Sticherus ferrugineus (Desv.) J.Gonzales	3
Aulacorhynchus sulcatus erythrognathus (Gould, 1874)	Animalia|Chordata|Aves|Piciformes|Ramphastidae|Aulacorhynchus|sulcatus|Aulacorhynchus sulcatus erythrognathus (Gould, 1874)	3
Cyclopogon elatus (Sw.) Schltr.	Plantae|Tracheophyta|Liliopsida|Asparagales|Orchidaceae|Cyclopogon|elatus|Cyclopogon elatus (Sw.) Schltr.	3
Tiaris bicolor (Linnaeus, 1766)	Animalia|Chordata|Aves|Passeriformes|Thraupidae|Tiaris|bicolor|Tiaris bicolor (Linnaeus, 1766)	3
Rattus G. Fischer, 1803	Animalia|Chordata|Mammalia|Rodentia|Muridae|Rattus||Rattus G. Fischer, 1803	3
Aulacorhynchus sulcatus subsp. erythrognathus (Gould, 1874)	Animalia|Chordata|Aves|Piciformes|Ramphastidae|Aulacorhynchus|sulcatus|Aulacorhynchus sulcatus subsp. erythrognathus (Gould, 1874)	3
Ameiva ameiva Linnaeus, 1758	Animalia|Chordata|Reptilia|Squamata|Teiidae|Ameiva|ameiva|Ameiva ameiva Linnaeus, 1758	3
Sticherus K. Presl	Plantae|Pteridophyta|Polypodiopsida|Gleicheniales|Gleicheniaceae|Sticherus||Sticherus K. Presl	3
Coereba flaveola subsp. atrata (Lawrence, 1878)	Animalia|Chordata|Aves|Passeriformes|Coerebidae|Coereba|flaveola|Coereba flaveola subsp. atrata (Lawrence, 1878)	3
Tyrannus dominicensis vorax Vieillot, 1819	Animalia|Chordata|Aves|Passeriformes|Tyrannidae|Tyrannus|dominicensis|Tyrannus dominicensis vorax Vieillot, 1819	2
Chaetura brachyura (Jardine, 1846)	Animalia|Chordata|Aves|Apodiformes|Apodidae|Chaetura|brachyura|Chaetura brachyura (Jardine, 1846)	2
Selaginella rotundifolia Spring	Plantae|Lycopodiophyta|Lycopodiopsida|Selaginellales|Selaginellaceae|Selaginella|rotundifolia|Selaginella rotundifolia Spring	2
Jungermannia unidentata Lehm. & Lindenb.	Plantae|Marchantiophyta|Jungermanniopsida|Porellales|Lejeuneaceae|Diplasiolejeunea|unidentata|Jungermannia unidentata Lehm. & Lindenb.	2
Graphis illinata Eschw.	Fungi|Ascomycota|Lecanoromycetes|Ostropales|Graphidaceae|Graphis|illinata|Graphis illinata Eschw.	2
Eleutherodactylus johnstonei Barbour, 1914	Animalia|Chordata|Amphibia|Anura|Eleutherodactylidae|Eleutherodactylus|johnstonei|Eleutherodactylus johnstonei Barbour, 1914	2
Danaea elliptica Sm.	Plantae|Tracheophyta|Marattiopsida|Marattiales|Marattiaceae|Danaea|elliptica|Danaea elliptica Sm.	2
Meiothecium boryanum Mitten, 1869	Plantae|Bryophyta|Bryopsida|Hypnales|Sematophyllaceae|Meiothecium|boryanum|Meiothecium boryanum Mitten, 1869	2
Tangara cucullata versicolor (Lawrence, 1878)	Animalia|Chordata|Aves|Passeriformes|Thraupidae|Tangara|cucullata|Tangara cucullata versicolor (Lawrence, 1878)	2
Petrea volubilis L.	Plantae|Tracheophyta|Magnoliopsida|Lamiales|Verbenaceae|Petrea|volubilis|Petrea volubilis L.	2
Bulbothrix laevigatula (Nyl.) Hale	Fungi|Ascomycota|Lecanoromycetes|Lecanorales|Parmeliaceae|Bulbothrix|laevigatula|Bulbothrix laevigatula (Nyl.) Hale	2
Gobiesox cephalus Lacep竪de, 1800	Animalia|Chordata|Actinopterygii|Gobiesociformes|Gobiesocidae|Arcos|cephalus|Gobiesox cephalus Lacep竪de, 1800	2
Megalastrum subincisum (Willd.) A. R. Sm. & R. C. Moran	Plantae|Tracheophyta|Polypodiopsida|Polypodiales|Dryopteridaceae|Megalastrum|subincisum|Megalastrum subincisum (Willd.) A. R. Sm. & R. C. Moran	2
Nautilocalyx melittifolius (L.) Wiehler	Plantae|Magnoliophyta|Magnoliopsida|Lamiales|Gesneriaceae|Nautilocalyx|melittifolius|Nautilocalyx melittifolius (L.) Wiehler	2
Pilotrichum affine Bridel, 1827	Plantae|Bryophyta|Bryopsida|Hookeriales|Daltoniaceae|Pilotrichum|affine|Pilotrichum affine Bridel, 1827	2
Blechnum ryanii Hieron.	Plantae|Tracheophyta|Polypodiopsida|Polypodiales|Blechnaceae|Blechnum|ryanii|Blechnum ryanii Hieron.	2
Falco peregrinus Tunstall, 1771	Animalia|Chordata|Aves|Falconiformes|Falconidae|Falco|peregrinus|Falco peregrinus Tunstall, 1771	2
Hemidactylus mabouia Moreau de Jonn竪s, 1818	Animalia|Chordata|Reptilia|Squamata|Gekkonidae|Hemidactylus|mabouia|Hemidactylus mabouia Moreau de Jonn竪s, 1818	2
Tetrazygia discolor (L.) DC.	Plantae|Tracheophyta|Magnoliopsida|Myrtales|Melastomataceae|Tetrazygia|discolor|Tetrazygia discolor (L.) DC.	2
Plagiochila (Dumort.) Dumort.	Plantae|Marchantiophyta|Jungermanniopsida|Jungermanniales|Plagiochilaceae|Plagiochila||Plagiochila (Dumort.) Dumort.	2
Tiaris bicolor omissus Jardine, 1847	Animalia|Chordata|Aves|Passeriformes|Emberizidae|Tiaris|bicolor|Tiaris bicolor omissus Jardine, 1847	2
Vireo altiloquus barbadensis	Animalia|Chordata|Aves|Passeriformes|Vireonidae|Vireo|altiloquus|Vireo altiloquus barbadensis	2
Exostema sanctae-luciae (Kentish) Britten	Plantae|Tracheophyta|Magnoliopsida|Gentianales|Rubiaceae|Exostema|sanctae-luciae|Exostema sanctae-luciae (Kentish) Britten	2
Vireo altiloquus subsp. barbadensis	Animalia|Chordata|Aves|Passeriformes|Vireonidae|Vireo|altiloquus|Vireo altiloquus subsp. barbadensis	2
Marchantia L.	Plantae|Marchantiophyta|Marchantiopsida|Marchantiales|Marchantiaceae|Marchantia||Marchantia L.	2
Monomorium ebeninum Forel, 1891	Animalia|Arthropoda|Insecta|Hymenoptera|Formicidae|Monomorium|ebeninum|Monomorium ebeninum Forel, 1891	2
Rogeria curvipubens Emery, 1894	Animalia|Arthropoda|Insecta|Hymenoptera|Formicidae|Rogeria|curvipubens|Rogeria curvipubens Emery, 1894	2
Leptotrema wightii (Taylor) M端ll. Arg.	Fungi|Ascomycota|Lecanoromycetes|Ostropales|Graphidaceae|Leptotrema|wightii|Leptotrema wightii (Taylor) M端ll. Arg.	2
Chrysophyllum glabrum Jacq.	Plantae|Tracheophyta|Magnoliopsida|Ericales|Sapotaceae|Chrysophyllum|glabrum|Chrysophyllum glabrum Jacq.	2
Arthotheliopsis hymenocarpoides Vain.	Fungi|Ascomycota|Lecanoromycetes|Ostropales|Gomphillaceae|Arthotheliopsis|hymenocarpoides|Arthotheliopsis hymenocarpoides Vain.	2
Tapinoma melanocephalum (Fabricius, 1793)	Animalia|Arthropoda|Insecta|Hymenoptera|Formicidae|Tapinoma|melanocephalum|Tapinoma melanocephalum (Fabricius, 1793)	2
Tangara cucullata subsp. versicolor (Lawrence, 1878)	Animalia|Chordata|Aves|Passeriformes|Thraupidae|Tangara|cucullata|Tangara cucullata subsp. versicolor (Lawrence, 1878)	2
Blechnum ryani Hieron.	Plantae|Pteridophyta|Polypodiopsida|Polypodiales|Blechnaceae|Blechnum|ryani|Blechnum ryani Hieron.	2
Troglodytes aedon Vieillot, 1809	Animalia|Chordata|Aves|Passeriformes|Troglodytidae|Troglodytes|aedon|Troglodytes aedon Vieillot, 1809	2
Paratrechina longicornis (Latreille, 1802)	Animalia|Arthropoda|Insecta|Hymenoptera|Formicidae|Paratrechina|longicornis|Paratrechina longicornis (Latreille, 1802)	2
Exostema sanctae-luciae (Kentish) Britten	Plantae|Magnoliophyta|Magnoliopsida|Gentianales|Rubiaceae|Exostema|sanctae-luciae|Exostema sanctae-luciae (Kentish) Britten	2
Tyrannus dominicensis subsp. vorax Vieillot, 1819	Animalia|Chordata|Aves|Passeriformes|Tyrannidae|Tyrannus|dominicensis|Tyrannus dominicensis subsp. vorax Vieillot, 1819	2
Nautilocalyx melittifolius (L.) Wiehler	Plantae|Tracheophyta|Magnoliopsida|Lamiales|Gesneriaceae|Nautilocalyx|melittifolius|Nautilocalyx melittifolius (L.) Wiehler	2
Etlingera elatior	Plantae|Magnoliophyta|Liliopsida|Zingiberales|Zingiberaceae|Etlingera|Etlingera elatior	2
Dirinaria picta (Swartz) Clem. & Shear	Fungi|Ascomycota|Lecanoromycetes|Teloschistales|Physciaceae|Dirinaria|picta|Dirinaria picta (Swartz) Clem. & Shear	2
Acnistus arborescens (L.) Schltdl.	Plantae|Tracheophyta|Magnoliopsida|Solanales|Solanaceae|Acnistus|arborescens|Acnistus arborescens (L.) Schltdl.	2
Bacidia mollisiaeformis Zahlbr.	Fungi|Ascomycota|Lecanoromycetes|Lecanorales|Ramalinaceae|Bacidia|mollisiaeformis|Bacidia mollisiaeformis Zahlbr.	2
Anthurium cordatum (L.) Schott	Plantae|Magnoliophyta|Liliopsida|Alismatales|Araceae|Anthurium|cordatum|Anthurium cordatum (L.) Schott	2
Anthurium cordatum (L.) Schott	Plantae|Tracheophyta|Liliopsida|Alismatales|Araceae|Anthurium|cordatum|Anthurium cordatum (L.) Schott	2
Chaetura martinica (Hermann, 1783)	Animalia|Chordata|Aves|Apodiformes|Apodidae|Chaetura|martinica|Chaetura martinica (Hermann, 1783)	2
Turdus fumigatus Lichtenstein, 1823	Animalia|Chordata|Aves|Passeriformes|Turdidae|Turdus|fumigatus|Turdus fumigatus Lichtenstein, 1823	2
Ramalina antillarum Vain.	Fungi|Ascomycota|Lecanoromycetes|Lecanorales|Ramalinaceae|Ramalina|antillarum|Ramalina antillarum Vain.	2
Diplazium ambiguum (Sw.) Hook.	Plantae|Pteridophyta|Polypodiopsida|Polypodiales|Athyriaceae|Callipteris|ambiguum|Diplazium ambiguum (Sw.) Hook.	2
Loxigilla noctis (Linnaeus, 1766)	Animalia|Chordata|Aves|Passeriformes|Thraupidae|Loxigilla|noctis|Loxigilla noctis (Linnaeus, 1766)	2
Connarus L.	Plantae|Tracheophyta|Magnoliopsida|Oxalidales|Connaraceae|Connarus||Connarus L.	2
Patagioenas squamosa (Bonnaterre, 1792)	Animalia|Chordata|Aves|Columbiformes|Columbidae|Patagioenas|squamosa|Patagioenas squamosa (Bonnaterre, 1792)	2
Tiaris bicolor subsp. omissus Jardine, 1847	Animalia|Chordata|Aves|Passeriformes|Thraupidae|Tiaris|bicolor|Tiaris bicolor subsp. omissus Jardine, 1847	2
Chiodecton cineritium (Ach.) Vain.	Fungi|Ascomycota|Arthoniomycetes|Arthoniales|Roccellaceae|Chiodecton|cineritium|Chiodecton cineritium (Ach.) Vain.	2
Eleotris gyrinus Valenciennes, 1837	Animalia|Chordata|Actinopterygii|Perciformes|Eleotridae|Eleotris|gyrinus|Eleotris gyrinus Valenciennes, 1837	2
Leucobryum martianum Hampe ex C. M端ller, 1843	Plantae|Bryophyta|Bryopsida|Dicranales|Dicranaceae|Leucobryum|martianum|Leucobryum martianum Hampe ex C. M端ller, 1843	2
Chiodecton cineritium (Ach.) Vainio	Fungi|Ascomycota|Arthoniomycetes|Arthoniales|Roccellaceae|Dichosporidium|cineritium|Chiodecton cineritium (Ach.) Vainio	2
Mugil braziliensis	Animalia|Chordata|Actinopterygii|Mugiliformes|Mugilidae|Mugil|braziliensis|Mugil braziliensis	2
Crematogaster crinosa Mayr, 1862	Animalia|Arthropoda|Insecta|Hymenoptera|Formicidae|Crematogaster|crinosa|Crematogaster crinosa Mayr, 1862	2
Eleutherodactylus shrevei Schwartz, 1967	Animalia|Chordata|Amphibia|Anura|Strabomantidae|Pristimantis|shrevei|Eleutherodactylus shrevei Schwartz, 1967	2
Butorides virescens (Linnaeus, 1758)	Animalia|Chordata|Aves|Pelecaniformes|Ardeidae|Butorides|virescens|Butorides virescens (Linnaeus, 1758)	2
Dirinaria picta (Sw.) Schaer. ex Clem.	Fungi|Ascomycota|Lecanoromycetes|Teloschistales|Physciaceae|Dirinaria|picta|Dirinaria picta (Sw.) Schaer. ex Clem.	2
Lejeunea Lib.	Plantae|Marchantiophyta|Jungermanniopsida|Porellales|Lejeuneaceae|Lejeunea||Lejeunea Lib.	2
Ocellularia fecunda (Vain.) Hale	Fungi|Ascomycota|Lecanoromycetes|Ostropales|Graphidaceae|Ocellularia|fecunda|Ocellularia fecunda (Vain.) Hale	2
Bacidia variabilis (Vain.) Zahlbr.	Fungi|Ascomycota|Lecanoromycetes|Lecanorales|Ramalinaceae|Bacidia|variabilis|Bacidia variabilis (Vain.) Zahlbr.	2
Orthorhyncus cristatus (Linnaeus, 1758)	Animalia|Chordata|Aves|Apodiformes|Trochilidae|Orthorhyncus|cristatus|Orthorhyncus cristatus (Linnaeus, 1758)	2
Gracilaria Greville, 1830	Plantae|Rhodophyta|Florideophyceae|Gracilariales|Gracilariaceae|Gracilaria||Gracilaria Greville, 1830	2
Staurothele acarosporoides Vain.	Fungi|Ascomycota|Eurotiomycetes|Verrucariales|Verrucariaceae|Staurothele|acarosporoides|Staurothele acarosporoides Vain.	2
Plagiochila macrostachya Lindenb.	Plantae|Marchantiophyta|Jungermanniopsida|Jungermanniales|Plagiochilaceae|Plagiochila|macrostachya|Plagiochila macrostachya Lindenb.	2
Diplazium godmanii (Baker) C.Chr.	Plantae|Pteridophyta|Polypodiopsida|Polypodiales|Woodsiaceae|Diplazium|godmanii|Diplazium godmanii (Baker) C.Chr.	2
Croton gossypiifolius var. genuinus M端ll.Arg.	Plantae|Tracheophyta|Magnoliopsida|Malpighiales|Euphorbiaceae|Croton|gossypiifolius|Croton gossypiifolius var. genuinus M端ll.Arg.	2
Rogeria foreli Emery, 1894	Animalia|Arthropoda|Insecta|Hymenoptera|Formicidae|Rogeria|foreli|Rogeria foreli Emery, 1894	2
Molossus molossus (Pallas, 1766)	Animalia|Chordata|Mammalia|Chiroptera|Molossidae|Molossus|molossus|Molossus molossus (Pallas, 1766)	2
Camponotus sexguttatus (Fabricius, 1793)	Animalia|Arthropoda|Insecta|Hymenoptera|Formicidae|Camponotus|sexguttatus|Camponotus sexguttatus (Fabricius, 1793)	2
Merremia dissecta (Jacq.) Hallier f.	Plantae|Magnoliophyta|Magnoliopsida|Solanales|Convolvulaceae|Merremia|dissecta|Merremia dissecta (Jacq.) Hallier f.	1
Leptotrema laevius (Vain.) Zahlbr., 1923	Fungi|Ascomycota|Lecanoromycetes|Ostropales|Graphidaceae|Thelotrema|laevius|Leptotrema laevius (Vain.) Zahlbr., 1923	1
Gelidium rigidum (C.Agardh) Greville, 1830	Plantae|Rhodophyta|Florideophyceae|Gelidiales|Gelidiellaceae|Gelidiella|rigidum|Gelidium rigidum (C.Agardh) Greville, 1830	1
Solanum seaforthianum Andrews	Plantae|Tracheophyta|Magnoliopsida|Solanales|Solanaceae|Solanum|seaforthianum|Solanum seaforthianum Andrews	1
Marchantia chenopoda L.	Plantae|Marchantiophyta|Marchantiopsida|Marchantiales|Marchantiaceae|Marchantia|chenopoda|Marchantia chenopoda L.	1
Graffenrieda latifolia (Naudin) Triana	Plantae|Tracheophyta|Magnoliopsida|Myrtales|Melastomataceae|Graffenrieda|latifolia|Graffenrieda latifolia (Naudin) Triana	1
Leptotrema laevius (Vain.) Zahlbr.	Fungi|Ascomycota|Lecanoromycetes|Ostropales|Thelotremataceae|Thelotrema|laevius|Leptotrema laevius (Vain.) Zahlbr.	1
Lejeunea ulicina var. bullata (Tayl.) Schust.	Plantae|Marchantiophyta|Jungermanniopsida|Porellales|Lejeuneaceae|Microlejeunea|ulicina|Lejeunea ulicina var. bullata (Tayl.) Schust.	1
Gouania polygama (Jacq.) Urb.	Plantae|Tracheophyta|Magnoliopsida|Rosales|Rhamnaceae|Gouania|polygama|Gouania polygama (Jacq.) Urb.	1
Andrographis paniculata (Burm. fil.) Nees	Plantae|Tracheophyta|Magnoliopsida|Lamiales|Acanthaceae|Andrographis|paniculata|Andrographis paniculata (Burm. fil.) Nees	1
Solanum nudum Dunal	Plantae|Magnoliophyta|Magnoliopsida|Solanales|Solanaceae|Solanum|nudum|Solanum nudum Dunal	1
Solanum americanum Mill.	Plantae|Magnoliophyta|Magnoliopsida|Solanales|Solanaceae|Solanum|americanum|Solanum americanum Mill.	1
Hymenophyllum protrusum Hook.	Plantae|Pteridophyta|Polypodiopsida|Hymenophyllales|Hymenophyllaceae|Hymenophyllum|protrusum|Hymenophyllum protrusum Hook.	1
Witheringia solanacea Miers ex Benth. & Hook.f.	Plantae|Magnoliophyta|Magnoliopsida|Solanales|Solanaceae|Witheringia|solanacea|Witheringia solanacea Miers ex Benth. & Hook.f.	1
Centropogon cornutus (L.) Druce	Plantae|Tracheophyta|Magnoliopsida|Asterales|Campanulaceae|Centropogon|cornutus|Centropogon cornutus (L.) Druce	1
Thersandrus compressus	Animalia|Arthropoda|Malacostraca|Decapoda|Majidae|Thersandrus|compressus|Thersandrus compressus	1
Formicidae Latreille, 1802	Animalia|Arthropoda|Insecta|Hymenoptera|Formicidae|||Formicidae Latreille, 1802	1
Acnistus arborescens (L.) Schlecht.	Plantae|Magnoliophyta|Magnoliopsida|Solanales|Solanaceae|Acnistus|arborescens|Acnistus arborescens (L.) Schlecht.	1
Gelidium rigidum var. radicans (Bory) J.Agardh, 1851	Plantae|Rhodophyta|Florideophyceae|Gelidiales|Gelidiellaceae|Gelidiella|rigidum|Gelidium rigidum var. radicans (Bory) J.Agardh, 1851	1
Freziera undulata var. hirsuta Urb.	Plantae|Magnoliophyta|Magnoliopsida|Ericales|Theaceae|Freziera|undulata|Freziera undulata var. hirsuta Urb.	1
Baccharis pedunculata (Mill.) Cabrera	Plantae|Tracheophyta|Magnoliopsida|Asterales|Asteraceae|Baccharis|pedunculata|Baccharis pedunculata (Mill.) Cabrera	1
Elaenia martinica subsp. martinica	Animalia|Chordata|Aves|Passeriformes|Tyrannidae|Elaenia|martinica|Elaenia martinica subsp. martinica	1
Argythamnia lancifolia (Schltdl.) M端ll.Arg.	Plantae|Tracheophyta|Magnoliopsida|Malpighiales|Euphorbiaceae|Ditaxis|lancifolia|Argythamnia lancifolia (Schltdl.) M端ll.Arg.	1
Polystachya caracasana Rchb.f.	Plantae|Tracheophyta|Liliopsida|Asparagales|Orchidaceae|Polystachya|caracasana|Polystachya caracasana Rchb.f.	1
Ipomoea violacea L.	Plantae|Magnoliophyta|Magnoliopsida|Solanales|Convolvulaceae|Ipomoea|violacea|Ipomoea violacea L.	1
Euphonia musica (J. F. Gmelin, 1789)	Animalia|Chordata|Aves|Passeriformes|Fringillidae|Euphonia|musica|Euphonia musica (J. F. Gmelin, 1789)	1
Lonchitis hirsuta L.	Plantae|Tracheophyta|Polypodiopsida|Polypodiales|Lonchitidaceae|Lonchitis|hirsuta|Lonchitis hirsuta L.	1
Vitex divaricata Sw.	Plantae|Tracheophyta|Magnoliopsida|Lamiales|Lamiaceae|Vitex|divaricata|Vitex divaricata Sw.	1
Solanum bahamense L.	Plantae|Magnoliophyta|Magnoliopsida|Solanales|Solanaceae|Solanum|bahamense|Solanum bahamense L.	1
Siparuna glabrescens A. DC.	Plantae|Tracheophyta|Magnoliopsida|Laurales|Siparunaceae|Siparuna|glabrescens|Siparuna glabrescens A. DC.	1
Dicliptera martinicensis (Jacq.) Juss.	Plantae|Tracheophyta|Magnoliopsida|Lamiales|Acanthaceae|Dicliptera|martinicensis|Dicliptera martinicensis (Jacq.) Juss.	1
Tylimanthus Mitt.	Plantae|Marchantiophyta|Jungermanniopsida|Jungermanniales|Acrobolbaceae|Tylimanthus||Tylimanthus Mitt.	1
Ipomoea violacea L.	Plantae|Tracheophyta|Magnoliopsida|Solanales|Convolvulaceae|Ipomoea|violacea|Ipomoea violacea L.	1
Thelotrema microglaenoides Vain.	Fungi|Ascomycota|Lecanoromycetes|Ostropales|Graphidaceae|Leptotrema|microglaenoides|Thelotrema microglaenoides Vain.	1
Galaxaura rugosa (J.Ellis & Solander) J.V.Lamouroux, 1816	Plantae|Rhodophyta|Florideophyceae|Nemaliales|Galaxauraceae|Galaxaura|rugosa|Galaxaura rugosa (J.Ellis & Solander) J.V.Lamouroux, 1816	1
Phlebodium aureum (L.) J. Sm.	Plantae|Pteridophyta|Polypodiopsida|Polypodiales|Polypodiaceae|Phlebodium|aureum|Phlebodium aureum (L.) J. Sm.	1
Euphonia musica (Gmelin, 1789)	Animalia|Chordata|Aves|Passeriformes|Thraupidae|Euphonia|musica|Euphonia musica (Gmelin, 1789)	1
Lonchitis hirsuta L.	Plantae|Pteridophyta|Polypodiopsida|Polypodiales|Dennstaedtiaceae|Lonchitis|hirsuta|Lonchitis hirsuta L.	1
Solanum torvum Sw.	Plantae|Tracheophyta|Magnoliopsida|Solanales|Solanaceae|Solanum|torvum|Solanum torvum Sw.	1
Trichomanes osmundoides DC. ex Poir.	Plantae|Pteridophyta|Polypodiopsida|Hymenophyllales|Hymenophyllaceae|Trichomanes|osmundoides|Trichomanes osmundoides DC. ex Poir.	1
Gouania domingensis (Jacq.) L.	Plantae|Tracheophyta|Magnoliopsida|Rosales|Rhamnaceae|Gouania|domingensis|Gouania domingensis (Jacq.) L.	1
Gouania lupuloides (L.) Urb.	Plantae|Tracheophyta|Magnoliopsida|Rosales|Rhamnaceae|Gouania|lupuloides|Gouania lupuloides (L.) Urb.	1
Croton corylifolius Lam.	Plantae|Tracheophyta|Magnoliopsida|Malpighiales|Euphorbiaceae|Croton|corylifolius|Croton corylifolius Lam.	1
Bostrychia tenella (J.V.Lamouroux) J.Agardh, 1863	Plantae|Rhodophyta|Florideophyceae|Ceramiales|Rhodomelaceae|Bostrychia|tenella|Bostrychia tenella (J.V.Lamouroux) J.Agardh, 1863	1
Lycopodium cernuum L.	Plantae|Lycopodiophyta|Lycopodiopsida|Lycopodiales|Lycopodiaceae|Lycopodiella|cernuum|Lycopodium cernuum L.	1
Vismia falcata Rusby	Plantae|Tracheophyta|Magnoliopsida|Malpighiales|Hypericaceae|Vismia|falcata|Vismia falcata Rusby	1
Passiflora rubra L.	Plantae|Magnoliophyta|Magnoliopsida|Malpighiales|Passifloraceae|Passiflora|rubra|Passiflora rubra L.	1
Polystachya caracasana Rchb.f.	Plantae|Magnoliophyta|Liliopsida|Asparagales|Orchidaceae|Polystachya|caracasana|Polystachya caracasana Rchb.f.	1
Clathroporina elliottii (Vain.) Zahlbr.	Fungi|Ascomycota|Lecanoromycetes|Ostropales|Porinaceae|Clathroporina|elliottii|Clathroporina elliottii (Vain.) Zahlbr.	1
Trichomanes osmundoides DC.	Plantae|Tracheophyta|Polypodiopsida|Hymenophyllales|Hymenophyllaceae|Trichomanes|osmundoides|Trichomanes osmundoides DC.	1
Vigna adenantha (G.Mey.) Marechal et al.	Plantae|Magnoliophyta|Magnoliopsida|Fabales|Fabaceae|Vigna|adenantha|Vigna adenantha (G.Mey.) Marechal et al.	1
Tibouchina cistoides (Griseb.) Cogn.	Plantae|Tracheophyta|Magnoliopsida|Myrtales|Melastomataceae|Tibouchina|cistoides|Tibouchina cistoides (Griseb.) Cogn.	1
Bazzania longistipula (Lindenb.) Trevis.	Plantae|Marchantiophyta|Jungermanniopsida|Jungermanniales|Lepidoziaceae|Bazzania|longistipula|Bazzania longistipula (Lindenb.) Trevis.	1
Centroceras clavulatum (C.Agardh) Montagne, 1846	Plantae|Rhodophyta|Florideophyceae|Ceramiales|Ceramiaceae|Centroceras|clavulatum|Centroceras clavulatum (C.Agardh) Montagne, 1846	1
Cyathea tenera (J. Sm. ex Hook.) T. Moore	Plantae|Pteridophyta|Polypodiopsida|Cyatheales|Cyatheaceae|Cyathea|tenera|Cyathea tenera (J. Sm. ex Hook.) T. Moore	1
Bignonia unguis-cati L.	Plantae|Tracheophyta|Magnoliopsida|Lamiales|Bignoniaceae|Dolichandra|unguis-cati|Bignonia unguis-cati L.	1
Thelotrema elliottii Vain.	Fungi|Ascomycota|Lecanoromycetes|Ostropales|Thelotremataceae|Thelotrema|elliottii|Thelotrema elliottii Vain.	1
Peperomia serpens (Sw.) Loud.	Plantae|Tracheophyta|Magnoliopsida|Piperales|Piperaceae|Peperomia|serpens|Peperomia serpens (Sw.) Loud.	1
Amauropelta Kunze	Plantae|Pteridophyta|Polypodiopsida|Polypodiales|Thelypteridaceae|Amauropelta||Amauropelta Kunze	1
Theaceae	Plantae|Tracheophyta|Magnoliopsida|Ericales|Theaceae|||Theaceae	1
Turdus nudigenis subsp. nudigenis	Animalia|Chordata|Aves|Passeriformes|Turdidae|Turdus|nudigenis|Turdus nudigenis subsp. nudigenis	1
Bostrychia Montagne, 1842	Plantae|Rhodophyta|Florideophyceae|Ceramiales|Rhodomelaceae|Bostrychia||Bostrychia Montagne, 1842	1
Anisosorus hirsutus (L.) Underw. & Maxon	Plantae|Tracheophyta|Polypodiopsida|Polypodiales|Lonchitidaceae|Lonchitis|hirsutus|Anisosorus hirsutus (L.) Underw. & Maxon	1
Matayba arborescens Radlk.	Plantae|Magnoliophyta|Magnoliopsida|Sapindales|Sapindaceae|Matayba|arborescens|Matayba arborescens Radlk.	1
Solanum bicolor Willd.	Plantae|Tracheophyta|Magnoliopsida|Solanales|Solanaceae|Solanum|bicolor|Solanum bicolor Willd.	1
Gesneria cymosa Urb.	Plantae|Magnoliophyta|Magnoliopsida|Lamiales|Gesneriaceae|Gesneria|cymosa|Gesneria cymosa Urb.	1
Styrax glaber Sw.	Plantae|Tracheophyta|Magnoliopsida|Ericales|Styracaceae|Styrax|glaber|Styrax glaber Sw.	1
Trichomanes polypodioides L.	Plantae|Tracheophyta|Polypodiopsida|Hymenophyllales|Hymenophyllaceae|Trichomanes|polypodioides|Trichomanes polypodioides L.	1
Diplazium godmanii (Bak.) C. Chr.	Plantae|Tracheophyta|Polypodiopsida|Polypodiales|Athyriaceae|Diplazium|godmanii|Diplazium godmanii (Bak.) C. Chr.	1
Trichomanes rigidum Ogata	Plantae|Pteridophyta|Polypodiopsida|Hymenophyllales|Hymenophyllaceae|Selenodesmium|rigidum|Trichomanes rigidum Ogata	1
Freziera undulata var. hirsuta (Sm.) Krug & Urb.	Plantae|Tracheophyta|Magnoliopsida|Ericales|Pentaphylacaceae|Freziera|undulata|Freziera undulata var. hirsuta (Sm.) Krug & Urb.	1
Rhynchostegiopsis flexuosa C. M端ller, 1897	Plantae|Bryophyta|Bryopsida|Hookeriales|Hookeriaceae|Rhynchostegiopsis|flexuosa|Rhynchostegiopsis flexuosa C. M端ller, 1897	1
Orchidaceae	Plantae|Tracheophyta|Liliopsida|Asparagales|Orchidaceae|||Orchidaceae	1
Plagiochila arcuata Lindenb.	Plantae|Marchantiophyta|Jungermanniopsida|Jungermanniales|Plagiochilaceae|Plagiochila|arcuata|Plagiochila arcuata Lindenb.	1
Anthoceros tuberculatus Lehm. & Lindenb.	Plantae|Anthocerotophyta|Anthocerotopsida|Anthocerotales|Anthocerotaceae|Anthoceros|tuberculatus|Anthoceros tuberculatus Lehm. & Lindenb.	1
Solanum americanum Mill.	Plantae|Tracheophyta|Magnoliopsida|Solanales|Solanaceae|Solanum|americanum|Solanum americanum Mill.	1
Lejeunea vincentiana Gottsche	Plantae|Marchantiophyta|Jungermanniopsida|Porellales|Lejeuneaceae|Symbiezidium|vincentiana|Lejeunea vincentiana Gottsche	1
Piper amalago L.	Plantae|Tracheophyta|Magnoliopsida|Piperales|Piperaceae|Piper|amalago|Piper amalago L.	1
Freziera undulata (Sw.) Willd.	Plantae|Tracheophyta|Magnoliopsida|Ericales|Pentaphylacaceae|Freziera|undulata|Freziera undulata (Sw.) Willd.	1
Mollugo radiata Ruiz & Pav.	Plantae|Tracheophyta|Magnoliopsida|Caryophyllales|Molluginaceae|Glinus|radiata|Mollugo radiata Ruiz & Pav.	1
Phlebodium aureum (L.) J. Sm.	Plantae|Tracheophyta|Polypodiopsida|Polypodiales|Polypodiaceae|Phlebodium|aureum|Phlebodium aureum (L.) J. Sm.	1
Gouania lupuloides (L.) Urb.	Plantae|Magnoliophyta|Magnoliopsida|Rosales|Rhamnaceae|Gouania|lupuloides|Gouania lupuloides (L.) Urb.	1
Boehmeria ramiflora Jacq.	Plantae|Tracheophyta|Magnoliopsida|Rosales|Urticaceae|Boehmeria|ramiflora|Boehmeria ramiflora Jacq.	1
Thelotrema microglaenoides Vain., 1896	Fungi|Ascomycota|Lecanoromycetes|Ostropales|Graphidaceae|Ocellularia|microglaenoides|Thelotrema microglaenoides Vain., 1896	1
Ternstroemia elliptica Sw.	Plantae|Tracheophyta|Magnoliopsida|Ericales|Pentaphylacaceae|Ternstroemia|elliptica|Ternstroemia elliptica Sw.	1
Prionolejeunea denticulata (F.Weber) Schiffn.	Plantae|Marchantiophyta|Jungermanniopsida|Porellales|Lejeuneaceae|Prionolejeunea|denticulata|Prionolejeunea denticulata (F.Weber) Schiffn.	1
Witheringia solanacea	Plantae|Tracheophyta|Magnoliopsida|Solanales|Solanaceae|Witheringia|solanacea|Witheringia solanacea	1
Orchidaceae Juss.	Plantae|Magnoliophyta|Liliopsida|Asparagales|Orchidaceae|||Orchidaceae Juss.	1
Clathroporina elliottii (Vain.) Zahlbr.	Fungi|Ascomycota|Lecanoromycetes||Thelenellaceae|Thelenella|elliottii|Clathroporina elliottii (Vain.) Zahlbr.	1
Piper aequale Vahl	Plantae|Tracheophyta|Magnoliopsida|Piperales|Piperaceae|Piper|aequale|Piper aequale Vahl	1
Anisosorus hirsutus (L.) Underwood & Maxon ex Maxon	Plantae|Pteridophyta|Polypodiopsida|Polypodiales|Dennstaedtiaceae|Lonchitis|hirsutus|Anisosorus hirsutus (L.) Underwood & Maxon ex Maxon	1
Prescottia oligantha (Sw.) Lindl.	Plantae|Tracheophyta|Liliopsida|Asparagales|Orchidaceae|Prescottia|oligantha|Prescottia oligantha (Sw.) Lindl.	1
Alectra aspera (Cham. & Schltdl.) L.O. Williams	Plantae|Magnoliophyta|Magnoliopsida|Lamiales|Orobanchaceae|Alectra|aspera|Alectra aspera (Cham. & Schltdl.) L.O. Williams	1
Anthoceros hookerianus Lehm.	Plantae|Anthocerotophyta|Anthocerotopsida|Anthocerotales|Anthocerotaceae|Anthoceros|hookerianus|Anthoceros hookerianus Lehm.	1
Lobelia brigittalis E.H.L.Krause	Plantae|Tracheophyta|Magnoliopsida|Asterales|Campanulaceae|Lobelia|brigittalis|Lobelia brigittalis E.H.L.Krause	1
Badula caribaea A.DC.	Plantae|Tracheophyta|Magnoliopsida|Ericales|Primulaceae|Stylogyne|caribaea|Badula caribaea A.DC.	1
Acacia catechu (L.f.) Willd.	Plantae|Tracheophyta|Magnoliopsida|Fabales|Fabaceae|Senegalia|catechu|Acacia catechu (L.f.) Willd.	1
Antrophyum subsessile Kunze	Plantae|Tracheophyta|Polypodiopsida|Polypodiales|Pteridaceae|Antrophyum|subsessile|Antrophyum subsessile Kunze	1
Erioderma physcioides Vainio	Fungi|Ascomycota|Lecanoromycetes|Peltigerales|Pannariaceae|Erioderma|physcioides|Erioderma physcioides Vainio	1
Solanum bahamense L.	Plantae|Tracheophyta|Magnoliopsida|Solanales|Solanaceae|Solanum|bahamense|Solanum bahamense L.	1
Bignonia unguis-cati L.	Plantae|Magnoliophyta|Magnoliopsida|Lamiales|Bignoniaceae|Dolichandra|unguis-cati|Bignonia unguis-cati L.	1
Platylejeunea (R. Spruce) V. Schiffner, 1893	Plantae|Marchantiophyta|Jungermanniopsida|Porellales|Lejeuneaceae|Platylejeunea||Platylejeunea (R. Spruce) V. Schiffner, 1893	1
Vitex divaricata Sw.	Plantae|Magnoliophyta|Magnoliopsida|Lamiales|Lamiaceae|Vitex|divaricata|Vitex divaricata Sw.	1
Gomphia nitida Vahl	Plantae|Tracheophyta|Magnoliopsida|Malpighiales|Ochnaceae|Ouratea|nitida|Gomphia nitida Vahl	1
Miconia lambertiana DC.	Plantae|Tracheophyta|Magnoliopsida|Myrtales|Melastomataceae|Miconia|lambertiana|Miconia lambertiana DC.	1
Carolus sinemariensis (Aubl.) W.R.Anderson	Plantae|Tracheophyta|Magnoliopsida|Malpighiales|Malpighiaceae|Carolus|sinemariensis|Carolus sinemariensis (Aubl.) W.R.Anderson	1
Bourreria succulenta Jacq.	Plantae|Tracheophyta|Magnoliopsida|Boraginales|Boraginaceae|Bourreria|succulenta|Bourreria succulenta Jacq.	1
Piper subrectinerve C. DC.	Plantae|Tracheophyta|Magnoliopsida|Piperales|Piperaceae|Piper|subrectinerve|Piper subrectinerve C. DC.	1
Taxilejeunea (Spruce) Schiffn.	Plantae|Marchantiophyta|Jungermanniopsida|Porellales|Lejeuneaceae|Taxilejeunea||Taxilejeunea (Spruce) Schiffn.	1
Bazzania stolonifera (Sw.) Trevis.	Plantae|Marchantiophyta|Jungermanniopsida|Jungermanniales|Lepidoziaceae|Bazzania|stolonifera|Bazzania stolonifera (Sw.) Trevis.	1
Begonia pensilis L.B.Sm. & Wassh.	Plantae|Tracheophyta|Magnoliopsida|Cucurbitales|Begoniaceae|Begonia|pensilis|Begonia pensilis L.B.Sm. & Wassh.	1
Aciotis purpurascens (Aubl.) Triana	Plantae|Tracheophyta|Magnoliopsida|Myrtales|Melastomataceae|Aciotis|purpurascens|Aciotis purpurascens (Aubl.) Triana	1
Syrrhopodon prolifer var. scaber (Mitt.) W.D.Reese	Plantae|Bryophyta|Bryopsida|Pottiales|Calymperaceae|Syrrhopodon|prolifer|Syrrhopodon prolifer var. scaber (Mitt.) W.D.Reese	1
Sphaenosiphon prasinus Reinsch, 1875	Bacteria|Cyanobacteria|Cyanophyceae|Chroococcales|Dermocarpellaceae|Dermocarpella|prasinus|Sphaenosiphon prasinus Reinsch, 1875	1
Alectra aspera (Cham. & Schltdl.) L.O. Williams	Plantae|Tracheophyta|Magnoliopsida|Lamiales|Orobanchaceae|Melasma|aspera|Alectra aspera (Cham. & Schltdl.) L.O. Williams	1
Bourreria baccata Rafin.	Plantae|Tracheophyta|Magnoliopsida|Boraginales|Boraginaceae|Bourreria|baccata|Bourreria baccata Rafin.	1
Croton helicoideus M端ll.Arg.	Plantae|Tracheophyta|Magnoliopsida|Malpighiales|Euphorbiaceae|Croton|helicoideus|Croton helicoideus M端ll.Arg.	1
Caloplaca epiphora (Taylor) C. W. Dodge	Fungi|Ascomycota|Lecanoromycetes|Teloschistales|Teloschistaceae|Caloplaca|epiphora|Caloplaca epiphora (Taylor) C. W. Dodge	1
Solanum mammosum L.	Plantae|Tracheophyta|Magnoliopsida|Solanales|Solanaceae|Solanum|mammosum|Solanum mammosum L.	1
Bacidia andita var. submedialis (Vain.) Zahlbr.	Fungi|Ascomycota|Lecanoromycetes|Lecanorales|Lecideaceae|Lecidea|andita|Bacidia andita var. submedialis (Vain.) Zahlbr.	1
Corallina officinalis Linnaeus, 1758	Plantae|Rhodophyta|Florideophyceae|Corallinales|Corallinaceae|Corallina|officinalis|Corallina officinalis Linnaeus, 1758	1
Tylimanthus Mitten in J.D. Hooker, 1867	Plantae|Marchantiophyta|Jungermanniopsida|Jungermanniales|Acrobolbaceae|Tylimanthus||Tylimanthus Mitten in J.D. Hooker, 1867	1
Solanum bicolor Willd. ex Roem. & Schult.	Plantae|Magnoliophyta|Magnoliopsida|Solanales|Solanaceae|Solanum|bicolor|Solanum bicolor Willd. ex Roem. & Schult.	1
Thalasseus maximus (Boddaert, 1783)	Animalia|Chordata|Aves|Charadriiformes|Laridae|Thalaseus|maximus|Thalasseus maximus (Boddaert, 1783)	1
Bourreria baccata Raf.	Plantae|Magnoliophyta|Magnoliopsida|Boraginales|Boraginaceae|Bourreria|baccata|Bourreria baccata Raf.	1
Vismia guianensis (Aubl.) Pers.	Plantae|Tracheophyta|Magnoliopsida|Malpighiales|Hypericaceae|Vismia|guianensis|Vismia guianensis (Aubl.) Pers.	1
Ocotea Aubl.	Plantae|Tracheophyta|Magnoliopsida|Laurales|Lauraceae|Ocotea||Ocotea Aubl.	1
Smilax solanifolia A.DC.	Plantae|Magnoliophyta|Liliopsida|Liliales|Smilacaceae|Smilax|solanifolia|Smilax solanifolia A.DC.	1
Antrophyum subsessile Kunze	Plantae|Pteridophyta|Polypodiopsida|Polypodiales|Pteridaceae|Antrophyum|subsessile|Antrophyum subsessile Kunze	1
Trichomanes rigidum Sw.	Plantae|Tracheophyta|Polypodiopsida|Hymenophyllales|Hymenophyllaceae|Abrodictyum|rigidum|Trichomanes rigidum Sw.	1
Solanum nudum Dunal	Plantae|Tracheophyta|Magnoliopsida|Solanales|Solanaceae|Solanum|nudum|Solanum nudum Dunal	1
Matayba arborescens (Aubl.) Radlk.	Plantae|Tracheophyta|Magnoliopsida|Sapindales|Sapindaceae|Matayba|arborescens|Matayba arborescens (Aubl.) Radlk.	1
Bacidia nana (Vain.) Zahlbr.	Fungi|Ascomycota|Lecanoromycetes|Lecanorales|Lecideaceae|Lecidea|nana|Bacidia nana (Vain.) Zahlbr.	1
Merremia dissecta (Jacquin) Hall. fil.	Plantae|Tracheophyta|Magnoliopsida|Solanales|Convolvulaceae|Merremia|dissecta|Merremia dissecta (Jacquin) Hall. fil.	1
Amauropelta	Plantae|Tracheophyta|Polypodiopsida|Polypodiales|Thelypteridaceae|Amauropelta||Amauropelta	1
Thalasseus maximus (Boddaert, 1783)	Animalia|Chordata|Aves|Charadriiformes|Laridae|Thalasseus|maximus|Thalasseus maximus (Boddaert, 1783)	1
Symbolanthus frigidus (Sw.) Struwe & K.Gould	Plantae|Tracheophyta|Magnoliopsida|Gentianales|Gentianaceae|Symbolanthus|frigidus|Symbolanthus frigidus (Sw.) Struwe & K.Gould	1
Cyathea tenera (Hook.) T. Moore	Plantae|Tracheophyta|Polypodiopsida|Cyatheales|Cyatheaceae|Cyathea|tenera|Cyathea tenera (Hook.) T. Moore	1
Solanum torvum Sw.	Plantae|Magnoliophyta|Magnoliopsida|Solanales|Solanaceae|Solanum|torvum|Solanum torvum Sw.	1
Diplazium ambiguum Raddi	Plantae|Tracheophyta|Polypodiopsida|Polypodiales|Athyriaceae|Diplazium|ambiguum|Diplazium ambiguum Raddi	1
Thelotrema elliottii Vain.	Fungi|Ascomycota|Lecanoromycetes|Ostropales|Graphidaceae|Thelotrema|elliottii|Thelotrema elliottii Vain.	1
Gesneria cymosa Urb.	Plantae|Tracheophyta|Magnoliopsida|Lamiales|Gesneriaceae|Gesneria|cymosa|Gesneria cymosa Urb.	1
Marchantia inflexa Nees & Mont.	Plantae|Marchantiophyta|Marchantiopsida|Marchantiales|Marchantiaceae|Marchantia|inflexa|Marchantia inflexa Nees & Mont.	1
Sticherus bifidus (Willd.) Ching	Plantae|Tracheophyta|Polypodiopsida|Gleicheniales|Gleicheniaceae|Sticherus|bifidus|Sticherus bifidus (Willd.) Ching	1
Sphaenosiphon prasinus Reinsch	Bacteria|Cyanobacteria||Chroococcales|Dermocarpellaceae|Cyanocystis|prasinus|Sphaenosiphon prasinus Reinsch	1
Cheilolejeunea discoidea (Lehm. & Lindenb.) Kachr. & R.M.Schust.	Plantae|Marchantiophyta|Jungermanniopsida|Porellales|Lejeuneaceae|Cheilolejeunea|discoidea|Cheilolejeunea discoidea (Lehm. & Lindenb.) Kachr. & R.M.Schust.	1
Jungermannia debilis Lehm. & Lindenb.	Plantae|Marchantiophyta|Jungermanniopsida|Porellales|Lejeuneaceae|Lejeunea|debilis|Jungermannia debilis Lehm. & Lindenb.	1
Bourreria succulenta Jacq.	Plantae|Magnoliophyta|Magnoliopsida|Boraginales|Boraginaceae|Bourreria|succulenta|Bourreria succulenta Jacq.	1
Solanum mammosum L.	Plantae|Magnoliophyta|Magnoliopsida|Solanales|Solanaceae|Solanum|mammosum|Solanum mammosum L.	1
Gouania polygama (Jacq.) Urb.	Plantae|Magnoliophyta|Magnoliopsida|Rosales|Rhamnaceae|Gouania|polygama|Gouania polygama (Jacq.) Urb.	1
Terustroemia Jack	Plantae|Magnoliophyta|Magnoliopsida|Ericales|Theaceae|Terustroemia||Terustroemia Jack	1
Acanthophora spicifera (M.Vahl) B淡rgesen, 1910	Plantae|Rhodophyta|Florideophyceae|Ceramiales|Rhodomelaceae|Acanthophora|spicifera|Acanthophora spicifera (M.Vahl) B淡rgesen, 1910	1
Hyperphyscia adglutinata (Fl旦rke) H. Mayrhofer & Poelt	Fungi|Ascomycota|Lecanoromycetes|Teloschistales|Physciaceae|Hyperphyscia|adglutinata|Hyperphyscia adglutinata (Fl旦rke) H. Mayrhofer & Poelt	1
Vigna adenantha (G.Mey.) Marechal et al.	Plantae|Tracheophyta|Magnoliopsida|Fabales|Fabaceae|Vigna|adenantha|Vigna adenantha (G.Mey.) Marechal et al.	1
Styrax glabrum Sw.	Plantae|Tracheophyta|Magnoliopsida|Ericales|Styracaceae|Styrax|glabrum|Styrax glabrum Sw.	1
Styrax glaber Cav.	Plantae|Magnoliophyta|Magnoliopsida|Ericales|Styracaceae|Styrax|glaber|Styrax glaber Cav.	1
Bacidia nana (Vain.) Zahlbr.	Fungi|Ascomycota|Lecanoromycetes|Lecanorales|Ramalinaceae|Bacidia|nana|Bacidia nana (Vain.) Zahlbr.	1
Thelotrema homopastoides Vain.	Fungi|Ascomycota|Lecanoromycetes|Ostropales|Graphidaceae|Thelotrema|homopastoides|Thelotrema homopastoides Vain.	1
Erioderma physcioides Vain.	Fungi|Ascomycota|Lecanoromycetes|Peltigerales|Pannariaceae|Erioderma|physcioides|Erioderma physcioides Vain.	1
Prestoea acuminata var. montana	Plantae|Magnoliophyta|Liliopsida|Arecales|Arecaceae|Prestoea|acuminata|Prestoea acuminata var. montana	1
Gelidium J.V. Lamouroux, 1813	Plantae|Rhodophyta|Florideophyceae|Gelidiales|Gelidiaceae|Gelidium||Gelidium J.V. Lamouroux, 1813	1
Lepidolejeunea involuta (Gottsche) Grolle	Plantae|Marchantiophyta|Jungermanniopsida|Porellales|Lejeuneaceae|Lepidolejeunea|involuta|Lepidolejeunea involuta (Gottsche) Grolle	1
Elaenia martinica martinica	Animalia|Chordata|Aves|Passeriformes|Tyrannidae|Elaenia|martinica|Elaenia martinica martinica	1
Sticherus bifidus (Willd.) Ching	Plantae|Pteridophyta|Polypodiopsida|Gleicheniales|Gleicheniaceae|Sticherus|bifidus|Sticherus bifidus (Willd.) Ching	1
Trichomanes polypodioides L.	Plantae|Pteridophyta|Polypodiopsida|Hymenophyllales|Hymenophyllaceae|Trichomanes|polypodioides|Trichomanes polypodioides L.	1
Cassipourea guianensis Aubl.	Plantae|Tracheophyta|Magnoliopsida|Malpighiales|Rhizophoraceae|Cassipourea|guianensis|Cassipourea guianensis Aubl.	1
Smilax solanifolia A.DC.	Plantae|Tracheophyta|Liliopsida|Liliales|Smilacaceae|Smilax|solanifolia|Smilax solanifolia A.DC.	1
Troglodytes aedon subsp. musicus	Animalia|Chordata|Aves|Passeriformes|Troglodytidae|Troglodytes|aedon|Troglodytes aedon subsp. musicus	1
Croton guildingii Griseb.	Plantae|Tracheophyta|Magnoliopsida|Malpighiales|Euphorbiaceae|Croton|guildingii|Croton guildingii Griseb.	1
Turdus nudigenis nudigenis	Animalia|Chordata|Aves|Passeriformes|Turdidae|Turdus|nudigenis|Turdus nudigenis nudigenis	1
Ipomoea tiliacea (Willd.) Choisy	Plantae|Tracheophyta|Magnoliopsida|Solanales|Convolvulaceae|Ipomoea|tiliacea|Ipomoea tiliacea (Willd.) Choisy	1
Syrrhopodon rigidus W. J. Hooker & Greville, 1825	Plantae|Bryophyta|Bryopsida|Pottiales|Calymperaceae|Syrrhopodon|rigidus|Syrrhopodon rigidus W. J. Hooker & Greville, 1825	1
Plagiochila superba (Nees ex Spreng.) Mont. & Nees	Plantae|Marchantiophyta|Jungermanniopsida|Jungermanniales|Plagiochilaceae|Plagiochila|superba|Plagiochila superba (Nees ex Spreng.) Mont. & Nees	1
Banisteriopsis lucida (Richard) Small	Plantae|Tracheophyta|Magnoliopsida|Malpighiales|Malpighiaceae|Diplopterys|lucida|Banisteriopsis lucida (Richard) Small	1
Savia sessiliflora (Sw.) Willd.	Plantae|Magnoliophyta|Magnoliopsida|Malpighiales|Phyllanthaceae|Savia|sessiliflora|Savia sessiliflora (Sw.) Willd.	1
Thelotrema homopastoides Vain.	Fungi|Ascomycota|Lecanoromycetes|Ostropales|Thelotremataceae|Thelotrema|homopastoides|Thelotrema homopastoides Vain.	1
Lithothamnion Heydrich, 1897	Plantae|Rhodophyta|Florideophyceae|Corallinales|Hapalidiaceae|Lithothamnion||Lithothamnion Heydrich, 1897	1
Halarachnion ligulatum (Woodward) K端tzing, 1843	Plantae|Rhodophyta|Florideophyceae|Gigartinales|Furcellariaceae|Halarachnion|ligulatum|Halarachnion ligulatum (Woodward) K端tzing, 1843	1
Selaginella rotundifolia Spring	Plantae|Tracheophyta|Lycopodiopsida|Selaginellales|Selaginellaceae|Selaginella|rotundifolia|Selaginella rotundifolia Spring	1
Lycopodium cernuum L.	Plantae|Tracheophyta|Lycopodiopsida|Lycopodiales|Lycopodiaceae|Palhinhaea|cernuum|Lycopodium cernuum L.	1
Bacidia andita var. submedialis (Vain.) Zahlbr.	Fungi|Ascomycota|Lecanoromycetes|Lecanorales|Ramalinaceae|Bacidia|andita|Bacidia andita var. submedialis (Vain.) Zahlbr.	1
Savia sessiliflora (Sw.) Willd.	Plantae|Tracheophyta|Magnoliopsida|Malpighiales|Phyllanthaceae|Savia|sessiliflora|Savia sessiliflora (Sw.) Willd.	1
Lejeunea angulistipa Stephani	Plantae|Marchantiophyta|Jungermanniopsida|Porellales|Lejeuneaceae|Cyclolejeunea|angulistipa|Lejeunea angulistipa Stephani	1
Formicidae	Animalia|Arthropoda|Insecta|Hymenoptera|Formicidae|||Formicidae	1
Clidemia lanata DC.	Plantae|Tracheophyta|Magnoliopsida|Myrtales|Melastomataceae|Miconia|lanata|Clidemia lanata DC.	1
Hymenophyllum protrusum Hook.	Plantae|Tracheophyta|Polypodiopsida|Hymenophyllales|Hymenophyllaceae|Hymenophyllum|protrusum|Hymenophyllum protrusum Hook.	1
Cyclolejeunea accedens (Gottsche) A.Evans	Plantae|Marchantiophyta|Jungermanniopsida|Porellales|Lejeuneaceae|Cyclolejeunea|accedens|Cyclolejeunea accedens (Gottsche) A.Evans	1