taxonName	taxonPath	recordCount
Coereba flaveola (Linnaeus, 1758)	Animalia|Chordata|Aves|Passeriformes|Coerebidae|Coereba|flaveola|Coereba flaveola (Linnaeus, 1758)	73
Zenaida aurita (Temminck, 1809)	Animalia|Chordata|Aves|Columbiformes|Columbidae|Zenaida|aurita|Zenaida aurita (Temminck, 1809)	59
Tyrannus dominicensis (Gmelin, 1788)	Animalia|Chordata|Aves|Passeriformes|Tyrannidae|Tyrannus|dominicensis|Tyrannus dominicensis (Gmelin, 1788)	53
Orthorhyncus cristatus (Linnaeus, 1758)	Animalia|Chordata|Aves|Apodiformes|Trochilidae|Orthorhyncus|cristatus|Orthorhyncus cristatus (Linnaeus, 1758)	53
Pelecanus occidentalis Linnaeus, 1766	Animalia|Chordata|Aves|Pelecaniformes|Pelecanidae|Pelecanus|occidentalis|Pelecanus occidentalis Linnaeus, 1766	44
Falco sparverius Linnaeus, 1758	Animalia|Chordata|Aves|Falconiformes|Falconidae|Falco|sparverius|Falco sparverius Linnaeus, 1758	41
Fregata magnificens Mathews, 1914	Animalia|Chordata|Aves|Suliformes|Fregatidae|Fregata|magnificens|Fregata magnificens Mathews, 1914	37
Margarops fuscatus (Vieillot, 1808)	Animalia|Chordata|Aves|Passeriformes|Mimidae|Margarops|fuscatus|Margarops fuscatus (Vieillot, 1808)	33
Brachyphylla cavernarum Gray, 1834	Animalia|Chordata|Mammalia|Chiroptera|Phyllostomidae|Brachyphylla|cavernarum|Brachyphylla cavernarum Gray, 1834	26
Sula leucogaster (Boddaert, 1783)	Animalia|Chordata|Aves|Suliformes|Sulidae|Sula|leucogaster|Sula leucogaster (Boddaert, 1783)	25
Tiaris bicolor (Linnaeus, 1766)	Animalia|Chordata|Aves|Passeriformes|Thraupidae|Tiaris|bicolor|Tiaris bicolor (Linnaeus, 1766)	24
Himantopus mexicanus (Statius Muller, 1776)	Animalia|Chordata|Aves|Charadriiformes|Recurvirostridae|Himantopus|mexicanus|Himantopus mexicanus (Statius Muller, 1776)	23
Tiaris bicolor (Linnaeus, 1766)	Animalia|Chordata|Aves|Passeriformes|Emberizidae|Tiaris|bicolor|Tiaris bicolor (Linnaeus, 1766)	21
Butorides virescens (Linnaeus, 1758)	Animalia|Chordata|Aves|Pelecaniformes|Ardeidae|Butorides|virescens|Butorides virescens (Linnaeus, 1758)	18
Eulampis holosericeus (Linnaeus, 1758)	Animalia|Chordata|Aves|Apodiformes|Trochilidae|Eulampis|holosericeus|Eulampis holosericeus (Linnaeus, 1758)	18
Elaenia martinica (Linnaeus, 1766)	Animalia|Chordata|Aves|Passeriformes|Tyrannidae|Elaenia|martinica|Elaenia martinica (Linnaeus, 1766)	17
Loxigilla noctis (Linnaeus, 1766)	Animalia|Chordata|Aves|Passeriformes|Thraupidae|Loxigilla|noctis|Loxigilla noctis (Linnaeus, 1766)	17
Ardea alba Linnaeus, 1758	Animalia|Chordata|Aves|Pelecaniformes|Ardeidae|Ardea|alba|Ardea alba Linnaeus, 1758	15
Columbina passerina (Linnaeus, 1758)	Animalia|Chordata|Aves|Columbiformes|Columbidae|Columbina|passerina|Columbina passerina (Linnaeus, 1758)	14
Loxigilla noctis (Linnaeus, 1766)	Animalia|Chordata|Aves|Passeriformes|Emberizidae|Loxigilla|noctis|Loxigilla noctis (Linnaeus, 1766)	13
Artibeus jamaicensis Leach, 1821	Animalia|Chordata|Mammalia|Chiroptera|Phyllostomidae|Artibeus|jamaicensis|Artibeus jamaicensis Leach, 1821	12
Thalasseus maximus (Boddaert, 1783)	Animalia|Chordata|Aves|Charadriiformes|Laridae|Thalaseus|maximus|Thalasseus maximus (Boddaert, 1783)	12
Phaethon lepturus Daudin, 1802	Animalia|Chordata|Aves|Phaethontiformes|Phaethontidae|Phaëthon|lepturus|Phaethon lepturus Daudin, 1802	11
Leucophaeus atricilla (Linnaeus, 1758)	Animalia|Chordata|Aves|Charadriiformes|Laridae|Leucophaeus|atricilla|Leucophaeus atricilla (Linnaeus, 1758)	11
Arenaria interpres (Linnaeus, 1758)	Animalia|Chordata|Aves|Charadriiformes|Scolopacidae|Arenaria|interpres|Arenaria interpres (Linnaeus, 1758)	10
Tringa flavipes (Gmelin, 1789)	Animalia|Chordata|Aves|Charadriiformes|Scolopacidae|Tringa|flavipes|Tringa flavipes (Gmelin, 1789)	10
Tadarida brasiliensis (I. Geoffroy, 1824)	Animalia|Chordata|Mammalia|Chiroptera|Molossidae|Tadarida|brasiliensis|Tadarida brasiliensis (I. Geoffroy, 1824)	10
Gallinula galeata	Animalia|Chordata|Aves|Gruiformes|Rallidae|Gallinula|galeata|Gallinula galeata	8
Charadrius vociferus Linnaeus, 1758	Animalia|Chordata|Aves|Charadriiformes|Charadriidae|Charadrius|vociferus|Charadrius vociferus Linnaeus, 1758	8
Actitis macularius (Linnaeus, 1766)	Animalia|Chordata|Aves|Charadriiformes|Scolopacidae|Actitis|macularius|Actitis macularius (Linnaeus, 1766)	8
Hirundo rustica Linnaeus, 1758	Animalia|Chordata|Aves|Passeriformes|Hirundinidae|Hirundo|rustica|Hirundo rustica Linnaeus, 1758	7
Anas discors Linnaeus, 1766	Animalia|Chordata|Aves|Anseriformes|Anatidae|Anas|discors|Anas discors Linnaeus, 1766	7
Falco peregrinus Tunstall, 1771	Animalia|Chordata|Aves|Falconiformes|Falconidae|Falco|peregrinus|Falco peregrinus Tunstall, 1771	6
Megaceryle alcyon (Linnaeus, 1758)	Animalia|Chordata|Aves|Coraciiformes|Alcedinidae|Megaceryle|alcyon|Megaceryle alcyon (Linnaeus, 1758)	6
Ardea herodias Linnaeus, 1758	Animalia|Chordata|Aves|Pelecaniformes|Ardeidae|Ardea|herodias|Ardea herodias Linnaeus, 1758	6
Columba livia Gmelin, 1789	Animalia|Chordata|Aves|Columbiformes|Columbidae|Columba|livia|Columba livia Gmelin, 1789	4
Egretta thula (Molina, 1782)	Animalia|Chordata|Aves|Pelecaniformes|Ardeidae|Egretta|thula|Egretta thula (Molina, 1782)	4
Beloperone eustachyana Benth. & Hook.f.	Plantae|Magnoliophyta|Magnoliopsida|Lamiales|Acanthaceae|Beloperone|eustachyana|Beloperone eustachyana Benth. & Hook.f.	4
Thalasseus maximus (Boddaert, 1783)	Animalia|Chordata|Aves|Charadriiformes|Laridae|Thalasseus|maximus|Thalasseus maximus (Boddaert, 1783)	4
Animalia	Animalia|||||||Animalia	4
Quiscalus lugubris Swainson, 1838	Animalia|Chordata|Aves|Passeriformes|Icteridae|Quiscalus|lugubris|Quiscalus lugubris Swainson, 1838	4
Tringa melanoleuca (Gmelin, 1789)	Animalia|Chordata|Aves|Charadriiformes|Scolopacidae|Tringa|melanoleuca|Tringa melanoleuca (Gmelin, 1789)	4
Beloperone eustachiana (Jacq.) Benth.	Plantae|Tracheophyta|Magnoliopsida|Lamiales|Acanthaceae|Justicia|eustachiana|Beloperone eustachiana (Jacq.) Benth.	4
Haematopus palliatus Temminck, 1820	Animalia|Chordata|Aves|Charadriiformes|Haematopodidae|Haematopus|palliatus|Haematopus palliatus Temminck, 1820	3
Passiflora suberosa var. suberosa	Plantae|Tracheophyta|Magnoliopsida|Malpighiales|Passifloraceae|Passiflora|suberosa|Passiflora suberosa var. suberosa	3
Setophaga petechia (Linnaeus, 1766)	Animalia|Chordata|Aves|Passeriformes|Parulidae|Setophaga|petechia|Setophaga petechia (Linnaeus, 1766)	3
Bubulcus ibis (Linnaeus, 1758)	Animalia|Chordata|Aves|Pelecaniformes|Ardeidae|Bubulcus|ibis|Bubulcus ibis (Linnaeus, 1758)	3
Bourreria succulenta Jacq.	Plantae|Tracheophyta|Magnoliopsida|Boraginales|Boraginaceae|Bourreria|succulenta|Bourreria succulenta Jacq.	3
Phaethon lepturus Daudin, 1802	Animalia|Chordata|Aves|Phaethontiformes|Phaethontidae|Phaethon|lepturus|Phaethon lepturus Daudin, 1802	3
Lecidea Ach.	Fungi|Ascomycota|Lecanoromycetes|Lecanorales|Lecideaceae|Lecidea||Lecidea Ach.	3
Bourreria baccata Raf.	Plantae|Magnoliophyta|Magnoliopsida|Boraginales|Boraginaceae|Bourreria|baccata|Bourreria baccata Raf.	3
Charadrius semipalmatus Bonaparte, 1825	Animalia|Chordata|Aves|Charadriiformes|Charadriidae|Charadrius|semipalmatus|Charadrius semipalmatus Bonaparte, 1825	3
Phaethon aethereus Linnaeus, 1758	Animalia|Chordata|Aves|Phaethontiformes|Phaethontidae|Phaëthon|aethereus|Phaethon aethereus Linnaeus, 1758	3
Enneanectes altivelis Rosenblatt, 1960	Animalia|Chordata|Actinopterygii|Perciformes|Tripterygiidae|Enneanectes|altivelis|Enneanectes altivelis Rosenblatt, 1960	3
Pertusaria leioplaca var. clausa Ach.	Fungi|Ascomycota|Lecanoromycetes|Pertusariales|Pertusariaceae|Pertusaria|leioplaca|Pertusaria leioplaca var. clausa Ach.	2
Aprognathodon platyventris Böhlke, 1967	Animalia|Chordata|Actinopterygii|Anguilliformes|Ophichthidae|Aprognathodon|platyventris|Aprognathodon platyventris Böhlke, 1967	2
Forestiera segregata (Jacq.) Krug & Urb.	Plantae|Tracheophyta|Magnoliopsida|Lamiales|Oleaceae|Forestiera|segregata|Forestiera segregata (Jacq.) Krug & Urb.	2
Nyctanassa violacea (Linnaeus, 1758)	Animalia|Chordata|Aves|Pelecaniformes|Ardeidae|Nyctanassa|violacea|Nyctanassa violacea (Linnaeus, 1758)	2
Caloplaca cinnabarina (Ach.) Zahlbr.	Fungi|Ascomycota|Lecanoromycetes|Teloschistales|Teloschistaceae|Caloplaca|cinnabarina|Caloplaca cinnabarina (Ach.) Zahlbr.	2
Anchoa lyolepis (Evermann & Marsh, 1900)	Animalia|Chordata|Actinopterygii|Clupeiformes|Engraulidae|Anchoa|lyolepis|Anchoa lyolepis (Evermann & Marsh, 1900)	2
Conocarpus erectus L.	Plantae|Tracheophyta|Magnoliopsida|Myrtales|Combretaceae|Conocarpus|erectus|Conocarpus erectus L.	2
Forestiera segregata (Jacq.) Krug & Urb.	Plantae|Magnoliophyta|Magnoliopsida|Lamiales|Oleaceae|Forestiera|segregata|Forestiera segregata (Jacq.) Krug & Urb.	2
Callisia monandra (Sw.) Schult. & Schult.f.	Plantae|Tracheophyta|Liliopsida|Commelinales|Commelinaceae|Callisia|monandra|Callisia monandra (Sw.) Schult. & Schult.f.	2
Ogcocephalus nasutus (Cuvier, 1829)	Animalia|Chordata|Actinopterygii|Lophiiformes|Ogcocephalidae|Ogcocephalus|nasutus|Ogcocephalus nasutus (Cuvier, 1829)	2
Jacquinia armillaris Jacq.	Plantae|Magnoliophyta|Magnoliopsida|Ericales|Primulaceae|Jacquinia|armillaris|Jacquinia armillaris Jacq.	2
Stichodactyla helianthus (Ellis, 1768)	Animalia|Cnidaria|Anthozoa|Actiniaria|Stichodactylidae|Stichodactyla|helianthus|Stichodactyla helianthus (Ellis, 1768)	2
Pandion haliaetus (Linnaeus, 1758)	Animalia|Chordata|Aves|Accipitriformes|Pandionidae|Pandion|haliaetus|Pandion haliaetus (Linnaeus, 1758)	2
Lecanora prosecha Ach.	Fungi|Ascomycota|Lecanoromycetes|Lecanorales|Lecanoraceae|Lecanora|prosecha|Lecanora prosecha Ach.	2
Eulampis jugularis (Linnaeus, 1766)	Animalia|Chordata|Aves|Apodiformes|Trochilidae|Eulampis|jugularis|Eulampis jugularis (Linnaeus, 1766)	2
Jacquinia armillaris Jacq.	Plantae|Tracheophyta|Magnoliopsida|Ericales|Primulaceae|Jacquinia|armillaris|Jacquinia armillaris Jacq.	2
Merremia quinquefolia (L.) Hallier f.	Plantae|Magnoliophyta|Magnoliopsida|Solanales|Convolvulaceae|Merremia|quinquefolia|Merremia quinquefolia (L.) Hallier f.	2
Merremia quinquefolia (L.) Hall. fil.	Plantae|Tracheophyta|Magnoliopsida|Solanales|Convolvulaceae|Merremia|quinquefolia|Merremia quinquefolia (L.) Hall. fil.	2
Fulica americana Gmelin, 1789	Animalia|Chordata|Aves|Gruiformes|Rallidae|Fulica|americana|Fulica americana Gmelin, 1789	2
Monophyllus plethodon Miller, 1900	Animalia|Chordata|Mammalia|Chiroptera|Phyllostomidae|Monophyllus|plethodon|Monophyllus plethodon Miller, 1900	2
Sphenotrochus lindstroemi Cairns, 2000	Animalia|Cnidaria|Anthozoa|Scleractinia|Turbinoliidae|Sphenotrochus|lindstroemi|Sphenotrochus lindstroemi Cairns, 2000	2
Jacquinia arborea Vahl	Plantae|Tracheophyta|Magnoliopsida|Ericales|Primulaceae|Jacquinia|arborea|Jacquinia arborea Vahl	2
Jacquinia arborea Vahl	Plantae|Magnoliophyta|Magnoliopsida|Ericales|Primulaceae|Jacquinia|arborea|Jacquinia arborea Vahl	2
Anous stolidus (Linnaeus, 1758)	Animalia|Chordata|Aves|Charadriiformes|Laridae|Anous|stolidus|Anous stolidus (Linnaeus, 1758)	2
Patagioenas squamosa (Bonnaterre, 1792)	Animalia|Chordata|Aves|Columbiformes|Columbidae|Patagioenas|squamosa|Patagioenas squamosa (Bonnaterre, 1792)	2
Charadrius wilsonia Ord, 1814	Animalia|Chordata|Aves|Charadriiformes|Charadriidae|Charadrius|wilsonia|Charadrius wilsonia Ord, 1814	2
Callisia monandra (Sw.) Schult. & Schult.f.	Plantae|Magnoliophyta|Liliopsida|Commelinales|Commelinaceae|Callisia|monandra|Callisia monandra (Sw.) Schult. & Schult.f.	2
Conocarpus erectus L.	Plantae|Magnoliophyta|Magnoliopsida|Myrtales|Combretaceae|Conocarpus|erectus|Conocarpus erectus L.	2
Oxyura jamaicensis (Gmelin, 1789)	Animalia|Chordata|Aves|Anseriformes|Anatidae|Oxyura|jamaicensis|Oxyura jamaicensis (Gmelin, 1789)	2
Spiloma verrucaria Ach.	Fungi|Ascomycota|Lecanoromycetes|Agyriales|Agyriaceae|Spiloma|verrucaria|Spiloma verrucaria Ach.	2
Chloris virgata Sw.	Plantae|Tracheophyta|Liliopsida|Poales|Poaceae|Chloris|virgata|Chloris virgata Sw.	1
Croton astroites Aiton	Plantae|Magnoliophyta|Magnoliopsida|Malpighiales|Euphorbiaceae|Croton|astroites|Croton astroites Aiton	1
Cyanthillium cinereum (L.) H. Rob.	Plantae|Tracheophyta|Magnoliopsida|Asterales|Asteraceae|Cyanthillium|cinereum|Cyanthillium cinereum (L.) H. Rob.	1
Chamaesyce hirta (L.) Millsp.	Plantae|Magnoliophyta|Magnoliopsida|Malpighiales|Euphorbiaceae|Euphorbia|hirta|Chamaesyce hirta (L.) Millsp.	1
Heliotropium angiospermum Murray	Plantae|Magnoliophyta|Magnoliopsida|Boraginales|Boraginaceae|Heliotropium|angiospermum|Heliotropium angiospermum Murray	1
Stylosanthes hamata (L.) Taub.	Plantae|Magnoliophyta|Magnoliopsida|Fabales|Fabaceae|Stylosanthes|hamata|Stylosanthes hamata (L.) Taub.	1
Passiflora foetida L.	Plantae|Tracheophyta|Magnoliopsida|Malpighiales|Passifloraceae|Passiflora|foetida|Passiflora foetida L.	1
Rhynchosia minima (L.) DC.	Plantae|Magnoliophyta|Magnoliopsida|Fabales|Fabaceae|Rhynchosia|minima|Rhynchosia minima (L.) DC.	1
Callisia fragrans (Lindl.) Woodson	Plantae|Tracheophyta|Liliopsida|Commelinales|Commelinaceae|Callisia|fragrans|Callisia fragrans (Lindl.) Woodson	1
Lecidea oolithina Nyl.	Fungi|Ascomycota|Lecanoromycetes|Lecanorales|Lecideaceae|Lecidea|oolithina|Lecidea oolithina Nyl.	1
Sorghum halepense (L.) Pers.	Plantae|Tracheophyta|Liliopsida|Poales|Poaceae|Sorghum|halepense|Sorghum halepense (L.) Pers.	1
Piper distachyon Hill	Plantae|Magnoliophyta|Magnoliopsida|Piperales|Piperaceae|Piper|distachyon|Piper distachyon Hill	1
Sesuvium portulacastrum (L.) L.	Plantae|Magnoliophyta|Magnoliopsida|Caryophyllales|Aizoaceae|Sesuvium|portulacastrum|Sesuvium portulacastrum (L.) L.	1
Capparis cynophallophora L.	Plantae|Tracheophyta|Magnoliopsida|Brassicales|Capparaceae|Quadrella|cynophallophora|Capparis cynophallophora L.	1
Tecoma stans (L.) Juss. ex Kunth	Plantae|Tracheophyta|Magnoliopsida|Lamiales|Bignoniaceae|Tecoma|stans|Tecoma stans (L.) Juss. ex Kunth	1
Crossopetalum rhacome Crantz	Plantae|Magnoliophyta|Magnoliopsida|Celastrales|Celastraceae|Crossopetalum|rhacome|Crossopetalum rhacome Crantz	1
Leucaena leucocephala (Lam.) de Wit	Plantae|Tracheophyta|Magnoliopsida|Fabales|Fabaceae|Leucaena|leucocephala|Leucaena leucocephala (Lam.) de Wit	1
Epipremnum pinnatum (L.) Engl.	Plantae|Tracheophyta|Liliopsida|Alismatales|Araceae|Epipremnum|pinnatum|Epipremnum pinnatum (L.) Engl.	1
Bothriochloa pertusa (L.) A.Camus	Plantae|Tracheophyta|Liliopsida|Poales|Poaceae|Bothriochloa|pertusa|Bothriochloa pertusa (L.) A.Camus	1
Sternula antillarum Lesson, 1847	Animalia|Chordata|Aves|Charadriiformes|Laridae|Sternula|antillarum|Sternula antillarum Lesson, 1847	1
Stachytarpheta jamaicensis (L.) Vahl	Plantae|Tracheophyta|Magnoliopsida|Lamiales|Verbenaceae|Stachytarpheta|jamaicensis|Stachytarpheta jamaicensis (L.) Vahl	1
Croton lobatus L.	Plantae|Magnoliophyta|Magnoliopsida|Malpighiales|Euphorbiaceae|Astraea|lobatus|Croton lobatus L.	1
Biatora E.M. Fries, 1817	Fungi|Ascomycota|Lecanoromycetes|Lecanorales|Ramalinaceae|Biatora||Biatora E.M. Fries, 1817	1
Cornicularia crocea Ach.	Fungi|Ascomycota|Lecanoromycetes|Teloschistales|Teloschistaceae|Teloschistes|crocea|Cornicularia crocea Ach.	1
Sesuvium maritimum (Walter) Britton, Sterns & Poggenburg, 1888	Plantae|Tracheophyta|Magnoliopsida|Caryophyllales|Aizoaceae|Sesuvium|maritimum|Sesuvium maritimum (Walter) Britton, Sterns & Poggenburg, 1888	1
Stachytarpheta jamaicensis (L.) Vahl	Plantae|Magnoliophyta|Magnoliopsida|Lamiales|Verbenaceae|Stachytarpheta|jamaicensis|Stachytarpheta jamaicensis (L.) Vahl	1
Sesuvium portulacastrum (L.) L.	Plantae|Tracheophyta|Magnoliopsida|Caryophyllales|Aizoaceae|Sesuvium|portulacastrum|Sesuvium portulacastrum (L.) L.	1
Sporobolus virginicus (L.) Kunth	Plantae|Tracheophyta|Liliopsida|Poales|Poaceae|Sporobolus|virginicus|Sporobolus virginicus (L.) Kunth	1
Epipremnum pinnatum (L.) Engl.	Plantae|Magnoliophyta|Liliopsida|Alismatales|Araceae|Epipremnum|pinnatum|Epipremnum pinnatum (L.) Engl.	1
Piper distachyon Hill	Plantae|Tracheophyta|Magnoliopsida|Piperales|Piperaceae|Piper|distachyon|Piper distachyon Hill	1
Calidris himantopus (Bonaparte, 1826)	Animalia|Chordata|Aves|Charadriiformes|Scolopacidae|Calidris|himantopus|Calidris himantopus (Bonaparte, 1826)	1
Lecidea antillarum Ach., 1810	Fungi|Ascomycota|Lecanoromycetes|Lecanorales|Psoraceae|Brianaria|antillarum|Lecidea antillarum Ach., 1810	1
Thespesia populnea (L.) Soland. ex Correa	Plantae|Tracheophyta|Magnoliopsida|Malvales|Malvaceae|Thespesia|populnea|Thespesia populnea (L.) Soland. ex Correa	1
Stigmaphyllon emarginatum (Cav.) A. Juss.	Plantae|Magnoliophyta|Magnoliopsida|Malpighiales|Malpighiaceae|Stigmaphyllon|emarginatum|Stigmaphyllon emarginatum (Cav.) A. Juss.	1
Acacia nilotica (L.) Delile	Plantae|Magnoliophyta|Magnoliopsida|Fabales|Fabaceae|Acacia|nilotica|Acacia nilotica (L.) Delile	1
Suriana maritima L.	Plantae|Tracheophyta|Magnoliopsida|Fabales|Surianaceae|Suriana|maritima|Suriana maritima L.	1
Lecanora Ach., 1809	Fungi|Ascomycota|Lecanoromycetes|Lecanorales|Lecanoraceae|Lecanora||Lecanora Ach., 1809	1
Bouteloua americana (L.) Scribn.	Plantae|Tracheophyta|Liliopsida|Poales|Poaceae|Bouteloua|americana|Bouteloua americana (L.) Scribn.	1
Fissidens hornschuchii Montagne, 1840	Plantae|Bryophyta|Bryopsida|Fissidentales|Fissidentaceae|Fissidens|hornschuchii|Fissidens hornschuchii Montagne, 1840	1
Anas bahamensis Linnaeus, 1758	Animalia|Chordata|Aves|Anseriformes|Anatidae|Anas|bahamensis|Anas bahamensis Linnaeus, 1758	1
Eugenia axillaris (Sw.) Willd.	Plantae|Tracheophyta|Magnoliopsida|Myrtales|Myrtaceae|Eugenia|axillaris|Eugenia axillaris (Sw.) Willd.	1
Progne dominicensis (J. F. Gmelin, 1789)	Animalia|Chordata|Aves|Passeriformes|Hirundinidae|Progne|dominicensis|Progne dominicensis (J. F. Gmelin, 1789)	1
Vernonia albicaulis (Vahl ex Pers.) Vahl ex Pers.	Plantae|Tracheophyta|Magnoliopsida|Asterales|Asteraceae|Vernonia|albicaulis|Vernonia albicaulis (Vahl ex Pers.) Vahl ex Pers.	1
Samyda dodecandra Jacq.	Plantae|Magnoliophyta|Magnoliopsida|Malpighiales|Salicaceae|Samyda|dodecandra|Samyda dodecandra Jacq.	1
Cordia bullata (L.) Roem. & Schult.	Plantae|Tracheophyta|Magnoliopsida|Boraginales|Boraginaceae|Varronia|bullata|Cordia bullata (L.) Roem. & Schult.	1
Vachellia tortuosa (L.) Seigler & Ebinger	Plantae|Tracheophyta|Magnoliopsida|Fabales|Fabaceae|Vachellia|tortuosa|Vachellia tortuosa (L.) Seigler & Ebinger	1
Cayaponia americana (Lam.) Cogn.	Plantae|Tracheophyta|Magnoliopsida|Cucurbitales|Cucurbitaceae|Cayaponia|americana|Cayaponia americana (Lam.) Cogn.	1
Hymenaea courbaril L.	Plantae|Magnoliophyta|Magnoliopsida|Fabales|Fabaceae|Hymenaea|courbaril|Hymenaea courbaril L.	1
Solanum bahamense L.	Plantae|Tracheophyta|Magnoliopsida|Solanales|Solanaceae|Solanum|bahamense|Solanum bahamense L.	1
Chamaesyce hypericifolia (L.) Millsp.	Plantae|Magnoliophyta|Magnoliopsida|Malpighiales|Euphorbiaceae|Euphorbia|hypericifolia|Chamaesyce hypericifolia (L.) Millsp.	1
Callisia fragrans (Lindl.) Woodson	Plantae|Magnoliophyta|Liliopsida|Commelinales|Commelinaceae|Callisia|fragrans|Callisia fragrans (Lindl.) Woodson	1
Biatora Fr.	Fungi|Ascomycota|Lecanoromycetes|Lecanorales|Ramalinaceae|Biatora||Biatora Fr.	1
Capparis cynophallophora L.	Plantae|Magnoliophyta|Magnoliopsida|Brassicales|Capparaceae|Quadrella|cynophallophora|Capparis cynophallophora L.	1
Bothriochloa ischaemum (L.) Keng	Plantae|Tracheophyta|Liliopsida|Poales|Poaceae|Bothriochloa|ischaemum|Bothriochloa ischaemum (L.) Keng	1
Patagioenas leucocephala (Linnaeus, 1758)	Animalia|Chordata|Aves|Columbiformes|Columbidae|Patagioenas|leucocephala|Patagioenas leucocephala (Linnaeus, 1758)	1
Xylocopa caribea Lepeletier, 1841	Animalia|Arthropoda|Insecta|Hymenoptera|Apidae|Xylocopa|caribea|Xylocopa caribea Lepeletier, 1841	1
Euphorbia balbisii Boiss.	Plantae|Tracheophyta|Magnoliopsida|Malpighiales|Euphorbiaceae|Euphorbia|balbisii|Euphorbia balbisii Boiss.	1
Sphagneticola trilobata (L.) Pruski	Plantae|Magnoliophyta|Magnoliopsida|Asterales|Asteraceae|Sphagneticola|trilobata|Sphagneticola trilobata (L.) Pruski	1
Cayaponia americana (Lam.) Cogn.	Plantae|Magnoliophyta|Magnoliopsida|Cucurbitales|Cucurbitaceae|Cayaponia|americana|Cayaponia americana (Lam.) Cogn.	1
Avicennia germinans (L.) L.	Plantae|Magnoliophyta|Magnoliopsida|Lamiales|Acanthaceae|Avicennia|germinans|Avicennia germinans (L.) L.	1
Pseudogynoxys chenopodioides (Kunth) Cabrera	Plantae|Tracheophyta|Magnoliopsida|Asterales|Asteraceae|Pseudogynoxys|chenopodioides|Pseudogynoxys chenopodioides (Kunth) Cabrera	1
Euphorbia hyssopifolia L.	Plantae|Tracheophyta|Magnoliopsida|Malpighiales|Euphorbiaceae|Euphorbia|hyssopifolia|Euphorbia hyssopifolia L.	1
Tabebuia lepidota (Kunth) Britt.	Plantae|Tracheophyta|Magnoliopsida|Lamiales|Bignoniaceae|Tabebuia|lepidota|Tabebuia lepidota (Kunth) Britt.	1
Lecanora Ach.	Fungi|Ascomycota|Lecanoromycetes|Lecanorales|Lecanoraceae|Lecanora||Lecanora Ach.	1
Rhizophora mangle L.	Plantae|Magnoliophyta|Magnoliopsida|Malpighiales|Rhizophoraceae|Rhizophora|mangle|Rhizophora mangle L.	1
Pithecellobium unguis-cati (L.) Benth.	Plantae|Magnoliophyta|Magnoliopsida|Fabales|Fabaceae|Pithecellobium|unguis-cati|Pithecellobium unguis-cati (L.) Benth.	1
Setophaga petechia	Animalia|Chordata|Aves|Passeriformes|Parulidae|Setophaga|petechia|Setophaga petechia	1
Cornicularia crocea Ach.	Fungi|Ascomycota|Lecanoromycetes|Lecanorales|Parmeliaceae|Cornicularia|crocea|Cornicularia crocea Ach.	1
Lecidea antillarum Ach.	Fungi|Ascomycota|Lecanoromycetes|Lecanorales|Pilocarpaceae|Micarea|antillarum|Lecidea antillarum Ach.	1
Sporobolus virginicus (L.) Kunth	Plantae|Magnoliophyta|Liliopsida|Poales|Poaceae|Sporobolus|virginicus|Sporobolus virginicus (L.) Kunth	1
Chamaecrista obcordata (Sw.) Britton	Plantae|Magnoliophyta|Magnoliopsida|Fabales|Fabaceae|Chamaecrista|obcordata|Chamaecrista obcordata (Sw.) Britton	1
Panicum maximum Jacq.	Plantae|Magnoliophyta|Liliopsida|Poales|Poaceae|Panicum|maximum|Panicum maximum Jacq.	1
Gambierdiscus toxicus Adachi & Fukuyo	Protozoa|Dinophyta|Dinophyceae|Gonyaulacales|Goniodomataceae|Gambierdiscus|toxicus|Gambierdiscus toxicus Adachi & Fukuyo	1
Cyphomyrmex minutus Mayr, 1862	Animalia|Arthropoda|Insecta|Hymenoptera|Formicidae|Cyphomyrmex|minutus|Cyphomyrmex minutus Mayr, 1862	1
Lantana involucrata L.	Plantae|Tracheophyta|Magnoliopsida|Lamiales|Verbenaceae|Lantana|involucrata|Lantana involucrata L.	1
Thespesia populnea (L.) Sol. ex Corrêa	Plantae|Magnoliophyta|Magnoliopsida|Malvales|Malvaceae|Thespesia|populnea|Thespesia populnea (L.) Sol. ex Corrêa	1
Porzana carolina (Linnaeus, 1758)	Animalia|Chordata|Aves|Gruiformes|Rallidae|Porzana|carolina|Porzana carolina (Linnaeus, 1758)	1
Bastardia viscosa (L.) Kunth	Plantae|Tracheophyta|Magnoliopsida|Malvales|Malvaceae|Abutilon|viscosa|Bastardia viscosa (L.) Kunth	1
Tridax procumbens L.	Plantae|Magnoliophyta|Magnoliopsida|Asterales|Asteraceae|Tridax|procumbens|Tridax procumbens L.	1
Allenia fusca (Müller, 1776)	Animalia|Chordata|Aves|Passeriformes|Mimidae|Allenia|fusca|Allenia fusca (Müller, 1776)	1
Croton astroites Dryand.	Plantae|Tracheophyta|Magnoliopsida|Malpighiales|Euphorbiaceae|Croton|astroites|Croton astroites Dryand.	1
Holacanthus tricolor (Bloch, 1795)	Animalia|Chordata|Actinopterygii|Perciformes|Pomacanthidae|Holacanthus|tricolor|Holacanthus tricolor (Bloch, 1795)	1
Charadrius nivosus (Cassin, 1858)	Animalia|Chordata|Aves|Charadriiformes|Charadriidae|Charadrius|nivosus|Charadrius nivosus (Cassin, 1858)	1
Ipomoea hederifolia L.	Plantae|Magnoliophyta|Magnoliopsida|Solanales|Convolvulaceae|Ipomoea|hederifolia|Ipomoea hederifolia L.	1
Setophaga discolor	Animalia|Chordata|Aves|Passeriformes|Parulidae|Setophaga|discolor|Setophaga discolor	1
Cordia bullata Roem. & Schult.	Plantae|Magnoliophyta|Magnoliopsida|Boraginales|Boraginaceae|Cordia|bullata|Cordia bullata Roem. & Schult.	1
Tridax procumbens L.	Plantae|Tracheophyta|Magnoliopsida|Asterales|Asteraceae|Tridax|procumbens|Tridax procumbens L.	1
Pithecellobium unguis-cati (L.) Benth.	Plantae|Tracheophyta|Magnoliopsida|Fabales|Fabaceae|Pithecellobium|unguis-cati|Pithecellobium unguis-cati (L.) Benth.	1
Allenia fusca (Statius Muller, 1776)	Animalia|Chordata|Aves|Passeriformes|Mimidae|Allenia|fusca|Allenia fusca (Statius Muller, 1776)	1
Limnodromus griseus (Gmelin, 1789)	Animalia|Chordata|Aves|Charadriiformes|Scolopacidae|Limnodromus|griseus|Limnodromus griseus (Gmelin, 1789)	1
Rhynchosia reticulata (Sw.) DC.	Plantae|Tracheophyta|Magnoliopsida|Fabales|Fabaceae|Rhynchosia|reticulata|Rhynchosia reticulata (Sw.) DC.	1
Avicennia germinans (L.) L.	Plantae|Tracheophyta|Magnoliopsida|Lamiales|Acanthaceae|Avicennia|germinans|Avicennia germinans (L.) L.	1
Capraria biflora L.	Plantae|Magnoliophyta|Magnoliopsida|Lamiales|Scrophulariaceae|Capraria|biflora|Capraria biflora L.	1
Pseudogynoxys chenopodioides (Kunth) Cabrera	Plantae|Magnoliophyta|Magnoliopsida|Asterales|Asteraceae|Pseudogynoxys|chenopodioides|Pseudogynoxys chenopodioides (Kunth) Cabrera	1
Vernonia arborescens Sw.	Plantae|Magnoliophyta|Magnoliopsida|Asterales|Asteraceae||arborescens|Vernonia arborescens Sw.	1
Chamaesyce balbisii (Boiss.) Millsp.	Plantae|Magnoliophyta|Magnoliopsida|Malpighiales|Euphorbiaceae|Euphorbia|balbisii|Chamaesyce balbisii (Boiss.) Millsp.	1
Bouteloua americana (L.) Scribn.	Plantae|Magnoliophyta|Liliopsida|Poales|Poaceae|Bouteloua|americana|Bouteloua americana (L.) Scribn.	1
Melochia tomentosa L.	Plantae|Magnoliophyta|Magnoliopsida|Malvales|Malvaceae|Melochia|tomentosa|Melochia tomentosa L.	1
Phyllanthus amarus Schumach. & Thonn.	Plantae|Tracheophyta|Magnoliopsida|Malpighiales|Phyllanthaceae|Phyllanthus|amarus|Phyllanthus amarus Schumach. & Thonn.	1
Crossopetalum rhacoma Crantz	Plantae|Tracheophyta|Magnoliopsida|Celastrales|Celastraceae|Crossopetalum|rhacoma|Crossopetalum rhacoma Crantz	1
Thrinax morrisii H.Wendl.	Plantae|Magnoliophyta|Liliopsida|Arecales|Arecaceae|Leucothrinax|morrisii|Thrinax morrisii H.Wendl.	1
Vernonia arborescens (L.) Sw.	Plantae|Tracheophyta|Magnoliopsida|Asterales|Asteraceae|Vernonia|arborescens|Vernonia arborescens (L.) Sw.	1
Canavalia rosea (Sw.) DC.	Plantae|Tracheophyta|Magnoliopsida|Fabales|Fabaceae|Canavalia|rosea|Canavalia rosea (Sw.) DC.	1
Cleome stenophylla Klotzsch ex Urb.	Plantae|Tracheophyta|Magnoliopsida|Brassicales|Cleomaceae|Physostemon|stenophylla|Cleome stenophylla Klotzsch ex Urb.	1
Anas crecca Linnaeus, 1758	Animalia|Chordata|Aves|Anseriformes|Anatidae|Anas|crecca|Anas crecca Linnaeus, 1758	1
Hymenaea courbaril L.	Plantae|Tracheophyta|Magnoliopsida|Fabales|Fabaceae|Hymenaea|courbaril|Hymenaea courbaril L.	1
Ruellia strepens L.	Plantae|Tracheophyta|Magnoliopsida|Lamiales|Acanthaceae|Ruellia|strepens|Ruellia strepens L.	1
Phyllanthus amarus Schumach. & Thonn.	Plantae|Magnoliophyta|Magnoliopsida|Malpighiales|Phyllanthaceae|Phyllanthus|amarus|Phyllanthus amarus Schumach. & Thonn.	1
Chamaecrista obcordata (Sw.) Britton	Plantae|Tracheophyta|Magnoliopsida|Fabales|Fabaceae|Chamaecrista|obcordata|Chamaecrista obcordata (Sw.) Britton	1
Stylosanthes hamata (L.) Taub.	Plantae|Tracheophyta|Magnoliopsida|Fabales|Fabaceae|Stylosanthes|hamata|Stylosanthes hamata (L.) Taub.	1
Plumeria alba L.	Plantae|Tracheophyta|Magnoliopsida|Gentianales|Apocynaceae|Plumeria|alba|Plumeria alba L.	1
Gambierdiscus toxicus R.Adachi & Y.Fukuyo, 1979	Chromista||||Goniodomataceae|Gambierdiscus|toxicus|Gambierdiscus toxicus R.Adachi & Y.Fukuyo, 1979	1
Chamaesyce hyssopifolia (L.) Small	Plantae|Magnoliophyta|Magnoliopsida|Malpighiales|Euphorbiaceae|Euphorbia|hyssopifolia|Chamaesyce hyssopifolia (L.) Small	1
Asystasia gangetica (L.) T. Anderson	Plantae|Magnoliophyta|Magnoliopsida|Lamiales|Acanthaceae|Asystasia|gangetica|Asystasia gangetica (L.) T. Anderson	1
Croton flavens L.	Plantae|Tracheophyta|Magnoliopsida|Malpighiales|Euphorbiaceae|Croton|flavens|Croton flavens L.	1
Talipariti tiliaceum (L.) Fryxell	Plantae|Tracheophyta|Magnoliopsida|Malvales|Malvaceae|Talipariti|tiliaceum|Talipariti tiliaceum (L.) Fryxell	1
Chamaecrista glandulosa (L.) Greene	Plantae|Magnoliophyta|Magnoliopsida|Fabales|Fabaceae|Chamaecrista|glandulosa|Chamaecrista glandulosa (L.) Greene	1
Megathyrsus maximus (Jacq.) B.K.Simon & S.W.L.Jacobs	Plantae|Tracheophyta|Liliopsida|Poales|Poaceae|Panicum|maximus|Megathyrsus maximus (Jacq.) B.K.Simon & S.W.L.Jacobs	1
Tabebuia lepidota Britton.	Plantae|Magnoliophyta|Magnoliopsida|Lamiales|Bignoniaceae|Tabebuia|lepidota|Tabebuia lepidota Britton.	1
Rhynchosia reticulata (Sw.) DC.	Plantae|Magnoliophyta|Magnoliopsida|Fabales|Fabaceae|Rhynchosia|reticulata|Rhynchosia reticulata (Sw.) DC.	1
Solanum bahamense L.	Plantae|Magnoliophyta|Magnoliopsida|Solanales|Solanaceae|Solanum|bahamense|Solanum bahamense L.	1
Leucaena leucocephala (Lam.) de Wit	Plantae|Magnoliophyta|Magnoliopsida|Fabales|Fabaceae|Leucaena|leucocephala|Leucaena leucocephala (Lam.) de Wit	1
Lantana involucrata L.	Plantae|Magnoliophyta|Magnoliopsida|Lamiales|Verbenaceae|Lantana|involucrata|Lantana involucrata L.	1
Sporobolus domingensis (Trin.) Kunth	Plantae|Magnoliophyta|Liliopsida|Poales|Poaceae|Sporobolus|domingensis|Sporobolus domingensis (Trin.) Kunth	1
Plumeria alba L.	Plantae|Magnoliophyta|Magnoliopsida|Gentianales|Apocynaceae|Plumeria|alba|Plumeria alba L.	1
Rhizophora mangle L.	Plantae|Tracheophyta|Magnoliopsida|Malpighiales|Rhizophoraceae|Rhizophora|mangle|Rhizophora mangle L.	1
Sorghum halepense (L.) Pers.	Plantae|Magnoliophyta|Liliopsida|Poales|Poaceae|Sorghum|halepense|Sorghum halepense (L.) Pers.	1
Bastardia viscosa (L.) Kunth	Plantae|Magnoliophyta|Magnoliopsida|Malvales|Malvaceae|Bastardia|viscosa|Bastardia viscosa (L.) Kunth	1
Chamaecrista glandulosa (L.) Greene	Plantae|Tracheophyta|Magnoliopsida|Fabales|Fabaceae|Chamaecrista|glandulosa|Chamaecrista glandulosa (L.) Greene	1
Buteo jamaicensis (Gmelin, 1788)	Animalia|Chordata|Aves|Accipitriformes|Accipitridae|Buteo|jamaicensis|Buteo jamaicensis (Gmelin, 1788)	1
Bothriochloa pertusa (L.) A.Camus	Plantae|Magnoliophyta|Liliopsida|Poales|Poaceae|Bothriochloa|pertusa|Bothriochloa pertusa (L.) A.Camus	1
Sphagneticola trilobata (L.) Pruski	Plantae|Tracheophyta|Magnoliopsida|Asterales|Asteraceae|Sphagneticola|trilobata|Sphagneticola trilobata (L.) Pruski	1
Euphorbia hypericifolia L.	Plantae|Tracheophyta|Magnoliopsida|Malpighiales|Euphorbiaceae|Euphorbia|hypericifolia|Euphorbia hypericifolia L.	1
Fulica caribaea Ridgway, 1884	Animalia|Chordata|Aves|Gruiformes|Rallidae|Fulica|caribaea|Fulica caribaea Ridgway, 1884	1
Samyda dodecandra Jacq.	Plantae|Tracheophyta|Magnoliopsida|Malpighiales|Salicaceae|Samyda|dodecandra|Samyda dodecandra Jacq.	1
Stigmaphyllon emarginatum (Cav.) A. Juss.	Plantae|Tracheophyta|Magnoliopsida|Malpighiales|Malpighiaceae|Stigmaphyllon|emarginatum|Stigmaphyllon emarginatum (Cav.) A. Juss.	1
Sula sula (Linnaeus, 1766)	Animalia|Chordata|Aves|Suliformes|Sulidae|Sula|sula|Sula sula (Linnaeus, 1766)	1
Melochia tomentosa L.	Plantae|Tracheophyta|Magnoliopsida|Malvales|Malvaceae|Melochia|tomentosa|Melochia tomentosa L.	1
Vernonia albicaulis (Vahl ex Pers.) Vahl ex Pers.	Plantae|Magnoliophyta|Magnoliopsida|Asterales|Asteraceae|Lepidaploa|albicaulis|Vernonia albicaulis (Vahl ex Pers.) Vahl ex Pers.	1
Ipomoea hederifolia L.	Plantae|Tracheophyta|Magnoliopsida|Solanales|Convolvulaceae|Ipomoea|hederifolia|Ipomoea hederifolia L.	1
Setophaga discolor (Vieillot, 1809)	Animalia|Chordata|Aves|Passeriformes|Parulidae|Setophaga|discolor|Setophaga discolor (Vieillot, 1809)	1
Centrosema virginianum (L.) Benth.	Plantae|Magnoliophyta|Magnoliopsida|Fabales|Fabaceae|Centrosema|virginianum|Centrosema virginianum (L.) Benth.	1
Euphorbia cyathophora Murray	Plantae|Magnoliophyta|Magnoliopsida|Malpighiales|Euphorbiaceae|Euphorbia|cyathophora|Euphorbia cyathophora Murray	1
Euphorbia cyathophora Murray	Plantae|Tracheophyta|Magnoliopsida|Malpighiales|Euphorbiaceae|Euphorbia|cyathophora|Euphorbia cyathophora Murray	1
Talipariti tiliaceum (L.) Fryxell	Plantae|Magnoliophyta|Magnoliopsida|Malvales|Malvaceae|Talipariti|tiliaceum|Talipariti tiliaceum (L.) Fryxell	1
Cassidulus caribaearum Lamarck, 1801	Animalia|Echinodermata|Echinoidea|Cassiduloida|Cassidulidae|Cassidulus|caribaearum|Cassidulus caribaearum Lamarck, 1801	1
Capraria biflora L.	Plantae|Tracheophyta|Magnoliopsida|Lamiales|Scrophulariaceae|Capraria|biflora|Capraria biflora L.	1
Gouania lupuloides (L.) Urb.	Plantae|Tracheophyta|Magnoliopsida|Rosales|Rhamnaceae|Gouania|lupuloides|Gouania lupuloides (L.) Urb.	1
Eugenia axillaris (Sw.) Willd.	Plantae|Magnoliophyta|Magnoliopsida|Myrtales|Myrtaceae|Eugenia|axillaris|Eugenia axillaris (Sw.) Willd.	1
Sporobolus domingensis (Trin.) Kunth	Plantae|Tracheophyta|Liliopsida|Poales|Poaceae|Sporobolus|domingensis|Sporobolus domingensis (Trin.) Kunth	1
Thrinax morrisii H.Wendl.	Plantae|Tracheophyta|Liliopsida|Arecales|Arecaceae|Leucothrinax|morrisii|Thrinax morrisii H.Wendl.	1
Euphorbia hirta L.	Plantae|Tracheophyta|Magnoliopsida|Malpighiales|Euphorbiaceae|Euphorbia|hirta|Euphorbia hirta L.	1
Progne dominicensis (Gmelin, 1789)	Animalia|Chordata|Aves|Passeriformes|Hirundinidae|Progne|dominicensis|Progne dominicensis (Gmelin, 1789)	1
Centrosema virginianum (L.) Benth.	Plantae|Tracheophyta|Magnoliopsida|Fabales|Fabaceae|Centrosema|virginianum|Centrosema virginianum (L.) Benth.	1
Heliotropium angiospermum Murray	Plantae|Tracheophyta|Magnoliopsida|Boraginales|Boraginaceae|Heliotropium|angiospermum|Heliotropium angiospermum Murray	1
Cyanthillium cinereum (L.) H. Rob.	Plantae|Magnoliophyta|Magnoliopsida|Asterales|Asteraceae|Cyanthillium|cinereum|Cyanthillium cinereum (L.) H. Rob.	1
Rhynchosia minima (L.) DC.	Plantae|Tracheophyta|Magnoliopsida|Fabales|Fabaceae|Rhynchosia|minima|Rhynchosia minima (L.) DC.	1
Scaevola plumieri (L.) Vahl	Plantae|Tracheophyta|Magnoliopsida|Asterales|Goodeniaceae|Scaevola|plumieri|Scaevola plumieri (L.) Vahl	1
Passiflora foetida L.	Plantae|Magnoliophyta|Magnoliopsida|Malpighiales|Passifloraceae|Passiflora|foetida|Passiflora foetida L.	1
Sesuvium maritimum (Walter) Britton, Sterns & Poggenb.	Plantae|Magnoliophyta|Magnoliopsida|Caryophyllales|Aizoaceae|Sesuvium|maritimum|Sesuvium maritimum (Walter) Britton, Sterns & Poggenb.	1
Cynanchum L.	Plantae|Tracheophyta|Magnoliopsida|Gentianales|Apocynaceae|Cynanchum||Cynanchum L.	1
Ernodea littoralis Sw.	Plantae|Magnoliophyta|Magnoliopsida|Gentianales|Rubiaceae|Ernodea|littoralis|Ernodea littoralis Sw.	1
Astraea lobata (L.) Klotzsch	Plantae|Tracheophyta|Magnoliopsida|Malpighiales|Euphorbiaceae|Astraea|lobata|Astraea lobata (L.) Klotzsch	1
Asystasia gangetica (L.) T. Anderson	Plantae|Tracheophyta|Magnoliopsida|Lamiales|Acanthaceae|Asystasia|gangetica|Asystasia gangetica (L.) T. Anderson	1
Chloris virgata Sw.	Plantae|Magnoliophyta|Liliopsida|Poales|Poaceae|Chloris|virgata|Chloris virgata Sw.	1
Catharanthus roseus (L.) G. Don	Plantae|Tracheophyta|Magnoliopsida|Gentianales|Apocynaceae|Catharanthus|roseus|Catharanthus roseus (L.) G. Don	1
Cynanchum parviflorum Sw.	Plantae|Magnoliophyta|Magnoliopsida|Gentianales|Apocynaceae|Metastelma|parviflorum|Cynanchum parviflorum Sw.	1