taxonName	taxonPath	recordCount
Columba livia Gmelin, 1789	Animalia|Chordata|Aves|Columbiformes|Columbidae|Columba|livia|Columba livia Gmelin, 1789	7
Turdus merula Linnaeus, 1758	Animalia|Chordata|Aves|Passeriformes|Turdidae|Turdus|merula|Turdus merula Linnaeus, 1758	5
Cyathus striatus (Huds.) Willd., 1787	Fungi|Basidiomycota|Agaricomycetes|Agaricales|Agaricaceae|Cyathus|striatus|Cyathus striatus (Huds.) Willd., 1787	4
Streptopelia decaocto (Frivaldszky, 1838)	Animalia|Chordata|Aves|Columbiformes|Columbidae|Streptopelia|decaocto|Streptopelia decaocto (Frivaldszky, 1838)	4
Phoenicurus phoenicurus (Linnaeus, 1758)	Animalia|Chordata|Aves|Passeriformes|Muscicapidae|Phoenicurus|phoenicurus|Phoenicurus phoenicurus (Linnaeus, 1758)	3
Serinus serinus (Linnaeus, 1766)	Animalia|Chordata|Aves|Passeriformes|Fringillidae|Serinus|serinus|Serinus serinus (Linnaeus, 1766)	3
Passer italiae (Vieillot, 1817)	Animalia|Chordata|Aves|Passeriformes|Passeridae|Passer|italiae|Passer italiae (Vieillot, 1817)	3
Apus apus (Linnaeus, 1758)	Animalia|Chordata|Aves|Apodiformes|Apodidae|Apus|apus|Apus apus (Linnaeus, 1758)	3
Delichon urbicum (Linnaeus, 1758)	Animalia|Chordata|Aves|Passeriformes|Hirundinidae|Delichon|urbicum|Delichon urbicum (Linnaeus, 1758)	2
Lepidium graminifolium subsp. graminifolium	Plantae|Tracheophyta|Magnoliopsida|Brassicales|Brassicaceae|Lepidium|graminifolium|Lepidium graminifolium subsp. graminifolium	2
Rumina decollata (Linnaeus, 1758)	Animalia|Mollusca|Gastropoda|Stylommatophora|Subulinidae|Rumina|decollata|Rumina decollata (Linnaeus, 1758)	2
Lauria cylindracea (da Costa, 1778)	Animalia|Mollusca|Gastropoda|Stylommatophora|Pupillidae|Lauria|cylindracea|Lauria cylindracea (da Costa, 1778)	2
Papilio machaon	Animalia|Arthropoda|Insecta|Lepidoptera|Papilionidae|Papilio|Papilio machaon	2
Iphiclides podalirius	Animalia|Arthropoda|Insecta|Lepidoptera|Papilionidae|Iphiclides|Iphiclides podalirius	2
Quercus petraea (Matt.) Liebl.	Plantae|Tracheophyta|Magnoliopsida|Fagales|Fagaceae|Quercus|petraea|Quercus petraea (Matt.) Liebl.	2
Puccinia glechomatis DC., 1808	Fungi|Basidiomycota|Pucciniomycetes|Pucciniales|Pucciniaceae|Puccinia|glechomatis|Puccinia glechomatis DC., 1808	2
Erysimum cheiri (L.) Crantz	Plantae|Tracheophyta|Magnoliopsida|Brassicales|Brassicaceae|Erysimum|cheiri|Erysimum cheiri (L.) Crantz	2
Apus melba (Linnaeus, 1758)	Animalia|Chordata|Aves|Apodiformes|Apodidae|Apus|melba|Apus melba (Linnaeus, 1758)	2
Erysimum L.	Plantae|Tracheophyta|Magnoliopsida|Brassicales|Brassicaceae|Erysimum||Erysimum L.	2
Corvus monedula Linnaeus, 1758	Animalia|Chordata|Aves|Passeriformes|Corvidae|Coloeus|monedula|Corvus monedula Linnaeus, 1758	2
Quercus petraea (Matt.) Liebl.	Plantae|Magnoliophyta|Magnoliopsida|Fagales|Fagaceae|Quercus|petraea|Quercus petraea (Matt.) Liebl.	2
Erysiphe flexuosa (Peck) U. Braun & S. Takam., 2000	Fungi|Ascomycota|Leotiomycetes|Erysiphales|Erysiphaceae|Erysiphe|flexuosa|Erysiphe flexuosa (Peck) U. Braun & S. Takam., 2000	2
Inocybe godeyi Gillet, 1874	Fungi|Basidiomycota|Agaricomycetes|Agaricales|Inocybaceae|Inocybe|godeyi|Inocybe godeyi Gillet, 1874	2
Fringilla coelebs Linnaeus, 1758	Animalia|Chordata|Aves|Passeriformes|Fringillidae|Fringilla|coelebs|Fringilla coelebs Linnaeus, 1758	2
Acer monspessulanum L.	Plantae|Tracheophyta|Magnoliopsida|Sapindales|Sapindaceae|Acer|monspessulanum|Acer monspessulanum L.	1
Erysimum L.	Plantae|Magnoliophyta|Magnoliopsida|Brassicales|Brassicaceae|Erysimum||Erysimum L.	1
Apera interrupta (L.) P.Beauv.	Plantae|Magnoliophyta|Liliopsida|Poales|Poaceae|Apera|interrupta|Apera interrupta (L.) P.Beauv.	1
Phellinus torulosus (Pers.) Bourdot & Galzin, 1925	Fungi|Basidiomycota|Agaricomycetes|Hymenochaetales|Hymenochaetaceae|Fuscoporia|torulosus|Phellinus torulosus (Pers.) Bourdot & Galzin, 1925	1
Phoenicurus ochruros (S. G. Gmelin, 1774)	Animalia|Chordata|Aves|Passeriformes|Muscicapidae|Phoenicurus|ochruros|Phoenicurus ochruros (S. G. Gmelin, 1774)	1
Artemisia absinthium L.	Plantae|Tracheophyta|Magnoliopsida|Asterales|Asteraceae|Artemisia|absinthium|Artemisia absinthium L.	1
Chloris chloris (Linnaeus, 1758)	Animalia|Chordata|Aves|Passeriformes|Fringillidae|Chloris|chloris|Chloris chloris (Linnaeus, 1758)	1
Erithacus rubecula (Linnaeus, 1758)	Animalia|Chordata|Aves|Passeriformes|Muscicapidae|Erithacus|rubecula|Erithacus rubecula (Linnaeus, 1758)	1
Motacilla alba Linnaeus, 1758	Animalia|Chordata|Aves|Passeriformes|Motacillidae|Motacilla|alba|Motacilla alba Linnaeus, 1758	1
Carduelis carduelis (Linnaeus, 1758)	Animalia|Chordata|Aves|Passeriformes|Fringillidae|Carduelis|carduelis|Carduelis carduelis (Linnaeus, 1758)	1
Campanula rapunculus L.	Plantae|Magnoliophyta|Magnoliopsida|Asterales|Campanulaceae|Campanula|rapunculus|Campanula rapunculus L.	1
Petrorhagia saxifraga (L.) Link	Plantae|Tracheophyta|Magnoliopsida|Caryophyllales|Caryophyllaceae|Petrorhagia|saxifraga|Petrorhagia saxifraga (L.) Link	1
Glechoma hederacea L.	Plantae|Tracheophyta|Magnoliopsida|Lamiales|Lamiaceae|Glechoma|hederacea|Glechoma hederacea L.	1
Pomatias elegans (O. F. M端ller, 1774)	Animalia|Mollusca|Gastropoda|Littorinimorpha|Pomatiidae|Pomatias|elegans|Pomatias elegans (O. F. M端ller, 1774)	1
Passer Brisson, 1760	Animalia|Chordata|Aves|Passeriformes|Passeridae|Passer||Passer Brisson, 1760	1
Titanocetus sammariensis	Animalia|Chordata|Mammalia|Cetacea||Titanocetus|sammariensis|Titanocetus sammariensis	1
Hirundo rustica Linnaeus, 1758	Animalia|Chordata|Aves|Passeriformes|Hirundinidae|Hirundo|rustica|Hirundo rustica Linnaeus, 1758	1
Periparus ater (Linnaeus, 1758)	Animalia|Chordata|Aves|Passeriformes|Paridae|Periparus|ater|Periparus ater (Linnaeus, 1758)	1
Lepidium graminifolium subsp. graminifolium L.	Plantae|Magnoliophyta|Magnoliopsida|Brassicales|Brassicaceae|Lepidium|graminifolium|Lepidium graminifolium subsp. graminifolium L.	1
Buteo buteo (Linnaeus, 1758)	Animalia|Chordata|Aves|Accipitriformes|Accipitridae|Buteo|buteo|Buteo buteo (Linnaeus, 1758)	1
Phellinus torulosus (Pers.) Bourdot & Galzin, 1925	Fungi|Basidiomycota|Agaricomycetes|Hymenochaetales|Hymenochaetaceae|Phellinus|torulosus|Phellinus torulosus (Pers.) Bourdot & Galzin, 1925	1
Acer monspessulanum L.	Plantae|Magnoliophyta|Magnoliopsida|Sapindales|Sapindaceae|Acer|monspessulanum|Acer monspessulanum L.	1
Sturnus vulgaris Linnaeus, 1758	Animalia|Chordata|Aves|Passeriformes|Sturnidae|Sturnus|vulgaris|Sturnus vulgaris Linnaeus, 1758	1
Erysimum cheiri (L.) Crantz	Plantae|Magnoliophyta|Magnoliopsida|Brassicales|Brassicaceae|Erysimum|cheiri|Erysimum cheiri (L.) Crantz	1
Glechoma hederacea L.	Plantae|Magnoliophyta|Magnoliopsida|Lamiales|Lamiaceae|Glechoma|hederacea|Glechoma hederacea L.	1
Petrorhagia saxifraga (L.) Link	Plantae|Magnoliophyta|Magnoliopsida|Caryophyllales|Caryophyllaceae|Petrorhagia|saxifraga|Petrorhagia saxifraga (L.) Link	1
Apera interrupta (L.) P.Beauv.	Plantae|Tracheophyta|Liliopsida|Poales|Poaceae|Apera|interrupta|Apera interrupta (L.) P.Beauv.	1
Aesculus hippocastanum L.	Plantae|Tracheophyta|Magnoliopsida|Sapindales|Sapindaceae|Aesculus|hippocastanum|Aesculus hippocastanum L.	1
Titanocetus sammarinensis (Capellini, 1901)	Animalia|Chordata|Mammalia|Cetacea|Cetotheriidae|Titanocetus|sammarinensis|Titanocetus sammarinensis (Capellini, 1901)	1
Cyanistes caeruleus (Linnaeus, 1758)	Animalia|Chordata|Aves|Passeriformes|Paridae|Cyanistes|caeruleus|Cyanistes caeruleus (Linnaeus, 1758)	1
Pomatias elegans (O.F. M端ller, 1774)	Animalia|Mollusca|Gastropoda|Neotaenioglossa|Pomatiidae|Pomatias|elegans|Pomatias elegans (O.F. M端ller, 1774)	1
Campanula rapunculus L.	Plantae|Tracheophyta|Magnoliopsida|Asterales|Campanulaceae|Campanula|rapunculus|Campanula rapunculus L.	1
Corvus cornix Linnaeus, 1758	Animalia|Chordata|Aves|Passeriformes|Corvidae|Corvus|cornix|Corvus cornix Linnaeus, 1758	1
Garrulus glandarius (Linnaeus, 1758)	Animalia|Chordata|Aves|Passeriformes|Corvidae|Garrulus|glandarius|Garrulus glandarius (Linnaeus, 1758)	1
Aesculus hippocastanum L.	Plantae|Magnoliophyta|Magnoliopsida|Sapindales|Sapindaceae|Aesculus|hippocastanum|Aesculus hippocastanum L.	1