taxonName	taxonPath	recordCount
Sorghum bicolor (L.) Moench	Plantae|Magnoliophyta|Liliopsida|Poales|Poaceae|Sorghum|bicolor|Sorghum bicolor (L.) Moench	71
Sorghum bicolor subsp. bicolor	Plantae|Tracheophyta|Liliopsida|Poales|Poaceae|Sorghum|bicolor|Sorghum bicolor subsp. bicolor	59
Epomophorus labiatus (Temminck, 1837)	Animalia|Chordata|Mammalia|Chiroptera|Pteropodidae|Epomophorus|labiatus|Epomophorus labiatus (Temminck, 1837)	39
Aspatharia Bourguignat, 1885	Animalia|Mollusca|Bivalvia|Unionoida|Iridinidae|Aspatharia||Aspatharia Bourguignat, 1885	38
Agama agama Linnaeus, 1758	Animalia|Chordata|Reptilia|Squamata|Agamidae|Agama|agama|Agama agama Linnaeus, 1758	30
Pycnonotus barbatus (Desfontaines, 1789)	Animalia|Chordata|Aves|Passeriformes|Pycnonotidae|Pycnonotus|barbatus|Pycnonotus barbatus (Desfontaines, 1789)	23
Uraeginthus bengalus (Linnaeus, 1766)	Animalia|Chordata|Aves|Passeriformes|Estrildidae|Uraeginthus|bengalus|Uraeginthus bengalus (Linnaeus, 1766)	19
Mutela alata (Lea, 1864)	Animalia|Mollusca|Bivalvia|Unionoida|Iridinidae|Mutela|alata|Mutela alata (Lea, 1864)	18
Chirobia otophaga Fain, 1959	Animalia|Arthropoda|Arachnida|Astigmata|Sarcoptidae|Chirobia|otophaga|Chirobia otophaga Fain, 1959	18
Mus Linnaeus, 1758	Animalia|Chordata|Mammalia|Rodentia|Muridae|Mus||Mus Linnaeus, 1758	18
Scotophilus Leach, 1821	Animalia|Chordata|Mammalia|Chiroptera|Vespertilionidae|Scotophilus||Scotophilus Leach, 1821	17
Vespertilionidae	Animalia|Chordata|Mammalia|Chiroptera|Vespertilionidae|||Vespertilionidae	17
Leptoptilos crumenifer	Animalia|Chordata|Aves|Ciconiiformes|Ciconiidae|Leptoptilos|crumenifer|Leptoptilos crumenifer	16
Neoromicia Roberts, 1926	Animalia|Chordata|Mammalia|Chiroptera|Vespertilionidae|Neoromicia||Neoromicia Roberts, 1926	16
Nycteris Geoffroy Saint-Hilaire & Cuvier, 1795	Animalia|Chordata|Mammalia|Chiroptera|Nycteridae|Nycteris||Nycteris Geoffroy Saint-Hilaire & Cuvier, 1795	15
Milvus migrans (Boddaert, 1783)	Animalia|Chordata|Aves|Accipitriformes|Accipitridae|Milvus|migrans|Milvus migrans (Boddaert, 1783)	15
Plantae	Plantae|||||||Plantae	14
Threskiornis aethiopicus (Latham, 1790)	Animalia|Chordata|Aves|Pelecaniformes|Threskiornithidae|Threskiornis|aethiopicus|Threskiornis aethiopicus (Latham, 1790)	14
Glauconycteris variegata (Tomes, 1861)	Animalia|Chordata|Mammalia|Chiroptera|Vespertilionidae|Glauconycteris|variegata|Glauconycteris variegata (Tomes, 1861)	13
Scopus umbretta Gmelin, 1789	Animalia|Chordata|Aves|Pelecaniformes|Scopidae|Scopus|umbretta|Scopus umbretta Gmelin, 1789	12
Bubulcus ibis (Linnaeus, 1758)	Animalia|Chordata|Aves|Pelecaniformes|Ardeidae|Bubulcus|ibis|Bubulcus ibis (Linnaeus, 1758)	12
Melaenornis Gray, 1840	Animalia|Chordata|Aves|Passeriformes|Muscicapidae|Melaenornis||Melaenornis Gray, 1840	12
Praomys jacksoni (de Winton, 1897)	Animalia|Chordata|Mammalia|Rodentia|Muridae|Praomys|jacksoni|Praomys jacksoni (de Winton, 1897)	11
Sorghum bicolor (L.) Moench	Plantae|Tracheophyta|Liliopsida|Poales|Poaceae|Sorghum|bicolor|Sorghum bicolor (L.) Moench	11
Epomophorus Bennett, 1836	Animalia|Chordata|Mammalia|Chiroptera|Pteropodidae|Epomophorus||Epomophorus Bennett, 1836	11
Scotoecus Thomas, 1901	Animalia|Chordata|Mammalia|Chiroptera|Vespertilionidae|Scotoecus||Scotoecus Thomas, 1901	10
Passer griseus (Vieillot, 1817)	Animalia|Chordata|Aves|Passeriformes|Passeridae|Passer|griseus|Passer griseus (Vieillot, 1817)	10
Epomops franqueti (Tomes, 1860)	Animalia|Chordata|Mammalia|Chiroptera|Pteropodidae|Epomops|franqueti|Epomops franqueti (Tomes, 1860)	9
Halcyon leucocephala (Statius Muller, 1776)	Animalia|Chordata|Aves|Coraciiformes|Alcedinidae|Halcyon|leucocephala|Halcyon leucocephala (Statius Muller, 1776)	9
Streptopelia capicola (Sundevall, 1857)	Animalia|Chordata|Aves|Columbiformes|Columbidae|Streptopelia|capicola|Streptopelia capicola (Sundevall, 1857)	9
Turdus pelios Bonaparte, 1850	Animalia|Chordata|Aves|Passeriformes|Turdidae|Turdus|pelios|Turdus pelios Bonaparte, 1850	9
Molossidae	Animalia|Chordata|Mammalia|Chiroptera|Molossidae|||Molossidae	9
Cichladusa guttata (Heuglin, 1862)	Animalia|Chordata|Aves|Passeriformes|Muscicapidae|Cichladusa|guttata|Cichladusa guttata (Heuglin, 1862)	9
Euplectes franciscanus (Isert, 1789)	Animalia|Chordata|Aves|Passeriformes|Ploceidae|Euplectes|franciscanus|Euplectes franciscanus (Isert, 1789)	8
Lybius guifsobalito Hermann, 1783	Animalia|Chordata|Aves|Piciformes|Ramphastidae|Lybius|guifsobalito|Lybius guifsobalito Hermann, 1783	8
Oena capensis (Linnaeus, 1766)	Animalia|Chordata|Aves|Columbiformes|Columbidae|Oena|capensis|Oena capensis (Linnaeus, 1766)	8
Heliosciurus rufobrachium (Waterhouse, 1842)	Animalia|Chordata|Mammalia|Rodentia|Sciuridae|Heliosciurus|rufobrachium|Heliosciurus rufobrachium (Waterhouse, 1842)	8
Corvus albus Müller, 1776	Animalia|Chordata|Aves|Passeriformes|Corvidae|Corvus|albus|Corvus albus Müller, 1776	8
Colotis danae (Fabricius, 1775)	Animalia|Arthropoda|Insecta|Lepidoptera|Pieridae|Colotis|danae|Colotis danae (Fabricius, 1775)	8
Hipposideros Gray, 1831	Animalia|Chordata|Mammalia|Chiroptera|Hipposideridae|Hipposideros||Hipposideros Gray, 1831	8
Laniarius erythrogaster (Cretzschmar, 1829)	Animalia|Chordata|Aves|Passeriformes|Malaconotidae|Laniarius|erythrogaster|Laniarius erythrogaster (Cretzschmar, 1829)	8
Hipposideros cyclops (Temminck, 1853)	Animalia|Chordata|Mammalia|Chiroptera|Rhinolophidae|Hipposideros|cyclops|Hipposideros cyclops (Temminck, 1853)	8
Hipposideros beatus subsp. maximus Verschuren, 1957	Animalia|Chordata|Mammalia|Chiroptera|Rhinolophidae|Hipposideros|beatus|Hipposideros beatus subsp. maximus Verschuren, 1957	8
Lavia frons (E. Geoffroy, 1810)	Animalia|Chordata|Mammalia|Chiroptera|Megadermatidae|Lavia|frons|Lavia frons (E. Geoffroy, 1810)	7
Lophaetus occipitalis (Daudin, 1800)	Animalia|Chordata|Aves|Accipitriformes|Accipitridae|Lophaetus|occipitalis|Lophaetus occipitalis (Daudin, 1800)	7
Falco ardosiaceus Vieillot, 1823	Animalia|Chordata|Aves|Falconiformes|Falconidae|Falco|ardosiaceus|Falco ardosiaceus Vieillot, 1823	7
Caelatura Conrad, 1853	Animalia|Mollusca|Gastropoda|Neotaenioglossa|Barleeiidae|Caelatura||Caelatura Conrad, 1853	7
Tchagra senegalus (Linnaeus, 1766)	Animalia|Chordata|Aves|Passeriformes|Malaconotidae|Tchagra|senegalus|Tchagra senegalus (Linnaeus, 1766)	7
Vanellus spinosus (Linnaeus, 1758)	Animalia|Chordata|Aves|Charadriiformes|Charadriidae|Vanellus|spinosus|Vanellus spinosus (Linnaeus, 1758)	7
Colius striatus Gmelin, 1789	Animalia|Chordata|Aves|Coliiformes|Coliidae|Colius|striatus|Colius striatus Gmelin, 1789	7
Treron waalia (F. A. A. Meyer, 1793)	Animalia|Chordata|Aves|Columbiformes|Columbidae|Treron|waalia|Treron waalia (F. A. A. Meyer, 1793)	7
Caelatura Conrad, 1865	Animalia|Mollusca|Gastropoda|Littorinimorpha|Barleeiidae|Caelatura||Caelatura Conrad, 1865	7
Hexalobus monopetalus (A. Rich.) Engl. & Diels	Plantae|Magnoliophyta|Magnoliopsida|Magnoliales|Annonaceae|Hexalobus|monopetalus|Hexalobus monopetalus (A. Rich.) Engl. & Diels	7
Hexalobus monopetalus (A. Rich.) Engl. & Diels	Plantae|Tracheophyta|Magnoliopsida|Magnoliales|Annonaceae|Hexalobus|monopetalus|Hexalobus monopetalus (A. Rich.) Engl. & Diels	7
Torgos tracheliotos	Animalia|Chordata|Aves|Accipitriformes|Accipitridae|Torgos|tracheliotos|Torgos tracheliotos	7
Lanius excubitoroides Prevost & DesMurs, 1847	Animalia|Chordata|Aves|Passeriformes|Laniidae|Lanius|excubitoroides|Lanius excubitoroides Prevost & DesMurs, 1847	7
Corvus albus Statius Muller, 1776	Animalia|Chordata|Aves|Passeriformes|Corvidae|Corvus|albus|Corvus albus Statius Muller, 1776	7
Dasymys incomtus (Sundevall, 1847)	Animalia|Chordata|Mammalia|Rodentia|Muridae|Dasymys|incomtus|Dasymys incomtus (Sundevall, 1847)	6
Micropteropus pusillus (Peters, 1868)	Animalia|Chordata|Mammalia|Chiroptera|Pteropodidae|Micropteropus|pusillus|Micropteropus pusillus (Peters, 1868)	6
Passeriformes	Animalia|Chordata|Aves|Passeriformes||||Passeriformes	6
Torgos tracheliotus (J. R. Forster, 1796)	Animalia|Chordata|Aves|Accipitriformes|Accipitridae|Torgos|tracheliotus|Torgos tracheliotus (J. R. Forster, 1796)	6
Ardea cinerea Linnaeus, 1758	Animalia|Chordata|Aves|Pelecaniformes|Ardeidae|Ardea|cinerea|Ardea cinerea Linnaeus, 1758	6
Lybius rolleti (Filippi, 1853)	Animalia|Chordata|Aves|Piciformes|Ramphastidae|Lybius|rolleti|Lybius rolleti (Filippi, 1853)	6
Rodentia	Animalia|Chordata|Mammalia|Rodentia||||Rodentia	6
Ardea melanocephala Children & Vigors, 1826	Animalia|Chordata|Aves|Pelecaniformes|Ardeidae|Ardea|melanocephala|Ardea melanocephala Children & Vigors, 1826	6
Poaceae Barnhart	Plantae|Magnoliophyta|Liliopsida|Poales|Poaceae|||Poaceae Barnhart	5
Poaceae	Plantae|Tracheophyta|Liliopsida|Poales|Poaceae|||Poaceae	5
Podocarpus milanjianus Rendle	Plantae|Pinophyta|Pinopsida|Pinales|Podocarpaceae|Podocarpus|milanjianus|Podocarpus milanjianus Rendle	5
Urocolius macrourus (Linnaeus, 1766)	Animalia|Chordata|Aves|Coliiformes|Coliidae|Urocolius|macrourus|Urocolius macrourus (Linnaeus, 1766)	5
Alectoris barbara subsp. spatzi (Reichenow, 1895)	Animalia|Chordata|Aves|Galliformes|Phasianidae|Alectoris|barbara|Alectoris barbara subsp. spatzi (Reichenow, 1895)	5
Prinia subflava (Gmelin, 1789)	Animalia|Chordata|Aves|Passeriformes|Cisticolidae|Prinia|subflava|Prinia subflava (Gmelin, 1789)	5
Podocarpus milanjianus Rendle	Plantae|Tracheophyta|Pinopsida|Pinales|Podocarpaceae|Podocarpus|milanjianus|Podocarpus milanjianus Rendle	5
Ptilostomus afer (Linnaeus, 1766)	Animalia|Chordata|Aves|Passeriformes|Corvidae|Ptilostomus|afer|Ptilostomus afer (Linnaeus, 1766)	5
Clamator glandarius (Linnaeus, 1758)	Animalia|Chordata|Aves|Cuculiformes|Cuculidae|Clamator|glandarius|Clamator glandarius (Linnaeus, 1758)	5
Lanius excubitorius	Animalia|Chordata|Aves|Passeriformes|Laniidae|Lanius|excubitorius|Lanius excubitorius	5
Tacca leontopetaloides (L.) Kuntze	Plantae|Tracheophyta|Liliopsida|Dioscoreales|Taccaceae|Tacca|leontopetaloides|Tacca leontopetaloides (L.) Kuntze	5
Empidornis semipartitus (Ruppell, 1840)	Animalia|Chordata|Aves|Passeriformes|Muscicapidae|Empidornis|semipartitus|Empidornis semipartitus (Ruppell, 1840)	5
Hibiscus asper Hook. fil.	Plantae|Tracheophyta|Magnoliopsida|Malvales|Malvaceae|Hibiscus|asper|Hibiscus asper Hook. fil.	5
Cossypha heuglini Hartlaub, 1866	Animalia|Chordata|Aves|Passeriformes|Muscicapidae|Cossypha|heuglini|Cossypha heuglini Hartlaub, 1866	5
	|||||||	5
Capparis sepiaria L.	Plantae|Magnoliophyta|Magnoliopsida|Brassicales|Capparaceae|Capparis|sepiaria|Capparis sepiaria L.	5
Empidornis semipartitus (Rüppell, 1840)	Animalia|Chordata|Aves|Passeriformes|Muscicapidae|Empidornis|semipartitus|Empidornis semipartitus (Rüppell, 1840)	5
Lanius collurio Linnaeus, 1758	Animalia|Chordata|Aves|Passeriformes|Laniidae|Lanius|collurio|Lanius collurio Linnaeus, 1758	4
Cinnyris pulchellus (Linnaeus, 1766)	Animalia|Chordata|Aves|Passeriformes|Nectariniidae|Cinnyris|pulchellus|Cinnyris pulchellus (Linnaeus, 1766)	4
Mus sorella (Thomas, 1909)	Animalia|Chordata|Mammalia|Rodentia|Muridae|Mus|sorella|Mus sorella (Thomas, 1909)	4
Acacia senegal (L.) Willd.	Plantae|Tracheophyta|Magnoliopsida|Fabales|Fabaceae|Senegalia|senegal|Acacia senegal (L.) Willd.	4
Glareola nuchalis G. R. Gray, 1849	Animalia|Chordata|Aves|Charadriiformes|Glareolidae|Glareola|nuchalis|Glareola nuchalis G. R. Gray, 1849	4
Pogoniulus chrysoconus (Temminck, 1832)	Animalia|Chordata|Aves|Piciformes|Ramphastidae|Pogoniulus|chrysoconus|Pogoniulus chrysoconus (Temminck, 1832)	4
Mesophoyx intermedia (Wagler, 1829)	Animalia|Chordata|Aves|Pelecaniformes|Ardeidae|Egretta|intermedia|Mesophoyx intermedia (Wagler, 1829)	4
Tauraco leucolophus (Heuglin, 1855)	Animalia|Chordata|Aves|Musophagiformes|Musophagidae|Tauraco|leucolophus|Tauraco leucolophus (Heuglin, 1855)	4
		4
Mastomys natalensis (A. Smith, 1834)	Animalia|Chordata|Mammalia|Rodentia|Muridae|Mastomys|natalensis|Mastomys natalensis (A. Smith, 1834)	4
Connochaetes gnou (Zimmermann, 1780)	Animalia|Chordata|Mammalia|Artiodactyla|Bovidae|Connochaetes|gnou|Connochaetes gnou (Zimmermann, 1780)	4
Terpsiphone viridis (Statius Muller, 1776)	Animalia|Chordata|Aves|Passeriformes|Monarchidae|Terpsiphone|viridis|Terpsiphone viridis (Statius Muller, 1776)	4
Serinus mozambicus (P. L. Statius Müller, 1776)	Animalia|Chordata|Aves|Passeriformes|Fringillidae|Crithagra|mozambicus|Serinus mozambicus (P. L. Statius Müller, 1776)	4
Anastomus lamelligerus Temminck, 1823	Animalia|Chordata|Aves|Ciconiiformes|Ciconiidae|Anastomus|lamelligerus|Anastomus lamelligerus Temminck, 1823	4
Bostrychia hagedash (Latham, 1790)	Animalia|Chordata|Aves|Pelecaniformes|Threskiornithidae|Bostrychia|hagedash|Bostrychia hagedash (Latham, 1790)	4
Melierax poliopterus Cabanis, 1868	Animalia|Chordata|Aves|Accipitriformes|Accipitridae|Melierax|poliopterus|Melierax poliopterus Cabanis, 1868	4
Ispidina picta (Boddaert, 1783)	Animalia|Chordata|Aves|Coraciiformes|Alcedinidae|Ceyx|picta|Ispidina picta (Boddaert, 1783)	4
Burhinus senegalensis (Swainson, 1837)	Animalia|Chordata|Aves|Charadriiformes|Burhinidae|Burhinus|senegalensis|Burhinus senegalensis (Swainson, 1837)	4
Commelina forskaolii Vahl	Plantae|Tracheophyta|Liliopsida|Commelinales|Commelinaceae|Commelina|forskaolii|Commelina forskaolii Vahl	4
Streptopelia Bonaparte, 1855	Animalia|Chordata|Aves|Columbiformes|Columbidae|Streptopelia||Streptopelia Bonaparte, 1855	4
Acacia senegal (L.) Willd.	Plantae|Magnoliophyta|Magnoliopsida|Fabales|Fabaceae|Acacia|senegal|Acacia senegal (L.) Willd.	4
Mastomys natalensis (Smith, 1834)	Animalia|Chordata|Mammalia|Rodentia|Muridae|Mastomys|natalensis|Mastomys natalensis (Smith, 1834)	4
Prionops plumatus (Shaw, 1809)	Animalia|Chordata|Aves|Passeriformes|Prionopidae|Prionops|plumatus|Prionops plumatus (Shaw, 1809)	4
Agama agama subsp. agama	Animalia|Chordata|Reptilia|Squamata|Agamidae|Agama|agama|Agama agama subsp. agama	4
Caprimulgus longipennis	Animalia|Chordata|Aves|Caprimulgiformes|Caprimulgidae|Caprimulgus|longipennis|Caprimulgus longipennis	4
Indicator minor Stephens, 1815	Animalia|Chordata|Aves|Piciformes|Indicatoridae|Indicator|minor|Indicator minor Stephens, 1815	4
Cinnyris pulchellus	Animalia|Chordata|Aves|Passeriformes|Nectariniidae|Cinnyris|pulchellus|Cinnyris pulchellus	3
Macronyx croceus (Vieillot, 1816)	Animalia|Chordata|Aves|Passeriformes|Motacillidae|Macronyx|croceus|Macronyx croceus (Vieillot, 1816)	3
Tapinanthus globiferus (A. Rich.) van Tiegh.	Plantae|Tracheophyta|Magnoliopsida|Santalales|Loranthaceae|Tapinanthus|globiferus|Tapinanthus globiferus (A. Rich.) van Tiegh.	3
Setaria anceps Stapf ex Massey	Plantae|Tracheophyta|Liliopsida|Poales|Poaceae|Setaria|anceps|Setaria anceps Stapf ex Massey	3
Tchagra australis (A. Smith, 1836)	Animalia|Chordata|Aves|Passeriformes|Malaconotidae|Tchagra|australis|Tchagra australis (A. Smith, 1836)	3
Solanum cerasiferum Dunal	Plantae|Tracheophyta|Magnoliopsida|Solanales|Solanaceae|Solanum|cerasiferum|Solanum cerasiferum Dunal	3
Harrisonia abyssinica Oliver	Plantae|Tracheophyta|Magnoliopsida|Sapindales|Rutaceae|Harrisonia|abyssinica|Harrisonia abyssinica Oliver	3
Chaerephon Dobson, 1874	Animalia|Chordata|Mammalia|Chiroptera|Molossidae|Chaerephon||Chaerephon Dobson, 1874	3
Cardiospermum halicacabum L.	Plantae|Tracheophyta|Magnoliopsida|Sapindales|Sapindaceae|Cardiospermum|halicacabum|Cardiospermum halicacabum L.	3
Ipomoea eriocarpa R. Br.	Plantae|Tracheophyta|Magnoliopsida|Solanales|Convolvulaceae|Ipomoea|eriocarpa|Ipomoea eriocarpa R. Br.	3
Parinari curatellifolia Benth. ex Planch.	Plantae|Magnoliophyta|Magnoliopsida|Malpighiales|Chrysobalanaceae|Parinari|curatellifolia|Parinari curatellifolia Benth. ex Planch.	3
Vidua macroura (Pallas, 1764)	Animalia|Chordata|Aves|Passeriformes|Viduidae|Vidua|macroura|Vidua macroura (Pallas, 1764)	3
Lagonosticta rara (Antinori, 1864)	Animalia|Chordata|Aves|Passeriformes|Estrildidae|Lagonosticta|rara|Lagonosticta rara (Antinori, 1864)	3
Lamprotornis chalybaeus Hemprich & Ehrenberg, 1828	Animalia|Chordata|Aves|Passeriformes|Sturnidae|Lamprotornis|chalybaeus|Lamprotornis chalybaeus Hemprich & Ehrenberg, 1828	3
Lannea nigritana (Scott-Elliot) Keay	Plantae|Magnoliophyta|Magnoliopsida|Sapindales|Anacardiaceae|Lannea|nigritana|Lannea nigritana (Scott-Elliot) Keay	3
Accipitridae Vigors, 1824	Animalia|Chordata|Aves|Accipitriformes|Accipitridae|||Accipitridae Vigors, 1824	3
Ceyx Lacepede, 1799	Animalia|Chordata|Aves|Coraciiformes|Alcedinidae|Ceyx||Ceyx Lacepede, 1799	3
Pytilia phoenicoptera Swainson, 1837	Animalia|Chordata|Aves|Passeriformes|Estrildidae|Pytilia|phoenicoptera|Pytilia phoenicoptera Swainson, 1837	3
Accipiter badius subsp. sphenurus (Ruppell, 1836)	Animalia|Chordata|Aves|Accipitriformes|Accipitridae|Accipiter|badius|Accipiter badius subsp. sphenurus (Ruppell, 1836)	3
Solanum campylacanthum Hochst. ex A.Rich.	Plantae|Tracheophyta|Magnoliopsida|Solanales|Solanaceae|Solanum|campylacanthum|Solanum campylacanthum Hochst. ex A.Rich.	3
Merops pusillus Statius Muller, 1776	Animalia|Chordata|Aves|Coraciiformes|Meropidae|Merops|pusillus|Merops pusillus Statius Muller, 1776	3
Centropus senegalensis (Linnaeus, 1766)	Animalia|Chordata|Aves|Cuculiformes|Cuculidae|Centropus|senegalensis|Centropus senegalensis (Linnaeus, 1766)	3
Scincidae Gray, 1825	Animalia|Chordata|Reptilia|Squamata|Scincidae|||Scincidae Gray, 1825	3
Caprimulgus Linnaeus, 1758	Animalia|Chordata|Aves|Strigiformes|Caprimulgidae|Caprimulgus||Caprimulgus Linnaeus, 1758	3
Kedrostis foetidissima (Jacq.) Cogn.	Plantae|Tracheophyta|Magnoliopsida|Cucurbitales|Cucurbitaceae|Kedrostis|foetidissima|Kedrostis foetidissima (Jacq.) Cogn.	3
Aneilema lanceolatum subsp. lanceolatum	Plantae|Tracheophyta|Liliopsida|Commelinales|Commelinaceae|Aneilema|lanceolatum|Aneilema lanceolatum subsp. lanceolatum	3
Actitis hypoleucos (Linnaeus, 1758)	Animalia|Chordata|Aves|Charadriiformes|Scolopacidae|Actitis|hypoleucos|Actitis hypoleucos (Linnaeus, 1758)	3
Balaeniceps rex Gould, 1850	Animalia|Chordata|Aves|Pelecaniformes|Balaenicipitidae|Balaeniceps|rex|Balaeniceps rex Gould, 1850	3
Coracias abyssinicus Hermann, 1783	Animalia|Chordata|Aves|Coraciiformes|Coraciidae|Coracias|abyssinicus|Coracias abyssinicus Hermann, 1783	3
Halcyon chelicuti chelicuti	Animalia|Chordata|Aves|Coraciiformes|Alcedinidae|Halcyon|chelicuti|Halcyon chelicuti chelicuti	3
Ipomoea eriocarpa R. Br.	Plantae|Magnoliophyta|Magnoliopsida|Solanales|Convolvulaceae|Ipomoea|eriocarpa|Ipomoea eriocarpa R. Br.	3
Erythrocebus patas (Schreber, 1774)	Animalia|Chordata|Mammalia|Primates|Cercopithecidae|Erythrocebus|patas|Erythrocebus patas (Schreber, 1774)	3
Geophila obvallata subsp. involucrata (Schweinf. ex Hiern) Verdc.	Plantae|Tracheophyta|Magnoliopsida|Gentianales|Rubiaceae|Geophila|obvallata|Geophila obvallata subsp. involucrata (Schweinf. ex Hiern) Verdc.	3
Cassia mimosoides L.	Plantae|Tracheophyta|Magnoliopsida|Fabales|Fabaceae|Chamaecrista|mimosoides|Cassia mimosoides L.	3
Camaroptera brevicaudata (Cretzschmar, 1830)	Animalia|Chordata|Aves|Passeriformes|Cisticolidae|Camaroptera|brevicaudata|Camaroptera brevicaudata (Cretzschmar, 1830)	3
Lamprotornis purpuroptera Rüppell, 1845	Animalia|Chordata|Aves|Passeriformes|Sturnidae|Lamprotornis|purpuroptera|Lamprotornis purpuroptera Rüppell, 1845	3
Chlorophytum Ker Gawl.	Plantae|Magnoliophyta|Liliopsida|Asparagales|Asparagaceae|Chlorophytum||Chlorophytum Ker Gawl.	3
Vidua paradisaea (Linnaeus, 1758)	Animalia|Chordata|Aves|Passeriformes|Viduidae|Vidua|paradisaea|Vidua paradisaea (Linnaeus, 1758)	3
Dicrurus adsimilis (Bechstein, 1794)	Animalia|Chordata|Aves|Passeriformes|Dicruridae|Dicrurus|adsimilis|Dicrurus adsimilis (Bechstein, 1794)	3
Lannea nigritana (Scott Elliot) Keay	Plantae|Tracheophyta|Magnoliopsida|Sapindales|Anacardiaceae|Lannea|nigritana|Lannea nigritana (Scott Elliot) Keay	3
Corythornis cristatus (Pallas, 1764)	Animalia|Chordata|Aves|Coraciiformes|Alcedinidae|Alcedo|cristatus|Corythornis cristatus (Pallas, 1764)	3
Geophila obvallata subsp. involucrata	Plantae|Magnoliophyta|Magnoliopsida|Gentianales|Rubiaceae|Geophila|obvallata|Geophila obvallata subsp. involucrata	3
Solanum campylacanthum Hochst. ex A.Rich.	Plantae|Magnoliophyta|Magnoliopsida|Solanales|Solanaceae|Solanum|campylacanthum|Solanum campylacanthum Hochst. ex A.Rich.	3
Corythornis cristatus (Pallas, 1764)	Animalia|Chordata|Aves|Coraciiformes|Alcedinidae|Corythornis|cristatus|Corythornis cristatus (Pallas, 1764)	3
Motacilla flava Linnaeus, 1758	Animalia|Chordata|Aves|Passeriformes|Motacillidae|Motacilla|flava|Motacilla flava Linnaeus, 1758	3
Turtur afer (Linnaeus, 1766)	Animalia|Chordata|Aves|Columbiformes|Columbidae|Turtur|afer|Turtur afer (Linnaeus, 1766)	3
Murdannia simplex (Vahl) Brenan	Plantae|Tracheophyta|Liliopsida|Commelinales|Commelinaceae|Murdannia|simplex|Murdannia simplex (Vahl) Brenan	3
Cucumis melo var. agrestis Naudin	Plantae|Tracheophyta|Magnoliopsida|Cucurbitales|Cucurbitaceae|Cucumis|melo|Cucumis melo var. agrestis Naudin	3
Phoeniculus Jarocki, 1821	Animalia|Chordata|Aves|Bucerotiformes|Phoeniculidae|Phoeniculus||Phoeniculus Jarocki, 1821	3
Parinari curatellifolia Planch. ex Benth.	Plantae|Tracheophyta|Magnoliopsida|Malpighiales|Chrysobalanaceae|Parinari|curatellifolia|Parinari curatellifolia Planch. ex Benth.	3
Cardiospermum halicacabum L.	Plantae|Magnoliophyta|Magnoliopsida|Sapindales|Sapindaceae|Cardiospermum|halicacabum|Cardiospermum halicacabum L.	3
Chlorophytum Ker Gawl.	Plantae|Tracheophyta|Liliopsida|Asparagales|Asparagaceae|Chlorophytum||Chlorophytum Ker Gawl.	3
Pycnonotus Boie, 1826	Animalia|Chordata|Aves|Passeriformes|Pycnonotidae|Pycnonotus||Pycnonotus Boie, 1826	3
Lanius senator Linnaeus, 1758	Animalia|Chordata|Aves|Passeriformes|Laniidae|Lanius|senator|Lanius senator Linnaeus, 1758	3
Ispidina picta	Animalia|Chordata|Aves|Coraciiformes|Alcedinidae|Ispidina|Ispidina picta	2
Burseraceae Kunth	Plantae|Magnoliophyta|Magnoliopsida|Sapindales|Burseraceae|||Burseraceae Kunth	2
Auchenoglanis	Animalia|Chordata|Auchenoglanis	2
Mylomys dybowskii (Pousargues, 1893)	Animalia|Chordata|Mammalia|Rodentia|Muridae|Mylomys|dybowskii|Mylomys dybowskii (Pousargues, 1893)	2
Wissadula amplissima var. rostrata (Schum. & Thonn.) R.E. Fr.	Plantae|Tracheophyta|Magnoliopsida|Malvales|Malvaceae|Wissadula|amplissima|Wissadula amplissima var. rostrata (Schum. & Thonn.) R.E. Fr.	2
Nymphaea	Plantae|Magnoliophyta|Magnoliopsida|Nymphaeales|Nymphaeaceae|Nymphaea|Nymphaea	2
Ploceus taeniopterus Reichenbach, 1863	Animalia|Chordata|Aves|Passeriformes|Ploceidae|Ploceus|taeniopterus|Ploceus taeniopterus Reichenbach, 1863	2
Euplectes franciscanus	Animalia|Chordata|Aves|Passeriformes|Ploceidae|Euplectes|Euplectes franciscanus	2
Euphorbia candelabrum var. candelabrum	Plantae|Tracheophyta|Magnoliopsida|Malpighiales|Euphorbiaceae|Euphorbia|candelabrum|Euphorbia candelabrum var. candelabrum	2
Spermestes cucullata	Animalia|Chordata|Aves|Passeriformes||Spermestes|cucullata|Spermestes cucullata	2
Francolinus icterorhynchus Heuglin, 1863	Animalia|Chordata|Aves|Galliformes|Phasianidae|Francolinus|icterorhynchus|Francolinus icterorhynchus Heuglin, 1863	2
Tockus erythrorhynchus (Temminck, 1823)	Animalia|Chordata|Aves|Bucerotiformes|Bucerotidae|Tockus|erythrorhynchus|Tockus erythrorhynchus (Temminck, 1823)	2
Lybius leucocephalus (Filippi, 1853)	Animalia|Chordata|Aves|Piciformes|Ramphastidae|Lybius|leucocephalus|Lybius leucocephalus (Filippi, 1853)	2
Myioparus plumbeus (Hartlaub, 1858)	Animalia|Chordata|Aves|Passeriformes|Muscicapidae|Myioparus|plumbeus|Myioparus plumbeus (Hartlaub, 1858)	2
Agama Daudin, 1802	Animalia|Chordata|Reptilia|Squamata|Agamidae|Agama||Agama Daudin, 1802	2
Streptopelia senegalensis (Linnaeus, 1766)	Animalia|Chordata|Aves|Columbiformes|Columbidae|Streptopelia|senegalensis|Streptopelia senegalensis (Linnaeus, 1766)	2
Lybius leucocephalus leucocephalus	Animalia|Chordata|Aves|Piciformes|Ramphastidae|Lybius|leucocephalus|Lybius leucocephalus leucocephalus	2
Dicrocercus Cabanis & Heine, 1860	Animalia|Chordata|Aves|Coraciiformes|Meropidae|Merops||Dicrocercus Cabanis & Heine, 1860	2
Falco Linnaeus, 1758	Animalia|Chordata|Aves|Falconiformes|Falconidae|Falco||Falco Linnaeus, 1758	2
Trachyphonus erythrocephalus Cabanis, 1878	Animalia|Chordata|Aves|Piciformes|Ramphastidae|Trachyphonus|erythrocephalus|Trachyphonus erythrocephalus Cabanis, 1878	2
Cassia obtusifolia L.	Plantae|Magnoliophyta|Magnoliopsida|Fabales|Fabaceae|Senna|obtusifolia|Cassia obtusifolia L.	2
Gekkonidae Gray, 1825	Animalia|Chordata|Reptilia|Squamata|Gekkonidae|||Gekkonidae Gray, 1825	2
Setaria sphacelata (Schumach.) Stapf & C.E.Hubb. ex Moss	Plantae|Magnoliophyta|Liliopsida|Poales|Poaceae|Setaria|sphacelata|Setaria sphacelata (Schumach.) Stapf & C.E.Hubb. ex Moss	2
Causus Wagler, 1830	Animalia|Chordata|Reptilia|Squamata|Viperidae|Causus||Causus Wagler, 1830	2
Aloe diolii L.E.Newton	Plantae|Tracheophyta|Liliopsida|Asparagales|Xanthorrhoeaceae|Aloë|diolii|Aloe diolii L.E.Newton	2
Necrosyrtes monachus (Temminck, 1823)	Animalia|Chordata|Aves|Accipitriformes|Accipitridae|Necrosyrtes|monachus|Necrosyrtes monachus (Temminck, 1823)	2
Ploceus luteolus (Lichtenstein, 1823)	Animalia|Chordata|Aves|Passeriformes|Ploceidae|Ploceus|luteolus|Ploceus luteolus (Lichtenstein, 1823)	2
Asparagus flagellaris (Kunth) Baker	Plantae|Tracheophyta|Liliopsida|Asparagales|Asparagaceae|Asparagus|flagellaris|Asparagus flagellaris (Kunth) Baker	2
Aloe diolii L.E.Newton	Plantae|Magnoliophyta|Liliopsida|Asparagales|Xanthorrhoeaceae|Aloe|diolii|Aloe diolii L.E.Newton	2
Meizodon regularis Fischer, 1856	Animalia|Chordata|Reptilia|Squamata|Colubridae|Meizodon|regularis|Meizodon regularis Fischer, 1856	2
Macrotyloma biflorum var. biflorum	Plantae|Magnoliophyta|Magnoliopsida|Fabales|Fabaceae|Macrotyloma|biflorum|Macrotyloma biflorum var. biflorum	2
Sternoptyx diaphana Hermann, 1781	Animalia|Chordata|Actinopterygii|Stomiiformes|Sternoptychidae|Sternoptyx|diaphana|Sternoptyx diaphana Hermann, 1781	2
Leptopelis christyi (Boulenger, 1912)	Animalia|Chordata|Amphibia|Anura|Arthroleptidae|Leptopelis|christyi|Leptopelis christyi (Boulenger, 1912)	2
Cinnyris pulchellus	Animalia|Chordata|Aves|Passeriformes|Nectariniidae|Cinnyris|Cinnyris pulchellus	2
Ziziphus mauritiana Lam.	Plantae|Tracheophyta|Magnoliopsida|Rosales|Rhamnaceae|Ziziphus|mauritiana|Ziziphus mauritiana Lam.	2
Turtur tympanistria (Temminck, 1809)	Animalia|Chordata|Aves|Columbiformes|Columbidae|Turtur|tympanistria|Turtur tympanistria (Temminck, 1809)	2
Crocidura olivieri (Lesson, 1827)	Animalia|Chordata|Mammalia|Soricomorpha|Soricidae|Crocidura|olivieri|Crocidura olivieri (Lesson, 1827)	2
Polyboroides typus A. Smith, 1829	Animalia|Chordata|Aves|Accipitriformes|Accipitridae|Polyboroides|typus|Polyboroides typus A. Smith, 1829	2
Agamidae	Animalia|Chordata|Reptilia|Squamata|Agamidae	2
Oreochromis aureus	Animalia|Chordata|Actinopterygii|Perciformes|Cichlidae|Oreochromis|Oreochromis aureus	2
Oriolus larvatus Lichtenstein, 1823	Animalia|Chordata|Aves|Passeriformes|Oriolidae|Oriolus|larvatus|Oriolus larvatus Lichtenstein, 1823	2
Hygrophila auriculata (Schumach.) Heine	Plantae|Magnoliophyta|Magnoliopsida|Lamiales|Acanthaceae|Hygrophila|auriculata|Hygrophila auriculata (Schumach.) Heine	2
Coffea liberica Hiern	Plantae|Magnoliophyta|Magnoliopsida|Gentianales|Rubiaceae|Coffea|liberica|Coffea liberica Hiern	2
Colotis aurora (Cramer, 1780)	Animalia|Arthropoda|Insecta|Lepidoptera|Pieridae|Colotis|aurora|Colotis aurora (Cramer, 1780)	2
Alysicarpus ovalifolius (Schum.) Leonard	Plantae|Magnoliophyta|Magnoliopsida|Fabales|Fabaceae|Alysicarpus|ovalifolius|Alysicarpus ovalifolius (Schum.) Leonard	2
Aspilia kotschyi var. kotschyi	Plantae|Tracheophyta|Magnoliopsida|Asterales|Asteraceae|Aspilia|kotschyi|Aspilia kotschyi var. kotschyi	2
Picoides Lacépède, 1799	Animalia|Chordata|Aves|Piciformes|Picidae|Picoides||Picoides Lacépède, 1799	2
Liliaceae Juss.	Plantae|Magnoliophyta|Liliopsida|Liliales|Liliaceae|||Liliaceae Juss.	2
Haliaeetus vocifer (Daudin, 1800)	Animalia|Chordata|Aves|Accipitriformes|Accipitridae|Haliaeetus|vocifer|Haliaeetus vocifer (Daudin, 1800)	2
Hyparrhenia rufa (Nees) Stapf	Plantae|Tracheophyta|Liliopsida|Poales|Poaceae|Hyparrhenia|rufa|Hyparrhenia rufa (Nees) Stapf	2
Varanus niloticus	Animalia|Chordata|Reptilia|Squamata|Varanidae|Varanus|Varanus niloticus	2
Ipomoea acanthocarpa (Choisy) Asch. & Schweinf.	Plantae|Tracheophyta|Magnoliopsida|Solanales|Convolvulaceae|Ipomoea|acanthocarpa|Ipomoea acanthocarpa (Choisy) Asch. & Schweinf.	2
Tephrosia linearis (Willd.) Pers.	Plantae|Tracheophyta|Magnoliopsida|Fabales|Fabaceae|Tephrosia|linearis|Tephrosia linearis (Willd.) Pers.	2
Selaginella njamnjamensis Hieron.	Plantae|Tracheophyta|Lycopodiopsida|Selaginellales|Selaginellaceae|Selaginella|njamnjamensis|Selaginella njamnjamensis Hieron.	2
Capparis sepiaria var. subglabra (Oliv.) De Wolf	Plantae|Tracheophyta|Magnoliopsida|Brassicales|Capparaceae|Capparis|sepiaria|Capparis sepiaria var. subglabra (Oliv.) De Wolf	2
Riparia riparia (Linnaeus, 1758)	Animalia|Chordata|Aves|Passeriformes|Hirundinidae|Riparia|riparia|Riparia riparia (Linnaeus, 1758)	2
Coracias abyssinicus	Animalia|Chordata|Aves|Coraciiformes|Coraciidae|Coracias|Coracias abyssinicus	2
Aloe macleayi Reynolds	Plantae|Magnoliophyta|Liliopsida|Asparagales|Xanthorrhoeaceae|Aloe|macleayi|Aloe macleayi Reynolds	2
Jacquemontia tamnifolia (L.) Griseb.	Plantae|Tracheophyta|Magnoliopsida|Solanales|Convolvulaceae|Jacquemontia|tamnifolia|Jacquemontia tamnifolia (L.) Griseb.	2
Diaphus problematicus Parr, 1928	Animalia|Chordata|Actinopterygii|Myctophiformes|Myctophidae|Diaphus|problematicus|Diaphus problematicus Parr, 1928	2
Agamidae Gray, 1827	Animalia|Chordata|Reptilia|Squamata|Agamidae|||Agamidae Gray, 1827	2
Brachyura Spix, 1824	Animalia|Chordata|Mammalia|||Brachyura||Brachyura Spix, 1824	2
Halcyon leucocephala	Animalia|Chordata|Aves|Coraciiformes|Alcedinidae|Halcyon|Halcyon leucocephala	2
Falco chicquera	Animalia|Chordata|Aves|Falconiformes|Falconidae|Falco|Falco chicquera	2
Euchrysops nilotica Aurivillius, 1904	Animalia|Arthropoda|Insecta|Lepidoptera|Lycaenidae|Euchrysops|nilotica|Euchrysops nilotica Aurivillius, 1904	2
Scincidae	Animalia|Chordata|Reptilia|Squamata|Scincidae	2
Sphaerothylax abyssinica Warm.	Plantae|Magnoliophyta|Magnoliopsida|Malpighiales|Podostemaceae|Sphaerothylax|abyssinica|Sphaerothylax abyssinica Warm.	2
Acraea encedon Linnaeus, 1758	Animalia|Arthropoda|Insecta|Lepidoptera|Nymphalidae|Acraea|encedon|Acraea encedon Linnaeus, 1758	2
Crocuta crocuta (Erxleben, 1777)	Animalia|Chordata|Mammalia|Carnivora|Hyaenidae|Crocuta|crocuta|Crocuta crocuta (Erxleben, 1777)	2
Alysicarpus ovalifolius (Schum.) Leonard	Plantae|Tracheophyta|Magnoliopsida|Fabales|Fabaceae|Alysicarpus|ovalifolius|Alysicarpus ovalifolius (Schum.) Leonard	2
Magnoliopsida	Plantae|Magnoliophyta|Magnoliopsida|||||Magnoliopsida	2
Dasypeltis atra Sternfeld, 1912	Animalia|Chordata|Reptilia|Squamata|Colubridae|Dasypeltis|atra|Dasypeltis atra Sternfeld, 1912	2
Sesbania sericea (Willd.) Link	Plantae|Magnoliophyta|Magnoliopsida|Fabales|Fabaceae|Sesbania|sericea|Sesbania sericea (Willd.) Link	2
Mastomys hildebrandtii (Peters, 1878)	Animalia|Chordata|Mammalia|Rodentia|Muridae|Mastomys|hildebrandtii|Mastomys hildebrandtii (Peters, 1878)	2
Varanus niloticus Linnaeus, 1758	Animalia|Chordata|Reptilia|Squamata|Varanidae|Varanus|niloticus|Varanus niloticus Linnaeus, 1758	2
Hoslundia opposita Vahl	Plantae|Tracheophyta|Magnoliopsida|Lamiales|Lamiaceae|Hoslundia|opposita|Hoslundia opposita Vahl	2
Dendropicos goertae subsp. abessinicus (Reichenow, 1900)	Animalia|Chordata|Aves|Piciformes|Picidae|Dendropicos|goertae|Dendropicos goertae subsp. abessinicus (Reichenow, 1900)	2
Sporopipes frontalis (Daudin, 1800)	Animalia|Chordata|Aves|Passeriformes|Ploceidae|Sporopipes|frontalis|Sporopipes frontalis (Daudin, 1800)	2
Salvadora persica L.	Plantae|Magnoliophyta|Magnoliopsida|Brassicales|Salvadoraceae|Salvadora|persica|Salvadora persica L.	2
Ctenolepis cerasiformis (Stocks) Hook. fil.	Plantae|Tracheophyta|Magnoliopsida|Cucurbitales|Cucurbitaceae|Ctenolepis|cerasiformis|Ctenolepis cerasiformis (Stocks) Hook. fil.	2
Urocolius macrourus	Animalia|Chordata|Aves|Coliiformes|Coliidae|Urocolius|Urocolius macrourus	2
Kobus A. Smith, 1840	Animalia|Chordata|Mammalia|Artiodactyla|Bovidae|Kobus||Kobus A. Smith, 1840	2
Hipposideros ruber (Noack, 1893)	Animalia|Chordata|Mammalia|Chiroptera|Hipposideridae|Hipposideros|ruber|Hipposideros ruber (Noack, 1893)	2
Halcyon senegalensis senegalensis	Animalia|Chordata|Aves|Coraciiformes|Alcedinidae|Halcyon|senegalensis|Halcyon senegalensis senegalensis	2
Lamprotornis chalybaeus Ehrenberg, 1828	Animalia|Chordata|Aves|Passeriformes|Sturnidae|Lamprotornis|chalybaeus|Lamprotornis chalybaeus Ehrenberg, 1828	2
Cymothoe caenis	Animalia|Arthropoda|Insecta|Lepidoptera|Nymphalidae|Cymothoe|Cymothoe caenis	2
Asparagus flagellaris (Kunth) Baker	Plantae|Magnoliophyta|Liliopsida|Asparagales|Asparagaceae|Asparagus|flagellaris|Asparagus flagellaris (Kunth) Baker	2
Dispholidus typus (Smith, 1828)	Animalia|Chordata|Reptilia|Squamata|Colubridae|Dasypeltis|typus|Dispholidus typus (Smith, 1828)	2
Macrodipteryx longipennis (Shaw, 1796)	Animalia|Chordata|Aves|Caprimulgiformes|Caprimulgidae|Macrodipteryx|longipennis|Macrodipteryx longipennis (Shaw, 1796)	2
Crotalaria L.	Plantae|Magnoliophyta|Magnoliopsida|Fabales|Fabaceae|Crotalaria||Crotalaria L.	2
Actinopterygii	Animalia|Chordata|Actinopterygii	2
Phoeniculus purpureus subsp. niloticus (Neumann, 1903)	Animalia|Chordata|Aves|Bucerotiformes|Phoeniculidae|Phoeniculus|purpureus|Phoeniculus purpureus subsp. niloticus (Neumann, 1903)	2
Taphozous E. Geoffroy, 1818	Animalia|Chordata|Mammalia|Chiroptera|Emballonuridae|Taphozous||Taphozous E. Geoffroy, 1818	2
Cucumis pustulatus Hook. fil.	Plantae|Tracheophyta|Magnoliopsida|Cucurbitales|Cucurbitaceae|Cucumis|pustulatus|Cucumis pustulatus Hook. fil.	2
Macrotyloma biflorum var. biflorum	Plantae|Tracheophyta|Magnoliopsida|Fabales|Fabaceae|Macrotyloma|biflorum|Macrotyloma biflorum var. biflorum	2
Commelina forskaolii Vahl	Plantae|Magnoliophyta|Liliopsida|Commelinales|Commelinaceae|Commelina|forskaolii|Commelina forskaolii Vahl	2
Turtur abyssinicus (Sharpe, 1902)	Animalia|Chordata|Aves|Columbiformes|Columbidae|Turtur|abyssinicus|Turtur abyssinicus (Sharpe, 1902)	2
Haemaphysalis houyi Nuttall & Warburton, 1915	Animalia|Arthropoda|Arachnida|Ixodida|Ixodidae|Haemaphysalis|houyi|Haemaphysalis houyi Nuttall & Warburton, 1915	2
Tricholaema lacrymosa Cabanis, 1878	Animalia|Chordata|Aves|Piciformes|Ramphastidae|Tricholaema|lacrymosa|Tricholaema lacrymosa Cabanis, 1878	2
Cisticola troglodytes (Antinori, 1864)	Animalia|Chordata|Aves|Passeriformes|Cisticolidae|Cisticola|troglodytes|Cisticola troglodytes (Antinori, 1864)	2
Bridelia scleroneura Müll.Arg.	Plantae|Tracheophyta|Magnoliopsida|Malpighiales|Phyllanthaceae|Bridelia|scleroneura|Bridelia scleroneura Müll.Arg.	2
Thamnolaea cinnamomeiventris subsp. subrufipennis	Animalia|Chordata|Aves|Passeriformes|Muscicapidae|Thamnolaea|cinnamomeiventris|Thamnolaea cinnamomeiventris subsp. subrufipennis	2
Glauconycteris superba	Animalia|Chordata|Mammalia|Chiroptera|Vespertilionidae|Glauconycteris|Glauconycteris superba	2
Naja melanoleuca Hallowell, 1857	Animalia|Chordata|Reptilia|Squamata|Elapidae|Naja|melanoleuca|Naja melanoleuca Hallowell, 1857	2
Nectarinia venusta (Shaw, 1799)	Animalia|Chordata|Aves|Passeriformes|Nectariniidae|Nectarinia|venusta|Nectarinia venusta (Shaw, 1799)	2
Emberiza tahapisi A. Smith, 1836	Animalia|Chordata|Aves|Passeriformes|Emberizidae|Emberiza|tahapisi|Emberiza tahapisi A. Smith, 1836	2
Acacia seyal var. seyal	Plantae|Tracheophyta|Magnoliopsida|Fabales|Fabaceae|Vachellia|seyal|Acacia seyal var. seyal	2
Sesbania sericea (Willd.) Link	Plantae|Tracheophyta|Magnoliopsida|Fabales|Fabaceae|Sesbania|sericea|Sesbania sericea (Willd.) Link	2
Scorpiones C. L. Koch, 1837	Animalia|Arthropoda|Arachnida|Scorpiones||||Scorpiones C. L. Koch, 1837	2
Cadaba farinosa Forssk.	Plantae|Magnoliophyta|Magnoliopsida|Brassicales|Capparaceae|Cadaba|farinosa|Cadaba farinosa Forssk.	2
Capparis fascicularis DC.	Plantae|Magnoliophyta|Magnoliopsida|Brassicales|Capparaceae|Capparis|fascicularis|Capparis fascicularis DC.	2
Cucumis ficifolius A. Rich.	Plantae|Tracheophyta|Magnoliopsida|Cucurbitales|Cucurbitaceae|Cucumis|ficifolius|Cucumis ficifolius A. Rich.	2
Dichrostachys cinerea (L.) Wight & Arn.	Plantae|Tracheophyta|Magnoliopsida|Fabales|Fabaceae|Dichrostachys|cinerea|Dichrostachys cinerea (L.) Wight & Arn.	2
Gempylus serpens Cuvier, 1829	Animalia|Chordata|Actinopterygii|Perciformes|Gempylidae|Gempylus|serpens|Gempylus serpens Cuvier, 1829	2
Clarias	Animalia|Chordata|Actinopterygii|Siluriformes|Clariidae|Clarias	2
Oldenlandia affinis (Roem. & Schult.) DC.	Plantae|Tracheophyta|Magnoliopsida|Gentianales|Rubiaceae|Oldenlandia|affinis|Oldenlandia affinis (Roem. & Schult.) DC.	2
Caprimulgus climacurus subsp. nigricans (Salvadori, 1868)	Animalia|Chordata|Aves|Caprimulgiformes|Caprimulgidae|Caprimulgus|climacurus|Caprimulgus climacurus subsp. nigricans (Salvadori, 1868)	2
Cassia singueana Delile	Plantae|Tracheophyta|Magnoliopsida|Fabales|Fabaceae|Senna|singueana|Cassia singueana Delile	2
Graphiurus kelleni (Reuvens, 1890)	Animalia|Chordata|Mammalia|Rodentia|Gliridae|Graphiurus|kelleni|Graphiurus kelleni (Reuvens, 1890)	2
Tchagra	Animalia|Chordata|Aves|Passeriformes|Malaconotidae|Tchagra|Tchagra	2
Lemniscomys Trouessart, 1881	Animalia|Chordata|Mammalia|Rodentia|Muridae|Lemniscomys||Lemniscomys Trouessart, 1881	2
Combretum aculeatum Vent.	Plantae|Tracheophyta|Magnoliopsida|Myrtales|Combretaceae|Combretum|aculeatum|Combretum aculeatum Vent.	2
Estrilda troglodytes (Lichtenstein, 1823)	Animalia|Chordata|Aves|Passeriformes|Estrildidae|Estrilda|troglodytes|Estrilda troglodytes (Lichtenstein, 1823)	2
Capparis tomentosa Lam.	Plantae|Tracheophyta|Magnoliopsida|Brassicales|Capparaceae|Capparis|tomentosa|Capparis tomentosa Lam.	2
Melierax poliopterus	Animalia|Chordata|Aves|Accipitriformes|Accipitridae|Melierax|Melierax poliopterus	2
Cinnyricinclus leucogaster (Boddaert, 1783)	Animalia|Chordata|Aves|Passeriformes|Sturnidae|Cinnyricinclus|leucogaster|Cinnyricinclus leucogaster (Boddaert, 1783)	2
Cayratia ibuensis (Hook. fil.) Suess.	Plantae|Tracheophyta|Magnoliopsida|Vitales|Vitaceae|Cayratia|ibuensis|Cayratia ibuensis (Hook. fil.) Suess.	2
Merops oreobates (Sharpe, 1892)	Animalia|Chordata|Aves|Coraciiformes|Meropidae|Merops|oreobates|Merops oreobates (Sharpe, 1892)	2
Hygrophila auriculata (Schumach.) Heine	Plantae|Tracheophyta|Magnoliopsida|Lamiales|Acanthaceae|Hygrophila|auriculata|Hygrophila auriculata (Schumach.) Heine	2
Cymothoe caenis Drury, 1773	Animalia|Arthropoda|Insecta|Lepidoptera|Nymphalidae|Cymothoe|caenis|Cymothoe caenis Drury, 1773	2
Dorstenia annua Friis & Vollesen	Plantae|Magnoliophyta|Magnoliopsida|Rosales|Moraceae|Dorstenia|annua|Dorstenia annua Friis & Vollesen	2
Dryoscopus gambensis (Lichtenstein, 1823)	Animalia|Chordata|Aves|Passeriformes|Malaconotidae|Dryoscopus|gambensis|Dryoscopus gambensis (Lichtenstein, 1823)	2
Motacilla alba Linnaeus, 1758	Animalia|Chordata|Aves|Passeriformes|Motacillidae|Motacilla|alba|Motacilla alba Linnaeus, 1758	2
Aneilema lanceolatum subsp. lanceolatum	Plantae|Magnoliophyta|Liliopsida|Commelinales|Commelinaceae|Aneilema|lanceolatum|Aneilema lanceolatum subsp. lanceolatum	2
Tchagra senegalus	Animalia|Chordata|Aves|Passeriformes|Malaconotidae|Tchagra|Tchagra senegalus	2
Estrilda troglodytes	Animalia|Chordata|Aves|Passeriformes|Estrildidae|Estrilda|Estrilda troglodytes	2
Euphorbia candelabrum var. candelabrum	Plantae|Magnoliophyta|Magnoliopsida|Malpighiales|Euphorbiaceae|Euphorbia|candelabrum|Euphorbia candelabrum var. candelabrum	2
Plocepasser superciliosus (Cretzschmar, 1827)	Animalia|Chordata|Aves|Passeriformes|Passeridae|Plocepasser|superciliosus|Plocepasser superciliosus (Cretzschmar, 1827)	2
Oxyanthus subpunctatus (Hiern) Keay	Plantae|Magnoliophyta|Magnoliopsida|Gentianales|Rubiaceae|Oxyanthus|subpunctatus|Oxyanthus subpunctatus (Hiern) Keay	2
Kobus Smith, 1840	Animalia|Chordata|Mammalia|Artiodactyla|Bovidae|Kobus||Kobus Smith, 1840	2
Micronisus gabar (Daudin, 1800)	Animalia|Chordata|Aves|Accipitriformes|Accipitridae|Micronisus|gabar|Micronisus gabar (Daudin, 1800)	2
Palpopleura portia	Animalia|Arthropoda|Insecta|Odonata|Libellulidae|Palpopleura|Palpopleura portia	2
Nycteris Geoffroy & Cuvier, 1795	Animalia|Chordata|Mammalia|Chiroptera|Nycteridae|Nycteris||Nycteris Geoffroy & Cuvier, 1795	2
Combretum adenogonium Steud. ex A.Rich.	Plantae|Magnoliophyta|Magnoliopsida|Myrtales|Combretaceae|Combretum|adenogonium|Combretum adenogonium Steud. ex A.Rich.	2
Eurytela dryope Cramer, 1779	Animalia|Arthropoda|Insecta|Lepidoptera|Nymphalidae|Eurytela|dryope|Eurytela dryope Cramer, 1779	2
Lamprotornis Temminck, 1820	Animalia|Chordata|Aves|Passeriformes|Sturnidae|Lamprotornis||Lamprotornis Temminck, 1820	2
Capparis sepiaria L.	Plantae|Tracheophyta|Magnoliopsida|Brassicales|Capparaceae|Capparis|sepiaria|Capparis sepiaria L.	2
Combretum aculeatum Vent.	Plantae|Magnoliophyta|Magnoliopsida|Myrtales|Combretaceae|Combretum|aculeatum|Combretum aculeatum Vent.	2
Coccinia grandis (L.) Voigt	Plantae|Tracheophyta|Magnoliopsida|Cucurbitales|Cucurbitaceae|Coccinia|grandis|Coccinia grandis (L.) Voigt	2
Indigofera stenophylla Guill. & Perr.	Plantae|Tracheophyta|Magnoliopsida|Fabales|Fabaceae|Indigofera|stenophylla|Indigofera stenophylla Guill. & Perr.	2
Ploceus taeniopterus (Reichenbach, 1863)	Animalia|Chordata|Aves|Passeriformes|Ploceidae|Ploceus|taeniopterus|Ploceus taeniopterus (Reichenbach, 1863)	2
Bunaea alcinoe Stoll, 1780	Animalia|Arthropoda|Insecta|Lepidoptera|Saturniidae|Bunaea|alcinoe|Bunaea alcinoe Stoll, 1780	2
Tockus nasutus (Linnaeus, 1766)	Animalia|Chordata|Aves|Bucerotiformes|Bucerotidae|Tockus|nasutus|Tockus nasutus (Linnaeus, 1766)	2
Cucumis metuliferus	Plantae|Magnoliophyta|Magnoliopsida|Cucurbitales|Cucurbitaceae|Cucumis|Cucumis metuliferus	2
Merops apiaster Linnaeus, 1758	Animalia|Chordata|Aves|Coraciiformes|Meropidae|Merops|apiaster|Merops apiaster Linnaeus, 1758	2
Grewia venusta Fresen.	Plantae|Tracheophyta|Magnoliopsida|Malvales|Malvaceae|Grewia|venusta|Grewia venusta Fresen.	2
Buteo buteo vulpinus	Animalia|Chordata|Aves|Accipitriformes|Accipitridae|Buteo|Buteo buteo vulpinus	2
Parmotrema andinum (Müll. Arg.) Hale	Fungi|Ascomycota|Lecanoromycetes|Lecanorales|Parmeliaceae|Parmotrema|andinum|Parmotrema andinum (Müll. Arg.) Hale	2
Rodentia Bowdich, 1821	Animalia|Chordata|Mammalia|Rodentia||||Rodentia Bowdich, 1821	2
Bubo cinerascens Guerin-Meneville, 1843	Animalia|Chordata|Aves|Strigiformes|Strigidae|Bubo|cinerascens|Bubo cinerascens Guerin-Meneville, 1843	2
Nycteris nana (K. Andersen, 1912)	Animalia|Chordata|Mammalia|Chiroptera|Nycteridae|Nycteris|nana|Nycteris nana (K. Andersen, 1912)	2
Odontomacrurus murrayi Norman, 1939	Animalia|Chordata|Actinopterygii|Gadiformes|Macrouridae|Odontomacrurus|murrayi|Odontomacrurus murrayi Norman, 1939	2
Gelochelidon nilotica (Gmelin, 1789)	Animalia|Chordata|Aves|Charadriiformes|Laridae|Gelochelidon|nilotica|Gelochelidon nilotica (Gmelin, 1789)	2
Oldenlandia affinis (Roem. & Schult.) DC.	Plantae|Magnoliophyta|Magnoliopsida|Gentianales|Rubiaceae|Oldenlandia|affinis|Oldenlandia affinis (Roem. & Schult.) DC.	2
Lannea humilis (Oliv.) Engl.	Plantae|Tracheophyta|Magnoliopsida|Sapindales|Anacardiaceae|Lannea|humilis|Lannea humilis (Oliv.) Engl.	2
Atelerix albiventris	Animalia|Chordata|Mammalia|Eulipotyphla|Erinaceidae|Atelerix|Atelerix albiventris	2
Ploceus vitellinus	Animalia|Chordata|Aves|Passeriformes|Ploceidae|Ploceus|Ploceus vitellinus	2
Bubo cinerascens	Animalia|Chordata|Aves|Strigiformes|Strigidae|Bubo|Bubo cinerascens	2
Spermestes cucullatus	Animalia|Chordata|Aves|Passeriformes||Spermestes|cucullatus|Spermestes cucullatus	2
Crotalaria L.	Plantae|Tracheophyta|Magnoliopsida|Fabales|Fabaceae|Crotalaria||Crotalaria L.	2
Burseraceae	Plantae|Tracheophyta|Magnoliopsida|Sapindales|Burseraceae|||Burseraceae	2
Acraea leucopyga	Animalia|Arthropoda|Insecta|Lepidoptera|Nymphalidae|Acraea|Acraea leucopyga	2
Graphiurus kelleni (Reuvens, 1890)	Animalia|Chordata|Mammalia|Rodentia|Myoxidae|Graphiurus|kelleni|Graphiurus kelleni (Reuvens, 1890)	2
Agama	Animalia|Chordata|Reptilia|Squamata|Agama	2
Clamator jacobinus (Boddaert, 1783)	Animalia|Chordata|Aves|Cuculiformes|Cuculidae|Clamator|jacobinus|Clamator jacobinus (Boddaert, 1783)	2
Grewia tenax (Forssk.) Fiori	Plantae|Tracheophyta|Magnoliopsida|Malvales|Malvaceae|Grewia|tenax|Grewia tenax (Forssk.) Fiori	2
Agama	Animalia|Chordata|Reptilia|Squamata|Agamidae|Agama	2
Coffea liberica Hiern	Plantae|Tracheophyta|Magnoliopsida|Gentianales|Rubiaceae|Coffea|liberica|Coffea liberica Hiern	2
Dorstenia annua I. Friis & K. Vollesen	Plantae|Tracheophyta|Magnoliopsida|Rosales|Moraceae|Dorstenia|annua|Dorstenia annua I. Friis & K. Vollesen	2
Atelerix albiventris (Wagner, 1841)	Animalia|Chordata|Mammalia|Erinaceomorpha|Erinaceidae|Atelerix|albiventris|Atelerix albiventris (Wagner, 1841)	2
Pennisetum polystachion (L.) Schult.	Plantae|Tracheophyta|Liliopsida|Poales|Poaceae|Pennisetum|polystachion|Pennisetum polystachion (L.) Schult.	2
Hexalobus crispiflorus A. Rich.	Plantae|Tracheophyta|Magnoliopsida|Magnoliales|Annonaceae|Hexalobus|crispiflorus|Hexalobus crispiflorus A. Rich.	2
Melocichla mentalis (Fraser, 1843)	Animalia|Chordata|Aves|Passeriformes|Macrosphenidae|Melocichla|mentalis|Melocichla mentalis (Fraser, 1843)	2
Brachiaria lata (Schumach.) C.E.Hubb.	Plantae|Tracheophyta|Liliopsida|Poales|Poaceae|Brachiaria|lata|Brachiaria lata (Schumach.) C.E.Hubb.	2
Uraeginthus bengalus	Animalia|Chordata|Aves|Passeriformes|Estrildidae|Uraeginthus|Uraeginthus bengalus	2
Actiniopteris radiata Link	Plantae|Pteridophyta|||Actiniopteridaceae|Actiniopteris|radiata|Actiniopteris radiata Link	2
Celosia trigyna L.	Plantae|Magnoliophyta|Magnoliopsida|Caryophyllales|Amaranthaceae|Celosia|trigyna|Celosia trigyna L.	2
Sylvietta brachyura Lafresnaye, 1839	Animalia|Chordata|Aves|Passeriformes|Macrosphenidae|Sylvietta|brachyura|Sylvietta brachyura Lafresnaye, 1839	2
Celosia trigyna L.	Plantae|Tracheophyta|Magnoliopsida|Caryophyllales|Amaranthaceae|Celosia|trigyna|Celosia trigyna L.	2
Capparis fascicularis var. elaeagnoides (Gilg) De Wolf	Plantae|Tracheophyta|Magnoliopsida|Brassicales|Capparaceae|Capparis|fascicularis|Capparis fascicularis var. elaeagnoides (Gilg) De Wolf	2
Sphaerothylax abyssinica (Wedd.) Warm.	Plantae|Tracheophyta|Magnoliopsida|Malpighiales|Podostemaceae|Sphaerothylax|abyssinica|Sphaerothylax abyssinica (Wedd.) Warm.	2
Palpopleura	Animalia|Arthropoda|Insecta|Odonata|Libellulidae|Palpopleura||Palpopleura	2
Mus musculoides Temminck, 1853	Animalia|Chordata|Mammalia|Rodentia|Muridae|Mus|musculoides|Mus musculoides Temminck, 1853	2
Streptopelia vinacea (Gmelin, 1789)	Animalia|Chordata|Aves|Columbiformes|Columbidae|Streptopelia|vinacea|Streptopelia vinacea (Gmelin, 1789)	2
Cayratia ibuensis (Hook.f.) Suess. & Suess.	Plantae|Magnoliophyta|Magnoliopsida|Vitales|Vitaceae|Cayratia|ibuensis|Cayratia ibuensis (Hook.f.) Suess. & Suess.	2
Zosterops senegalensis Bonaparte, 1850	Animalia|Chordata|Aves|Passeriformes|Zosteropidae|Zosterops|senegalensis|Zosterops senegalensis Bonaparte, 1850	2
Ploceus Cuvier, 1816	Animalia|Chordata|Aves|Passeriformes|Ploceidae|Ploceus||Ploceus Cuvier, 1816	2
Clamator jacobinus	Animalia|Chordata|Aves|Cuculiformes|Cuculidae|Clamator|Clamator jacobinus	2
Lybius bidentatus (Shaw, 1799)	Animalia|Chordata|Aves|Piciformes|Ramphastidae|Lybius|bidentatus|Lybius bidentatus (Shaw, 1799)	2
Combretum adenogonium Steud. ex A. Rich.	Plantae|Tracheophyta|Magnoliopsida|Myrtales|Combretaceae|Combretum|adenogonium|Combretum adenogonium Steud. ex A. Rich.	2
Lybius vieilloti vieilloti	Animalia|Chordata|Aves|Piciformes|Ramphastidae|Lybius|vieilloti|Lybius vieilloti vieilloti	2
Bitis arietans	Animalia|Chordata|Reptilia|Squamata|Viperidae|Bitis|Bitis arietans	2
Capparis tomentosa Lam.	Plantae|Magnoliophyta|Magnoliopsida|Brassicales|Capparaceae|Capparis|tomentosa|Capparis tomentosa Lam.	2
Ploceus cucullatus (Statius Muller, 1776)	Animalia|Chordata|Aves|Passeriformes|Ploceidae|Ploceus|cucullatus|Ploceus cucullatus (Statius Muller, 1776)	2
Actiniopteris radiata (Koenig ex Sw.) Link	Plantae|Tracheophyta|Polypodiopsida|Polypodiales|Pteridaceae|Actiniopteris|radiata|Actiniopteris radiata (Koenig ex Sw.) Link	2
Vidua interjecta (Grote, 1922)	Animalia|Chordata|Aves|Passeriformes|Viduidae|Vidua|interjecta|Vidua interjecta (Grote, 1922)	2
Ipomoea acanthocarpa Hochst. ex Choisy	Plantae|Magnoliophyta|Magnoliopsida|Solanales|Convolvulaceae|Ipomoea|acanthocarpa|Ipomoea acanthocarpa Hochst. ex Choisy	2
Graphium policenes (Cramer, 1775)	Animalia|Arthropoda|Insecta|Lepidoptera|Papilionidae|Graphium|policenes|Graphium policenes (Cramer, 1775)	2
Hexalobus crispiflorus A. Rich.	Plantae|Magnoliophyta|Magnoliopsida|Magnoliales|Annonaceae|Hexalobus|crispiflorus|Hexalobus crispiflorus A. Rich.	2
Coccinia grandis (L.) Voigt	Plantae|Magnoliophyta|Magnoliopsida|Cucurbitales|Cucurbitaceae|Coccinia|grandis|Coccinia grandis (L.) Voigt	2
Acacia gerrardii Benth.	Plantae|Tracheophyta|Magnoliopsida|Fabales|Fabaceae|Vachellia|gerrardii|Acacia gerrardii Benth.	2
Murdannia simplex (Vahl) Brenan	Plantae|Magnoliophyta|Liliopsida|Commelinales|Commelinaceae|Murdannia|simplex|Murdannia simplex (Vahl) Brenan	2
Hoslundia opposita Vahl	Plantae|Magnoliophyta|Magnoliopsida|Lamiales|Lamiaceae|Hoslundia|opposita|Hoslundia opposita Vahl	2
Vigna unguiculata subsp. dekindtiana (Harms) Verdc.	Plantae|Tracheophyta|Magnoliopsida|Fabales|Fabaceae|Vigna|unguiculata|Vigna unguiculata subsp. dekindtiana (Harms) Verdc.	2
Centropus senegalensis	Animalia|Chordata|Aves|Cuculiformes|Cuculidae|Centropus|Centropus senegalensis	2
Acraea leucopyga Aurivillius, 1904	Animalia|Arthropoda|Insecta|Lepidoptera|Nymphalidae|Acraea|leucopyga|Acraea leucopyga Aurivillius, 1904	2
Halcyon senegalensis (Linnaeus, 1766)	Animalia|Chordata|Aves|Coraciiformes|Alcedinidae|Halcyon|senegalensis|Halcyon senegalensis (Linnaeus, 1766)	2
Eurytela dryope	Animalia|Arthropoda|Insecta|Lepidoptera|Nymphalidae|Eurytela|Eurytela dryope	2
Cisticola lateralis (Fraser, 1843)	Animalia|Chordata|Aves|Passeriformes|Cisticolidae|Cisticola|lateralis|Cisticola lateralis (Fraser, 1843)	2
Falco chicquera Daudin, 1800	Animalia|Chordata|Aves|Falconiformes|Falconidae|Falco|chicquera|Falco chicquera Daudin, 1800	2
Estrilda paludicola Heuglin, 1863	Animalia|Chordata|Aves|Passeriformes|Estrildidae|Estrilda|paludicola|Estrilda paludicola Heuglin, 1863	2
Pytilia phoenicoptera	Animalia|Chordata|Aves|Passeriformes|Estrildidae|Pytilia|Pytilia phoenicoptera	2
Aloe macleayi Reynolds	Plantae|Tracheophyta|Liliopsida|Asparagales|Xanthorrhoeaceae|Aloë|macleayi|Aloe macleayi Reynolds	2
Nycteris arge Thomas, 1903	Animalia|Chordata|Mammalia|Chiroptera|Nycteridae|Nycteris|arge|Nycteris arge Thomas, 1903	2
Lonchura cucullata (Swainson, 1837)	Animalia|Chordata|Aves|Passeriformes|Estrildidae|Lonchura|cucullata|Lonchura cucullata (Swainson, 1837)	2
Corchorus aestuans L.	Plantae|Tracheophyta|Magnoliopsida|Malvales|Malvaceae|Corchorus|aestuans|Corchorus aestuans L.	2
Euplectes hordeaceus (Linnaeus, 1758)	Animalia|Chordata|Aves|Passeriformes|Ploceidae|Euplectes|hordeaceus|Euplectes hordeaceus (Linnaeus, 1758)	2
Aspilia kotschyi var. kotschyi	Plantae|Magnoliophyta|Magnoliopsida|Asterales|Asteraceae||kotschyi|Aspilia kotschyi var. kotschyi	2
Cassia obtusifolia L.	Plantae|Tracheophyta|Magnoliopsida|Fabales|Fabaceae|Senna|obtusifolia|Cassia obtusifolia L.	2
Campethera nubica (Boddaert, 1783)	Animalia|Chordata|Aves|Piciformes|Picidae|Campethera|nubica|Campethera nubica (Boddaert, 1783)	2
Pennisetum polystachion (L.) Schult.	Plantae|Magnoliophyta|Liliopsida|Poales|Poaceae|Pennisetum|polystachion|Pennisetum polystachion (L.) Schult.	2
Dispholidus typus Smith, 1829	Animalia|Chordata|Reptilia|Squamata|Colubridae|Dispholidus|typus|Dispholidus typus Smith, 1829	2
Kedrostis foetidissima Cogn.	Plantae|Magnoliophyta|Magnoliopsida|Cucurbitales|Cucurbitaceae|Kedrostis|foetidissima|Kedrostis foetidissima Cogn.	2
Salvadora persica L.	Plantae|Tracheophyta|Magnoliopsida|Brassicales|Salvadoraceae|Salvadora|persica|Salvadora persica L.	2
Acacia seyal var. seyal	Plantae|Magnoliophyta|Magnoliopsida|Fabales|Fabaceae|Acacia|seyal|Acacia seyal var. seyal	2
Lipocarpha prieuriana Steud.	Plantae|Tracheophyta|Liliopsida|Poales|Cyperaceae|Lipocarpha|prieuriana|Lipocarpha prieuriana Steud.	2
Solanum hastifolium Hochst. ex Dunal	Plantae|Tracheophyta|Magnoliopsida|Solanales|Solanaceae|Solanum|hastifolium|Solanum hastifolium Hochst. ex Dunal	2
Acacia sieberiana var. sieberiana	Plantae|Tracheophyta|Magnoliopsida|Fabales|Fabaceae|Vachellia|sieberiana|Acacia sieberiana var. sieberiana	1
Fimbristylis subaphylla Boeckeler	Plantae|Tracheophyta|Liliopsida|Poales|Cyperaceae|Fimbristylis|subaphylla|Fimbristylis subaphylla Boeckeler	1
Cymbopogon giganteus Chiov.	Plantae|Tracheophyta|Liliopsida|Poales|Poaceae|Cymbopogon|giganteus|Cymbopogon giganteus Chiov.	1
Petronia pyrgita (Heuglin, 1862)	Animalia|Chordata|Aves|Passeriformes|Passeridae|Gymnoris|pyrgita|Petronia pyrgita (Heuglin, 1862)	1
Psammophis sibilans (Linnaeus, 1758)	Animalia|Chordata|Reptilia|Squamata|Lamprophiidae|Psammophis|sibilans|Psammophis sibilans (Linnaeus, 1758)	1
Oldenlandia corymbosa L.	Plantae|Tracheophyta|Magnoliopsida|Gentianales|Rubiaceae|Oldenlandia|corymbosa|Oldenlandia corymbosa L.	1
Galactosomum spinetum	Animalia|Platyhelminthes|Trematoda|Opisthorchiida|Heterophyidae|Galactosomum|spinetum|Galactosomum spinetum	1
Rhamphicarpa heuglinii Hochst. ex Engl.	Plantae|Magnoliophyta|Magnoliopsida|Lamiales|Scrophulariaceae|Rhamphicarpa|heuglinii|Rhamphicarpa heuglinii Hochst. ex Engl.	1
Euschistospiza dybowskii (Oustalet, 1892)	Animalia|Chordata|Aves|Passeriformes|Estrildidae|Euschistospiza|dybowskii|Euschistospiza dybowskii (Oustalet, 1892)	1
Carissa spinarum L.	Plantae|Magnoliophyta|Magnoliopsida|Gentianales|Apocynaceae|Carissa|spinarum|Carissa spinarum L.	1
Setaria glauca (L.) P.Beauv.	Plantae|Magnoliophyta|Liliopsida|Poales|Poaceae|Pennisetum|glauca|Setaria glauca (L.) P.Beauv.	1
Hyparrhenia figariana (Chiov.) Clayton	Plantae|Magnoliophyta|Liliopsida|Poales|Poaceae|Hyparrhenia|figariana|Hyparrhenia figariana (Chiov.) Clayton	1
Fimbristylis ferruginea (L.) Vahl	Plantae|Tracheophyta|Liliopsida|Poales|Cyperaceae|Fimbristylis|ferruginea|Fimbristylis ferruginea (L.) Vahl	1
Cephaelis suaveolens Schweinf. ex Hiern	Plantae|Tracheophyta|Magnoliopsida|Gentianales|Rubiaceae|Psychotria|suaveolens|Cephaelis suaveolens Schweinf. ex Hiern	1
Dicrurus adsimilis subsp. divaricatus	Animalia|Chordata|Aves|Passeriformes|Dicruridae|Dicrurus|adsimilis|Dicrurus adsimilis subsp. divaricatus	1
Potamogeton nodosus Poir.	Plantae|Tracheophyta|Liliopsida|Alismatales|Potamogetonaceae|Potamogeton|nodosus|Potamogeton nodosus Poir.	1
Spirostreptidae Brandt, 1833	Animalia|Arthropoda|Diplopoda|Spirostreptida|Spirostreptidae|||Spirostreptidae Brandt, 1833	1
Panicum bambusiculme Friis & Vollesen	Plantae|Tracheophyta|Liliopsida|Poales|Poaceae|Panicum|bambusiculme|Panicum bambusiculme Friis & Vollesen	1
Actiniopteris semiflabellata Pic.Serm.	Plantae|Pteridophyta|||Actiniopteridaceae|Actiniopteris|semiflabellata|Actiniopteris semiflabellata Pic.Serm.	1
Turdoides rubiginosa rubiginosa	Animalia|Chordata|Aves|Passeriformes|Leiothrichidae|Turdoides|rubiginosa|Turdoides rubiginosa rubiginosa	1
Camaroptera brevicaudata	Animalia|Chordata|Aves|Passeriformes|Cisticolidae|Camaroptera|Camaroptera brevicaudata	1
Plectranthus bojeri (Benth.) Hedge	Plantae|Tracheophyta|Magnoliopsida|Lamiales|Lamiaceae|Plectranthus|bojeri|Plectranthus bojeri (Benth.) Hedge	1
Lobelia dissecta subsp. humidulorum Friis & Vollesen	Plantae|Tracheophyta|Magnoliopsida|Asterales|Campanulaceae|Lobelia|dissecta|Lobelia dissecta subsp. humidulorum Friis & Vollesen	1
Isolepis filamentosa (Vahl) Roem. & Schult.	Plantae|Tracheophyta|Liliopsida|Poales|Cyperaceae|Bulbostylis|filamentosa|Isolepis filamentosa (Vahl) Roem. & Schult.	1
Orchidaceae Juss.	Plantae|Magnoliophyta|Liliopsida|Asparagales|Orchidaceae|||Orchidaceae Juss.	1
Xeromphis nilotica (Stapf) Keay	Plantae|Tracheophyta|Magnoliopsida|Gentianales|Rubiaceae|Catunaregam|nilotica|Xeromphis nilotica (Stapf) Keay	1
Albizzia Benth.	Plantae||||Mimosaceae|Albizzia||Albizzia Benth.	1
Glauconycteris superba Hayman, 1939	Animalia|Chordata|Mammalia|Chiroptera|Vespertilionidae|Niumbaha|superba|Glauconycteris superba Hayman, 1939	1
Pavonia Cavanilles, 1786	Plantae|Magnoliophyta|Magnoliopsida|Malvales|Malvaceae|Pavonia||Pavonia Cavanilles, 1786	1
Kaupifalco monogrammicus monogrammicus	Animalia|Chordata|Aves|Accipitriformes|Accipitridae|Kaupifalco|monogrammicus|Kaupifalco monogrammicus monogrammicus	1
Melanitis leda Linnaeus, 1758	Animalia|Arthropoda|Insecta|Lepidoptera|Nymphalidae|Melanitis|leda|Melanitis leda Linnaeus, 1758	1
Crocidura gracilipes Peters, 1870	Animalia|Chordata|Mammalia|Soricomorpha|Soricidae|Crocidura|gracilipes|Crocidura gracilipes Peters, 1870	1
Plicosepalus sagittifolius (Sprague) Danser	Plantae|Magnoliophyta|Magnoliopsida|Santalales|Loranthaceae|Plicosepalus|sagittifolius|Plicosepalus sagittifolius (Sprague) Danser	1
Desmodium salicifolium (Poir.) DC.	Plantae|Magnoliophyta|Magnoliopsida|Fabales|Fabaceae|Desmodium|salicifolium|Desmodium salicifolium (Poir.) DC.	1
Causus lichtensteinii Jan, 1859	Animalia|Chordata|Reptilia|Squamata|Viperidae|Causus|lichtensteinii|Causus lichtensteinii Jan, 1859	1
Parinari excelsa Sabine	Plantae|Tracheophyta|Magnoliopsida|Malpighiales|Chrysobalanaceae|Parinari|excelsa|Parinari excelsa Sabine	1
Commelina erecta subsp. livingstonii	Plantae|Magnoliophyta|Liliopsida|Commelinales|Commelinaceae|Commelina|erecta|Commelina erecta subsp. livingstonii	1
Carissa spinarum L.	Plantae|Tracheophyta|Magnoliopsida|Gentianales|Apocynaceae|Carissa|spinarum|Carissa spinarum L.	1
Canscora diffusa (Vahl) R.Br. ex Roem. & Schult.	Plantae|Magnoliophyta|Magnoliopsida|Gentianales|Gentianaceae|Canscora|diffusa|Canscora diffusa (Vahl) R.Br. ex Roem. & Schult.	1
Fimbristylis subaphylla Boeckeler	Plantae|Magnoliophyta|Liliopsida|Poales|Cyperaceae|Fimbristylis|subaphylla|Fimbristylis subaphylla Boeckeler	1
Ctenolepis cerasiformis (Stocks) Naudin	Plantae|Magnoliophyta|Magnoliopsida|Cucurbitales|Cucurbitaceae|Ctenolepis|cerasiformis|Ctenolepis cerasiformis (Stocks) Naudin	1
Desmodium salicifolium (Poir.) DC.	Plantae|Tracheophyta|Magnoliopsida|Fabales|Fabaceae|Desmodium|salicifolium|Desmodium salicifolium (Poir.) DC.	1
Commelina benghalensis L.	Plantae|Magnoliophyta|Liliopsida|Commelinales|Commelinaceae|Commelina|benghalensis|Commelina benghalensis L.	1
Ekebergia capensis Sparrm.	Plantae|Magnoliophyta|Magnoliopsida|Sapindales|Meliaceae|Ekebergia|capensis|Ekebergia capensis Sparrm.	1
Lamprophis fuliginosus Boie, 1827	Animalia|Chordata|Reptilia|Squamata|Colubridae|Lamprophis|fuliginosus|Lamprophis fuliginosus Boie, 1827	1
Bulbostylis abortiva (Steud.) C.B.Clarke	Plantae|Tracheophyta|Liliopsida|Poales|Cyperaceae|Bulbostylis|abortiva|Bulbostylis abortiva (Steud.) C.B.Clarke	1
Siluriformes	Animalia|Chordata|Actinopterygii|Siluriformes||||Siluriformes	1
Albizia welwitschii Oliv.	Plantae|Tracheophyta|Magnoliopsida|Fabales|Fabaceae|Albizia|welwitschii|Albizia welwitschii Oliv.	1
Hipposideros abae J. A. Allen, 1917	Animalia|Chordata|Mammalia|Chiroptera|Rhinolophidae|Hipposideros|abae|Hipposideros abae J. A. Allen, 1917	1
Bathmocercus rufus subsp. vulpinus	Animalia|Chordata|Aves|Passeriformes|Sylviidae|Bathmocercus|rufus|Bathmocercus rufus subsp. vulpinus	1
Mabuya quinquetaeniata scharica Cansdale, 1951	Animalia|Chordata|Reptilia|Squamata|Scincidae|Trachylepis|quinquetaeniata|Mabuya quinquetaeniata scharica Cansdale, 1951	1
Sesbania macrantha E.Phillips & Hutch.	Plantae|Tracheophyta|Magnoliopsida|Fabales|Fabaceae|Sesbania|macrantha|Sesbania macrantha E.Phillips & Hutch.	1
Rourea minor Leenh.	Plantae|Magnoliophyta|Magnoliopsida|Oxalidales|Connaraceae|Rourea|minor|Rourea minor Leenh.	1
Eclipta prostrata (L.) L.	Plantae|Tracheophyta|Magnoliopsida|Asterales|Asteraceae|Eclipta|prostrata|Eclipta prostrata (L.) L.	1
Numida meleagris (Linnaeus, 1758)	Animalia|Chordata|Aves|Galliformes|Numididae|Numida|meleagris|Numida meleagris (Linnaeus, 1758)	1
Columba livia Gmelin, 1789	Animalia|Chordata|Aves|Columbiformes|Columbidae|Columba|livia|Columba livia Gmelin, 1789	1
Hedydipna platura (Vieillot, 1819)	Animalia|Chordata|Aves|Passeriformes|Nectariniidae|Hedydipna|platura|Hedydipna platura (Vieillot, 1819)	1
Halcyon chelicuti subsp. chelicuti	Animalia|Chordata|Aves|Coraciiformes|Alcedinidae|Halcyon|chelicuti|Halcyon chelicuti subsp. chelicuti	1
Euphorbia depauperata var. laevicarpa	Plantae|Magnoliophyta|Magnoliopsida|Malpighiales|Euphorbiaceae|Euphorbia|depauperata|Euphorbia depauperata var. laevicarpa	1
Sporobolus pyramidalis P.Beauv.	Plantae|Tracheophyta|Liliopsida|Poales|Poaceae|Sporobolus|pyramidalis|Sporobolus pyramidalis P.Beauv.	1
Fimbristylis hispidula (Vahl) Kunth	Plantae|Tracheophyta|Liliopsida|Poales|Cyperaceae|Bulbostylis|hispidula|Fimbristylis hispidula (Vahl) Kunth	1
Graueria vittata Hartert, 1908	Animalia|Chordata|Aves|Passeriformes|Cettiidae|Graueria|vittata|Graueria vittata Hartert, 1908	1
Echinochloa pyramidalis (Lam.) Hitchc. & Chase	Plantae|Tracheophyta|Liliopsida|Poales|Poaceae|Melica|pyramidalis|Echinochloa pyramidalis (Lam.) Hitchc. & Chase	1
Euplectes macroura macroura	Animalia|Chordata|Aves|Passeriformes|Ploceidae|Euplectes|macroura|Euplectes macroura macroura	1
Pytilia phoenicoptera phoenicoptera	Animalia|Chordata|Aves|Passeriformes|Estrildidae|Pytilia|phoenicoptera|Pytilia phoenicoptera phoenicoptera	1
Turtur chalcospilos (Wagler, 1827)	Animalia|Chordata|Aves|Columbiformes|Columbidae|Turtur|chalcospilos|Turtur chalcospilos (Wagler, 1827)	1
Amadina fasciata (J. F. Gmelin, 1789)	Animalia|Chordata|Aves|Passeriformes|Estrildidae|Amadina|fasciata|Amadina fasciata (J. F. Gmelin, 1789)	1
Hyptis spicigera Lam.	Plantae|Magnoliophyta|Magnoliopsida|Lamiales|Lamiaceae|Hyptis|spicigera|Hyptis spicigera Lam.	1
Borreria chaetocephala (DC.) Hepper	Plantae|Tracheophyta|Magnoliopsida|Gentianales|Rubiaceae|Spermacoce|chaetocephala|Borreria chaetocephala (DC.) Hepper	1
Bitis arietans Merrem, 1820	Animalia|Chordata|Reptilia|Squamata|Viperidae|Bitis|arietans|Bitis arietans Merrem, 1820	1
Papio anubis (Lesson, 1827)	Animalia|Chordata|Mammalia|Primates|Cercopithecidae|Papio|anubis|Papio anubis (Lesson, 1827)	1
Ploceus cucullatus (Müller, 1776)	Animalia|Chordata|Aves|Passeriformes|Ploceidae|Ploceus|cucullatus|Ploceus cucullatus (Müller, 1776)	1
Psidium guajava L.	Plantae|Magnoliophyta|Magnoliopsida|Myrtales|Myrtaceae|Psidium|guajava|Psidium guajava L.	1
Heliotropium strigosum Willd.	Plantae|Tracheophyta|Magnoliopsida|Boraginales|Boraginaceae|Euploca|strigosum|Heliotropium strigosum Willd.	1
Tribulus terrestris L.	Plantae|Tracheophyta|Magnoliopsida|Zygophyllales|Zygophyllaceae|Tribulus|terrestris|Tribulus terrestris L.	1
Amaurornis flavirostra (Swainson, 1837)	Animalia|Chordata|Aves|Gruiformes|Rallidae|Amaurornis|flavirostra|Amaurornis flavirostra (Swainson, 1837)	1
Lagonosticta rara subsp. rara	Animalia|Chordata|Aves|Passeriformes|Estrildidae|Lagonosticta|rara|Lagonosticta rara subsp. rara	1
Aldrovanda vesiculosa L.	Plantae|Magnoliophyta|Magnoliopsida|Caryophyllales|Droseraceae|Aldrovanda|vesiculosa|Aldrovanda vesiculosa L.	1
Euplectes ardens (Boddaert, 1783)	Animalia|Chordata|Aves|Passeriformes|Ploceidae|Euplectes|ardens|Euplectes ardens (Boddaert, 1783)	1
Potamogeton octandrus Poir.	Plantae|Magnoliophyta|Liliopsida|Alismatales|Potamogetonaceae|Potamogeton|octandrus|Potamogeton octandrus Poir.	1
Chalcomitra senegalensis (Linnaeus, 1766)	Animalia|Chordata|Aves|Passeriformes|Nectariniidae|Chalcomitra|senegalensis|Chalcomitra senegalensis (Linnaeus, 1766)	1
Cyperus capillifolius A.Rich.	Plantae|Tracheophyta|Liliopsida|Poales|Cyperaceae|Pycreus|capillifolius|Cyperus capillifolius A.Rich.	1
Ciconia episcopus subsp. microscelis G. R. Gray, 1848	Animalia|Chordata|Aves|Ciconiiformes|Ciconiidae|Ciconia|episcopus|Ciconia episcopus subsp. microscelis G. R. Gray, 1848	1
Crotalaria aculeata De Wild.	Plantae|Magnoliophyta|Magnoliopsida|Fabales|Fabaceae|Crotalaria|aculeata|Crotalaria aculeata De Wild.	1
Micropteropus pusillus (Peters, 1867)	Animalia|Chordata|Mammalia|Chiroptera|Pteropodidae|Micropteropus|pusillus|Micropteropus pusillus (Peters, 1867)	1
Camaroptera brachyura brevicaudata	Animalia|Chordata|Aves|Passeriformes|Cisticolidae|Camaroptera|Camaroptera brachyura brevicaudata	1
Achyrospermum axillare E.A.Bruce	Plantae|Tracheophyta|Magnoliopsida|Lamiales|Lamiaceae|Achyrospermum|axillare|Achyrospermum axillare E.A.Bruce	1
Dinemellia dinemelli dinemelli	Animalia|Chordata|Aves|Passeriformes|Ploceidae|Dinemellia|dinemelli|Dinemellia dinemelli dinemelli	1
Acraea acerata Hewitson, 1874	Animalia|Arthropoda|Insecta|Lepidoptera|Nymphalidae|Acraea|acerata|Acraea acerata Hewitson, 1874	1
Gomphrena celosioides Mart.	Plantae|Tracheophyta|Magnoliopsida|Caryophyllales|Amaranthaceae|Gomphrena|celosioides|Gomphrena celosioides Mart.	1
Poicephalus meyeri (Cretzschmar, 1827)	Animalia|Chordata|Aves|Psittaciformes|Psittacidae|Poicephalus|meyeri|Poicephalus meyeri (Cretzschmar, 1827)	1
Eriosema macrostipulum Baker f.	Plantae|Tracheophyta|Magnoliopsida|Fabales|Fabaceae|Eriosema|macrostipulum|Eriosema macrostipulum Baker f.	1
Borassus aethiopum Mart.	Plantae|Magnoliophyta|Liliopsida|Arecales|Arecaceae|Borassus|aethiopum|Borassus aethiopum Mart.	1
Duosperma glabratum Vollesen	Plantae|Tracheophyta|Magnoliopsida|Lamiales|Acanthaceae|Duosperma|glabratum|Duosperma glabratum Vollesen	1
Orchidaceae	Plantae|Tracheophyta|Liliopsida|Asparagales|Orchidaceae|||Orchidaceae	1
Diospyros abyssinica subsp. abyssinica	Plantae|Tracheophyta|Magnoliopsida|Ericales|Ebenaceae|Diospyros|abyssinica|Diospyros abyssinica subsp. abyssinica	1
Alestes baremoze (Joannis, 1835)	Animalia|Chordata|Actinopterygii|Characiformes|Alestidae|Alestes|baremoze|Alestes baremoze (Joannis, 1835)	1
Cossypha heuglini subsp. heuglini	Animalia|Chordata|Aves|Passeriformes|Muscicapidae|Cossypha|heuglini|Cossypha heuglini subsp. heuglini	1
Clarias Scopoli, 1777	Animalia|Chordata|Actinopterygii|Siluriformes|Clariidae|Clarias||Clarias Scopoli, 1777	1
Phoeniculus purpureus (J. F. Miller, 1784)	Animalia|Chordata|Aves|Bucerotiformes|Phoeniculidae|Phoeniculus|purpureus|Phoeniculus purpureus (J. F. Miller, 1784)	1
Neptis serena Overlaet, 1955	Animalia|Arthropoda|Insecta|Lepidoptera|Nymphalidae|Neptis|serena|Neptis serena Overlaet, 1955	1
Chrysanthellum americum	Plantae|Tracheophyta|Magnoliopsida|Asterales|Asteraceae|Chrysanthellum|americum|Chrysanthellum americum	1
Cyanotis axillaris (L.) D.Don ex Sweet	Plantae|Tracheophyta|Liliopsida|Commelinales|Commelinaceae|Cyanotis|axillaris|Cyanotis axillaris (L.) D.Don ex Sweet	1
Opilia amentacea Roxb.	Plantae|Tracheophyta|Magnoliopsida|Santalales|Opiliaceae|Opilia|amentacea|Opilia amentacea Roxb.	1
Serinus mozambicus (Statius Muller, 1776)	Animalia|Chordata|Aves|Passeriformes|Fringillidae|Serinus|mozambicus|Serinus mozambicus (Statius Muller, 1776)	1
Basella L.	Plantae|Magnoliophyta|Magnoliopsida|Caryophyllales|Basellaceae|Basella||Basella L.	1
Andira Lam.	Plantae|Tracheophyta|Magnoliopsida|Fabales|Fabaceae|Andira||Andira Lam.	1
Gardenia ternifolia var. goetzei	Plantae|Magnoliophyta|Magnoliopsida|Gentianales|Rubiaceae|Gardenia|ternifolia|Gardenia ternifolia var. goetzei	1
Ficus sycomorus L.	Plantae|Magnoliophyta|Magnoliopsida|Rosales|Moraceae|Ficus|sycomorus|Ficus sycomorus L.	1
Oxyanthus speciosus DC.	Plantae|Tracheophyta|Magnoliopsida|Gentianales|Rubiaceae|Oxyanthus|speciosus|Oxyanthus speciosus DC.	1
Rhynchosia minima (L.) DC.	Plantae|Magnoliophyta|Magnoliopsida|Fabales|Fabaceae|Rhynchosia|minima|Rhynchosia minima (L.) DC.	1
Saxicola torquata (Linnaeus, 1766)	Animalia|Chordata|Aves|Passeriformes|Muscicapidae|Saxicola|torquata|Saxicola torquata (Linnaeus, 1766)	1
Sorghum Moench	Plantae|Magnoliophyta|Liliopsida|Poales|Poaceae|Sorghum||Sorghum Moench	1
Columba guinea Linnaeus, 1758	Animalia|Chordata|Aves|Columbiformes|Columbidae|Columba|guinea|Columba guinea Linnaeus, 1758	1
Stephania Lour.	Plantae|Tracheophyta|Magnoliopsida|Ranunculales|Menispermaceae|Stephania||Stephania Lour.	1
Lophuromys ansorgei De Winton, 1896	Animalia|Chordata|Mammalia|Rodentia|Muridae|Lophuromys|ansorgei|Lophuromys ansorgei De Winton, 1896	1
Diplopoda	Animalia|Arthropoda|Diplopoda|||||Diplopoda	1
Gymnema sylvestre (Retz.) Schult.	Plantae|Tracheophyta|Magnoliopsida|Gentianales|Apocynaceae|Gymnema|sylvestre|Gymnema sylvestre (Retz.) Schult.	1
Dendrocygna viduata (Linnaeus, 1766)	Animalia|Chordata|Aves|Anseriformes|Anatidae|Dendrocygna|viduata|Dendrocygna viduata (Linnaeus, 1766)	1
Erythrocebus patas pyrrhonotus	Animalia|Chordata|Mammalia|Primates|Cercopithecidae|Erythrocebus|Erythrocebus patas pyrrhonotus	1
Parinari excelsa Sabine	Plantae|Magnoliophyta|Magnoliopsida|Malpighiales|Chrysobalanaceae|Parinari|excelsa|Parinari excelsa Sabine	1
Odonata Fabricius, 1793	Animalia|Arthropoda|Insecta|Odonata||||Odonata Fabricius, 1793	1
Eriosema pulcherrimum Taub.	Plantae|Tracheophyta|Magnoliopsida|Fabales|Fabaceae|Eriosema|pulcherrimum|Eriosema pulcherrimum Taub.	1
Clytospiza monteiri (Hartlaub, 1860)	Animalia|Chordata|Aves|Passeriformes|Estrildidae|Clytospiza|monteiri|Clytospiza monteiri (Hartlaub, 1860)	1
Chrysopogon nigritanus (Benth.) Veldkamp	Plantae|Tracheophyta|Liliopsida|Poales|Poaceae|Chrysopogon|nigritanus|Chrysopogon nigritanus (Benth.) Veldkamp	1
Ceratophyllum L.	Plantae|Tracheophyta|Magnoliopsida|Ceratophyllales|Ceratophyllaceae|Ceratophyllum||Ceratophyllum L.	1
Phalacrocorax africanus (Gmelin, 1789)	Animalia|Chordata|Aves|Suliformes|Phalacrocoracidae|Microcarbo|africanus|Phalacrocorax africanus (Gmelin, 1789)	1
Acomys percivali Dollman, 1911	Animalia|Chordata|Mammalia|Rodentia|Muridae|Acomys|percivali|Acomys percivali Dollman, 1911	1
Amadina fasciata (Gmelin, 1789)	Animalia|Chordata|Aves|Passeriformes|Estrildidae|Amadina|fasciata|Amadina fasciata (Gmelin, 1789)	1
Prinia subflava (J. F. Gmelin, 1789)	Animalia|Chordata|Aves|Passeriformes|Cisticolidae|Prinia|subflava|Prinia subflava (J. F. Gmelin, 1789)	1
Persicaria decipiens (R. Br.) K. L. Wilson	Plantae|Tracheophyta|Magnoliopsida|Caryophyllales|Polygonaceae|Persicaria|decipiens|Persicaria decipiens (R. Br.) K. L. Wilson	1
Adiantum poiretii Wikstr.	Plantae|Pteridophyta|Polypodiopsida|Polypodiales|Pteridaceae|Adiantum|poiretii|Adiantum poiretii Wikstr.	1
Chrysanthellum americanum (L.) Vatke	Plantae|Magnoliophyta|Magnoliopsida|Asterales|Asteraceae|Chrysanthellum|americanum|Chrysanthellum americanum (L.) Vatke	1
Terpsiphone viridis kivuensis	Animalia|Chordata|Aves|Passeriformes|Monarchidae|Terpsiphone|viridis|Terpsiphone viridis kivuensis	1
Ipomoea prismatosyphon var. prismatosyphon	Plantae|Tracheophyta|Magnoliopsida|Solanales|Convolvulaceae|Ipomoea|prismatosyphon|Ipomoea prismatosyphon var. prismatosyphon	1
Eremomela scotops Sundevall, 1850	Animalia|Chordata|Aves|Passeriformes|Cisticolidae|Eremomela|scotops|Eremomela scotops Sundevall, 1850	1
Glauconycteris superba Hayman, 1939	Animalia|Chordata|Mammalia|Chiroptera|Vespertilionidae|Glauconycteris|superba|Glauconycteris superba Hayman, 1939	1
Eriosema macrostipulum Baker f.	Plantae|Magnoliophyta|Magnoliopsida|Fabales|Fabaceae|Eriosema|macrostipulum|Eriosema macrostipulum Baker f.	1
Catunaregam taylorii (S.Moore) Bridson	Plantae|Tracheophyta|Magnoliopsida|Gentianales|Rubiaceae|Catunaregam|taylorii|Catunaregam taylorii (S.Moore) Bridson	1
Monanthotaxis buchananii (Engl.) Verdc.	Plantae|Magnoliophyta|Magnoliopsida|Magnoliales|Annonaceae|Monanthotaxis|buchananii|Monanthotaxis buchananii (Engl.) Verdc.	1
Serinus citrinelloides Ruppell, 1840	Animalia|Chordata|Aves|Passeriformes|Fringillidae|Crithagra|citrinelloides|Serinus citrinelloides Ruppell, 1840	1
Cyperus capillifolius A.Rich.	Plantae|Magnoliophyta|Liliopsida|Poales|Cyperaceae|Pycreus|capillifolius|Cyperus capillifolius A.Rich.	1
Melaenornis edolioides (Swainson, 1837)	Animalia|Chordata|Aves|Passeriformes|Muscicapidae|Melaenornis|edolioides|Melaenornis edolioides (Swainson, 1837)	1
Fimbristylis hispidula (Vahl) Kunth	Plantae|Magnoliophyta|Liliopsida|Poales|Cyperaceae|Bulbostylis|hispidula|Fimbristylis hispidula (Vahl) Kunth	1
Balanites aegyptiaca (L.) Delile	Plantae|Tracheophyta|Magnoliopsida|Zygophyllales|Zygophyllaceae|Balanites|aegyptiaca|Balanites aegyptiaca (L.) Delile	1
Oxyanthus speciosus DC.	Plantae|Magnoliophyta|Magnoliopsida|Gentianales|Rubiaceae|Oxyanthus|speciosus|Oxyanthus speciosus DC.	1
Sphenostylis schweinfurthii Harms	Plantae|Tracheophyta|Magnoliopsida|Fabales|Fabaceae|Sphenostylis|schweinfurthii|Sphenostylis schweinfurthii Harms	1
Ipomoea quamoclit L.	Plantae|Tracheophyta|Magnoliopsida|Solanales|Convolvulaceae|Ipomoea|quamoclit|Ipomoea quamoclit L.	1
Achyrospermum axillare E.A.Bruce	Plantae|Magnoliophyta|Magnoliopsida|Lamiales|Lamiaceae|Achyrospermum|axillare|Achyrospermum axillare E.A.Bruce	1
Cordia rothii Roem. & Schult.	Plantae|Tracheophyta|Magnoliopsida|Boraginales|Boraginaceae|Cordia|rothii|Cordia rothii Roem. & Schult.	1
Euphorbia depauperata var. laevicarpa Friis & Vollesen	Plantae|Tracheophyta|Magnoliopsida|Malpighiales|Euphorbiaceae|Euphorbia|depauperata|Euphorbia depauperata var. laevicarpa Friis & Vollesen	1
Aneilema lanceolatum Benth.	Plantae|Magnoliophyta|Liliopsida|Commelinales|Commelinaceae|Aneilema|lanceolatum|Aneilema lanceolatum Benth.	1
Dacus ciliatus Loew, 1862	Animalia|Arthropoda|Insecta|Diptera|Lauxaniidae|Dacus|ciliatus|Dacus ciliatus Loew, 1862	1
Trachylepis quinquetaeniata	Animalia|Chordata|Reptilia|Squamata|Scincidae|Trachylepis|Trachylepis quinquetaeniata	1
Hyparrhenia Andersson ex E. Fourn.	Plantae|Magnoliophyta|Liliopsida|Poales|Poaceae|Hyparrhenia||Hyparrhenia Andersson ex E. Fourn.	1
Eulophia petersii (Rchb.f.) Rchb.f.	Plantae|Tracheophyta|Liliopsida|Asparagales|Orchidaceae|Eulophia|petersii|Eulophia petersii (Rchb.f.) Rchb.f.	1
Psychotria mahonii var. puberula (E.M.A.Petit) Verdc.	Plantae|Tracheophyta|Magnoliopsida|Gentianales|Rubiaceae|Psychotria|mahonii|Psychotria mahonii var. puberula (E.M.A.Petit) Verdc.	1
Phylloscopus collybita (Vieillot, 1817)	Animalia|Chordata|Aves|Passeriformes|Phylloscopidae|Phylloscopus|collybita|Phylloscopus collybita (Vieillot, 1817)	1
Streptopelia decipiens (Hartlaub & Finsch, 1870)	Animalia|Chordata|Aves|Columbiformes|Columbidae|Streptopelia|decipiens|Streptopelia decipiens (Hartlaub & Finsch, 1870)	1
Cisticola cantans (Heuglin, 1869)	Animalia|Chordata|Aves|Passeriformes|Cisticolidae|Cisticola|cantans|Cisticola cantans (Heuglin, 1869)	1
Hyparrhenia filipendula (Hochst.) Stapf	Plantae|Tracheophyta|Liliopsida|Poales|Poaceae|Hyparrhenia|filipendula|Hyparrhenia filipendula (Hochst.) Stapf	1
Lygodactylus Gray, 1864	Animalia|Chordata|Reptilia|Squamata|Gekkonidae|Lygodactylus||Lygodactylus Gray, 1864	1
Dalbergia melanoxylon Guill. & Perr.	Plantae|Tracheophyta|Magnoliopsida|Fabales|Fabaceae|Dalbergia|melanoxylon|Dalbergia melanoxylon Guill. & Perr.	1
Mus minutoides A. Smith, 1834	Animalia|Chordata|Mammalia|Rodentia|Muridae|Mus|minutoides|Mus minutoides A. Smith, 1834	1
Lophuromys ansorgei de Winton, 1896	Animalia|Chordata|Mammalia|Rodentia|Muridae|Lophuromys|ansorgei|Lophuromys ansorgei de Winton, 1896	1
Prunus africana (Hook. fil.) Kalkm.	Plantae|Tracheophyta|Magnoliopsida|Rosales|Rosaceae|Pygeum|africana|Prunus africana (Hook. fil.) Kalkm.	1
Belenois gidica (Godart, 1819)	Animalia|Arthropoda|Insecta|Lepidoptera|Pieridae|Belenois|gidica|Belenois gidica (Godart, 1819)	1
Heteropogon contortus (L.) P.Beauv. ex Roem. & Schult.	Plantae|Tracheophyta|Liliopsida|Poales|Poaceae|Heteropogon|contortus|Heteropogon contortus (L.) P.Beauv. ex Roem. & Schult.	1
Indigofera simplicifolia Lam.	Plantae|Tracheophyta|Magnoliopsida|Fabales|Fabaceae|Indigofera|simplicifolia|Indigofera simplicifolia Lam.	1
Eremospatha haullevilleana De Wild.	Plantae|Magnoliophyta|Liliopsida|Arecales|Arecaceae|Eremospatha|haullevilleana|Eremospatha haullevilleana De Wild.	1
Turdoides plebejus (Cretzschmar, 1828)	Animalia|Chordata|Aves|Passeriformes|Sylviidae|Turdoides|plebejus|Turdoides plebejus (Cretzschmar, 1828)	1
Milvus migrans parasitus	Animalia|Chordata|Aves|Accipitriformes|Accipitridae|Milvus|Milvus migrans parasitus	1
Platycerium elephantotis Schweinf.	Plantae|Pteridophyta|Polypodiopsida|Polypodiales|Polypodiaceae|Platycerium|elephantotis|Platycerium elephantotis Schweinf.	1
Hamanumida daedalus Fabricius, 1775	Animalia|Arthropoda|Insecta|Lepidoptera|Nymphalidae|Hamanumida|daedalus|Hamanumida daedalus Fabricius, 1775	1
Milvus migrans	Animalia|Chordata|Aves|Accipitriformes|Accipitridae|Milvus|Milvus migrans	1
Heliotropium longiflorum (A.DC.) C.Jaubert & E.Spach	Plantae|Magnoliophyta|Magnoliopsida|Boraginales|Boraginaceae|Heliotropium|longiflorum|Heliotropium longiflorum (A.DC.) C.Jaubert & E.Spach	1
Eriospermum abyssinicum Baker	Plantae|Magnoliophyta|Liliopsida|Asparagales|Asparagaceae|Eriospermum|abyssinicum|Eriospermum abyssinicum Baker	1
Dregea rubicunda (N. E. Br.) K. Schum.	Plantae|Tracheophyta|Magnoliopsida|Gentianales|Apocynaceae|Marsdenia|rubicunda|Dregea rubicunda (N. E. Br.) K. Schum.	1
Pipistrellus nanus (Peters, 1852)	Animalia|Chordata|Mammalia|Chiroptera|Vespertilionidae|Pipistrellus|nanus|Pipistrellus nanus (Peters, 1852)	1
Sesbania macrantha E.Phillips & Hutch.	Plantae|Magnoliophyta|Magnoliopsida|Fabales|Fabaceae|Sesbania|macrantha|Sesbania macrantha E.Phillips & Hutch.	1
Protea L.	Plantae|Tracheophyta|Magnoliopsida|Proteales|Proteaceae|Protea||Protea L.	1
Acacia persiciflora Pax	Plantae|Tracheophyta|Magnoliopsida|Fabales|Fabaceae|Senegalia|persiciflora|Acacia persiciflora Pax	1
Prunus africana (Hook.f.) Kalkman	Plantae|Magnoliophyta|Magnoliopsida|Rosales|Rosaceae|Prunus|africana|Prunus africana (Hook.f.) Kalkman	1
Eurema hecabe (Linnaeus, 1758)	Animalia|Arthropoda|Insecta|Lepidoptera|Pieridae|Eurema|hecabe|Eurema hecabe (Linnaeus, 1758)	1
Circus macrourus (S. G. Gmelin, 1770)	Animalia|Chordata|Aves|Accipitriformes|Accipitridae|Circus|macrourus|Circus macrourus (S. G. Gmelin, 1770)	1
Jussiaea suffruticosa var. linearis (Willd.) Bertoni	Plantae|Magnoliophyta|Magnoliopsida|Myrtales|Onagraceae|Jussiaea|suffruticosa|Jussiaea suffruticosa var. linearis (Willd.) Bertoni	1
Ipomoea aquatica Forssk.	Plantae|Magnoliophyta|Magnoliopsida|Solanales|Convolvulaceae|Ipomoea|aquatica|Ipomoea aquatica Forssk.	1
Sporobolus cordofanus (Hochst. ex Steud.) Hérincq ex Coss.	Plantae|Magnoliophyta|Liliopsida|Poales|Poaceae|Sporobolus|cordofanus|Sporobolus cordofanus (Hochst. ex Steud.) Hérincq ex Coss.	1
Acraea sykesi Sharpe, 1902	Animalia|Arthropoda|Insecta|Lepidoptera|Nymphalidae|Acraea|sykesi|Acraea sykesi Sharpe, 1902	1
Brachystephanus C.G.D. Nees in Alph. de Candolle, 1847	Plantae|Magnoliophyta|Magnoliopsida|Lamiales|Acanthaceae|Brachystephanus||Brachystephanus C.G.D. Nees in Alph. de Candolle, 1847	1
Aspilia kotschyi var. alba Berhaut	Plantae|Tracheophyta|Magnoliopsida|Asterales|Asteraceae|Aspilia|kotschyi|Aspilia kotschyi var. alba Berhaut	1
Causus lichtensteinii (Jan, 1859)	Animalia|Chordata|Reptilia|Squamata|Viperidae|Causus|lichtensteinii|Causus lichtensteinii (Jan, 1859)	1
Indigofera andrewsiana J.B.Gillett	Plantae|Tracheophyta|Magnoliopsida|Fabales|Fabaceae|Indigofera|andrewsiana|Indigofera andrewsiana J.B.Gillett	1
Albizia welwitschii Oliv.	Plantae|Magnoliophyta|Magnoliopsida|Asterales|Asteraceae|Albizia|welwitschii|Albizia welwitschii Oliv.	1
Ypthima granulosa Butler, 1883	Animalia|Arthropoda|Insecta|Lepidoptera|Nymphalidae|Ypthima|granulosa|Ypthima granulosa Butler, 1883	1
Chaerephon pumilus Cretzschmar, 1830-, 1831	Animalia|Chordata|Mammalia|Chiroptera|Molossidae|Chaerephon|pumilus|Chaerephon pumilus Cretzschmar, 1830-, 1831	1
Solanum hastifolium Hochst. ex Dunal	Plantae|Magnoliophyta|Magnoliopsida|Solanales|Solanaceae|Solanum|hastifolium|Solanum hastifolium Hochst. ex Dunal	1
Striga aspera (Willd.) Benth.	Plantae|Tracheophyta|Magnoliopsida|Lamiales|Orobanchaceae|Striga|aspera|Striga aspera (Willd.) Benth.	1
Monanthotaxis buchananii (Engl.) Verdc.	Plantae|Tracheophyta|Magnoliopsida|Magnoliales|Annonaceae|Monanthotaxis|buchananii|Monanthotaxis buchananii (Engl.) Verdc.	1
Chassalia cristata (Hiern) Bremek.	Plantae|Magnoliophyta|Magnoliopsida|Gentianales|Rubiaceae|Chassalia|cristata|Chassalia cristata (Hiern) Bremek.	1
Tatera valida (Bocage, 1890)	Animalia|Chordata|Mammalia|Rodentia|Muridae|Gerbilliscus|valida|Tatera valida (Bocage, 1890)	1
Maranthes polyandra (Benth.) Prance	Plantae|Tracheophyta|Magnoliopsida|Malpighiales|Chrysobalanaceae|Maranthes|polyandra|Maranthes polyandra (Benth.) Prance	1
Crotalaria intermedia Kotschy	Plantae|Tracheophyta|Magnoliopsida|Fabales|Fabaceae|Crotalaria|intermedia|Crotalaria intermedia Kotschy	1
Borreria tenuissima Schweinf. ex Hiern	Plantae|Magnoliophyta|Magnoliopsida|Gentianales|Rubiaceae|Spermacoce|tenuissima|Borreria tenuissima Schweinf. ex Hiern	1
Crotalaria aculeata subsp. claessensii (De Wild.) Polhill	Plantae|Tracheophyta|Magnoliopsida|Fabales|Fabaceae|Crotalaria|aculeata|Crotalaria aculeata subsp. claessensii (De Wild.) Polhill	1
Acraea Fabricius, 1808	Animalia|Arthropoda|Insecta|Lepidoptera|Nymphalidae|Acraea||Acraea Fabricius, 1808	1
Apiaceae Lindl.	Plantae|Magnoliophyta|Magnoliopsida|Apiales|Apiaceae|||Apiaceae Lindl.	1
Merremia tridentata subsp. angustifolia (Jacq.) Ooststr.	Plantae|Magnoliophyta|Magnoliopsida|Solanales|Convolvulaceae|Xenostegia|tridentata|Merremia tridentata subsp. angustifolia (Jacq.) Ooststr.	1
Allophylus rubifolius (Hochst. ex A. Rich.) Engl.	Plantae|Tracheophyta|Magnoliopsida|Sapindales|Sapindaceae|Allophylus|rubifolius|Allophylus rubifolius (Hochst. ex A. Rich.) Engl.	1
Acrocephalus griseldis (Hartlaub, 1891)	Animalia|Chordata|Aves|Passeriformes|Acrocephalidae|Acrocephalus|griseldis|Acrocephalus griseldis (Hartlaub, 1891)	1
Courbonia virgata Brongn.	Plantae|Tracheophyta|Magnoliopsida|Brassicales|Capparaceae|Maerua|virgata|Courbonia virgata Brongn.	1
Canscora diffusa (Vahl) R. Br. ex Roem. & Schult.	Plantae|Tracheophyta|Magnoliopsida|Gentianales|Gentianaceae|Canscora|diffusa|Canscora diffusa (Vahl) R. Br. ex Roem. & Schult.	1
Bathmocercus rufus Reichenow, 1895	Animalia|Chordata|Aves|Passeriformes|Sylviidae|Bathmocercus|rufus|Bathmocercus rufus Reichenow, 1895	1
Kobus kob subsp. thomasi P. L. Sclater, 1896	Animalia|Chordata|Mammalia|Artiodactyla|Bovidae|Kobus|kob|Kobus kob subsp. thomasi P. L. Sclater, 1896	1
Desmodium hirtum Guill. & Perr.	Plantae|Tracheophyta|Magnoliopsida|Fabales|Fabaceae|Desmodium|hirtum|Desmodium hirtum Guill. & Perr.	1
Courbonia virgata Brongn.	Plantae|Magnoliophyta|Magnoliopsida|Brassicales|Capparaceae|Courbonia|virgata|Courbonia virgata Brongn.	1
Adenium obesum (Forssk.) Roem. & Schult.	Plantae|Tracheophyta|Magnoliopsida|Gentianales|Apocynaceae|Adenium|obesum|Adenium obesum (Forssk.) Roem. & Schult.	1
Indicator indicator (Sparrman, 1777)	Animalia|Chordata|Aves|Piciformes|Indicatoridae|Indicator|indicator|Indicator indicator (Sparrman, 1777)	1
Lobelia dissecta subsp. humidulorum	Plantae|Magnoliophyta|Magnoliopsida|Asterales|Campanulaceae|Lobelia|dissecta|Lobelia dissecta subsp. humidulorum	1
Gonimbrasia hecate Rougeot, 1955	Animalia|Arthropoda|Insecta|Lepidoptera|Saturniidae|Gonimbrasia|hecate|Gonimbrasia hecate Rougeot, 1955	1
Lanistes nyassanus Dohrn, 1865	Animalia|Mollusca|Gastropoda||Ampullariidae|Lanistes|nyassanus|Lanistes nyassanus Dohrn, 1865	1
Rhus natalensis Bernh. ex Krauss	Plantae|Magnoliophyta|Magnoliopsida|Sapindales|Anacardiaceae|Rhus|natalensis|Rhus natalensis Bernh. ex Krauss	1
Kigelia africana (Lam.) Benth.	Plantae|Magnoliophyta|Magnoliopsida|Lamiales|Bignoniaceae|Kigelia|africana|Kigelia africana (Lam.) Benth.	1
Alternanthera pungens Kunth	Plantae|Magnoliophyta|Magnoliopsida|Caryophyllales|Amaranthaceae|Alternanthera|pungens|Alternanthera pungens Kunth	1
Crotalaria bongensis Baker f.	Plantae|Magnoliophyta|Magnoliopsida|Fabales|Fabaceae|Crotalaria|bongensis|Crotalaria bongensis Baker f.	1
Prionops plumatus (Shaw, 1809)	Animalia|Chordata|Aves|Passeriformes|Malaconotidae|Prionops|plumatus|Prionops plumatus (Shaw, 1809)	1
Mesopicos goertae (Statius M?ller, 1776)	Animalia|Chordata|Aves|Piciformes|Picidae|Mesopicos|goertae|Mesopicos goertae (Statius M?ller, 1776)	1
Junonia oenone Linnaeus, 1764	Animalia|Arthropoda|Insecta|Lepidoptera|Nymphalidae|Junonia|oenone|Junonia oenone Linnaeus, 1764	1
Grammomys dolichurus (Smuts, 1832)	Animalia|Chordata|Mammalia|Rodentia|Muridae|Grammomys|dolichurus|Grammomys dolichurus (Smuts, 1832)	1
Borreria tenuissima (Hiern) Schweinf. ex K.Schum.	Plantae|Tracheophyta|Magnoliopsida|Gentianales|Rubiaceae|Spermacoce|tenuissima|Borreria tenuissima (Hiern) Schweinf. ex K.Schum.	1
Allophylus rubifolius Engl.	Plantae|Magnoliophyta|Magnoliopsida|Sapindales|Sapindaceae|Allophylus|rubifolius|Allophylus rubifolius Engl.	1
Homalium abdessammadii Aschers. & Schweinf	Plantae|Tracheophyta|Magnoliopsida|Malpighiales|Salicaceae|Homalium|abdessammadii|Homalium abdessammadii Aschers. & Schweinf	1
Zornia glochidiata DC.	Plantae|Tracheophyta|Magnoliopsida|Fabales|Fabaceae|Zornia|glochidiata|Zornia glochidiata DC.	1
Hyliota flavigaster Swainson, 1837	Animalia|Chordata|Aves|Passeriformes|Sylviidae|Hyliota|flavigaster|Hyliota flavigaster Swainson, 1837	1
Aerva javanica (Burm. f.) Juss. ex Schult.	Plantae|Magnoliophyta|Magnoliopsida|Caryophyllales|Amaranthaceae|Aerva|javanica|Aerva javanica (Burm. f.) Juss. ex Schult.	1
Terathopius ecaudatus (Daudin, 1800)	Animalia|Chordata|Aves|Accipitriformes|Accipitridae|Terathopius|ecaudatus|Terathopius ecaudatus (Daudin, 1800)	1
Sporobolus festivus Hochst.	Plantae|Tracheophyta|Liliopsida|Poales|Poaceae|Sporobolus|festivus|Sporobolus festivus Hochst.	1
Mesopicos Malherbe, 1849	Animalia|Chordata|Aves|Piciformes|Picidae|Mesopicos||Mesopicos Malherbe, 1849	1
Cercomela familiaris (Stephens, 1826)	Animalia|Chordata|Aves|Passeriformes|Muscicapidae|Oenanthe|familiaris|Cercomela familiaris (Stephens, 1826)	1
Clamator Kaup, 1829	Animalia|Chordata|Aves|Cuculiformes|Cuculidae|Clamator||Clamator Kaup, 1829	1
Bidens negriana (Sherff) Cufod.	Plantae|Tracheophyta|Magnoliopsida|Asterales|Asteraceae|Bidens|negriana|Bidens negriana (Sherff) Cufod.	1
Diospyros abyssinica subsp. abyssinica	Plantae|Magnoliophyta|Magnoliopsida|Ericales|Ebenaceae|Diospyros|abyssinica|Diospyros abyssinica subsp. abyssinica	1
Andira Juss.	Plantae|Magnoliophyta|Magnoliopsida|Fabales|Fabaceae|Andira||Andira Juss.	1
Mycteria ibis (Linnaeus, 1766)	Animalia|Chordata|Aves|Ciconiiformes|Ciconiidae|Mycteria|ibis|Mycteria ibis (Linnaeus, 1766)	1
Ptychadena mascareniensis (Duméril & Bibron, 1841)	Animalia|Chordata|Amphibia|Anura|Ptychadenidae|Ptychadena|mascareniensis|Ptychadena mascareniensis (Duméril & Bibron, 1841)	1
Panicum bambusiculme Friis & Vollesen	Plantae|Magnoliophyta|Liliopsida|Poales|Poaceae|Panicum|bambusiculme|Panicum bambusiculme Friis & Vollesen	1
Crotalaria microcarpa Benth.	Plantae|Tracheophyta|Magnoliopsida|Fabales|Fabaceae|Crotalaria|microcarpa|Crotalaria microcarpa Benth.	1
Cyanomitra verticalis (Latham, 1790)	Animalia|Chordata|Aves|Passeriformes|Nectariniidae|Cyanomitra|verticalis|Cyanomitra verticalis (Latham, 1790)	1
Psammophis mossambicus Peters, 1882	Animalia|Chordata|Reptilia|Squamata|Lamprophiidae|Psammophis|mossambicus|Psammophis mossambicus Peters, 1882	1
Cyperus angolensis Boeckeler	Plantae|Magnoliophyta|Liliopsida|Poales|Cyperaceae|Cyperus|angolensis|Cyperus angolensis Boeckeler	1
Rhamphicarpa heuglinii Hochst. ex Schweinf.	Plantae|Tracheophyta|Magnoliopsida|Lamiales|Orobanchaceae|Cycnium|heuglinii|Rhamphicarpa heuglinii Hochst. ex Schweinf.	1
Bathmocercus rufus vulpinus	Animalia|Chordata|Aves|Passeriformes|Cisticolidae|Bathmocercus|rufus|Bathmocercus rufus vulpinus	1
Selaginella njamnjamensis Hieron.	Plantae|Lycopodiophyta|Lycopodiopsida|Selaginellales|Selaginellaceae|Selaginella|njamnjamensis|Selaginella njamnjamensis Hieron.	1
Ploceus ocularis A. Smith, 1828	Animalia|Chordata|Aves|Passeriformes|Ploceidae|Ploceus|ocularis|Ploceus ocularis A. Smith, 1828	1
Prionops plumatus vinaceigularis	Animalia|Chordata|Aves|Passeriformes|Prionopidae|Prionops|plumatus|Prionops plumatus vinaceigularis	1
Sorghum bicolor nothosubsp. drummondii (Steudel) de Wet	Plantae|Tracheophyta|Liliopsida|Poales|Poaceae|Sorghum|bicolor|Sorghum bicolor nothosubsp. drummondii (Steudel) de Wet	1
Hymenocoleus hirsutus (Benth.) Robbr.	Plantae|Magnoliophyta|Magnoliopsida|Gentianales|Rubiaceae|Hymenocoleus|hirsutus|Hymenocoleus hirsutus (Benth.) Robbr.	1
Lybius vieilloti subsp. vieilloti	Animalia|Chordata|Aves|Piciformes|Ramphastidae|Lybius|vieilloti|Lybius vieilloti subsp. vieilloti	1
Striga asiatica (L.) Kuntze	Plantae|Tracheophyta|Magnoliopsida|Lamiales|Orobanchaceae|Striga|asiatica|Striga asiatica (L.) Kuntze	1
Pytilia phoenicoptera subsp. phoenicoptera	Animalia|Chordata|Aves|Passeriformes|Estrildidae|Pytilia|phoenicoptera|Pytilia phoenicoptera subsp. phoenicoptera	1
Sporobolus cordofanus (Hochst. ex Steud.) Hérincq ex Coss.	Plantae|Tracheophyta|Liliopsida|Poales|Poaceae|Sporobolus|cordofanus|Sporobolus cordofanus (Hochst. ex Steud.) Hérincq ex Coss.	1
Cycadales	Plantae|Cycadophyta|Cycadopsida|Cycadales||||Cycadales	1
Lybius leucocephalus subsp. leucocephalus	Animalia|Chordata|Aves|Piciformes|Ramphastidae|Lybius|leucocephalus|Lybius leucocephalus subsp. leucocephalus	1
Hemidactylus mabouia Moreau DE Jonnès, 1818	Animalia|Chordata|Reptilia|Squamata|Gekkonidae|Hemidactylus|mabouia|Hemidactylus mabouia Moreau DE Jonnès, 1818	1
Jussiaea suffruticosa var. linearis (Willd.) Oliv. ex O. Kuntze	Plantae|Tracheophyta|Magnoliopsida|Myrtales|Onagraceae|Ludwigia|suffruticosa|Jussiaea suffruticosa var. linearis (Willd.) Oliv. ex O. Kuntze	1
Bulbostylis abortiva (Steud.) C.B.Clarke	Plantae|Magnoliophyta|Liliopsida|Poales|Cyperaceae|Bulbostylis|abortiva|Bulbostylis abortiva (Steud.) C.B.Clarke	1
Apiaceae	Plantae|Tracheophyta|Magnoliopsida|Apiales|Apiaceae|||Apiaceae	1
Myonycteris torquata (Dobson, 1878)	Animalia|Chordata|Mammalia|Chiroptera|Pteropodidae|Myonycteris|torquata|Myonycteris torquata (Dobson, 1878)	1
Estrilda Swainson, 1827	Animalia|Chordata|Aves|Passeriformes|Estrildidae|Estrilda||Estrilda Swainson, 1827	1
Pytilia melba belli	Animalia|Chordata|Aves|Passeriformes|Estrildidae|Pytilia|melba|Pytilia melba belli	1
Caprimulgus climacurus nigricans (Salvadori, 1868)	Animalia|Chordata|Aves|Strigiformes|Caprimulgidae|Caprimulgus|climacurus|Caprimulgus climacurus nigricans (Salvadori, 1868)	1
Andropogon brazzae Franch.	Plantae|Tracheophyta|Liliopsida|Poales|Poaceae|Andropogon|brazzae|Andropogon brazzae Franch.	1
Ipomoea prismatosyphon Welw.	Plantae|Tracheophyta|Magnoliopsida|Solanales|Convolvulaceae|Ipomoea|prismatosyphon|Ipomoea prismatosyphon Welw.	1
Clitoria ternatea L.	Plantae|Tracheophyta|Magnoliopsida|Fabales|Fabaceae|Clitoria|ternatea|Clitoria ternatea L.	1
Solanum L.	Plantae|Magnoliophyta|Magnoliopsida|Solanales|Solanaceae|Solanum||Solanum L.	1
Jacquemontia tamnifolia (L.) Griseb.	Plantae|Magnoliophyta|Magnoliopsida|Solanales|Convolvulaceae|Jacquemontia|tamnifolia|Jacquemontia tamnifolia (L.) Griseb.	1
Ipomoea coptica (L.) Roth ex Roem. & Schult.	Plantae|Tracheophyta|Magnoliopsida|Solanales|Convolvulaceae|Ipomoea|coptica|Ipomoea coptica (L.) Roth ex Roem. & Schult.	1
Ipomoea obscura (L.) Ker Gawler	Plantae|Tracheophyta|Magnoliopsida|Solanales|Convolvulaceae|Ipomoea|obscura|Ipomoea obscura (L.) Ker Gawler	1
Crotalaria microcarpa Benth.	Plantae|Magnoliophyta|Magnoliopsida|Fabales|Fabaceae|Crotalaria|microcarpa|Crotalaria microcarpa Benth.	1
Indigofera andrewsiana J.B.Gillett	Plantae|Magnoliophyta|Magnoliopsida|Fabales|Fabaceae|Indigofera|andrewsiana|Indigofera andrewsiana J.B.Gillett	1
Acrocephalus griseldis (Hartlaub, 1891)	Animalia|Chordata|Aves|Passeriformes|Sylviidae|Acrocephalus|griseldis|Acrocephalus griseldis (Hartlaub, 1891)	1
Ipomoea quamoclit L.	Plantae|Magnoliophyta|Magnoliopsida|Solanales|Convolvulaceae|Ipomoea|quamoclit|Ipomoea quamoclit L.	1
Setaria glauca Kunth	Plantae|Tracheophyta|Liliopsida|Poales|Poaceae|Setaria|glauca|Setaria glauca Kunth	1
Dendropicos fuscescens (Vieillot, 1818)	Animalia|Chordata|Aves|Piciformes|Picidae|Dendropicos|fuscescens|Dendropicos fuscescens (Vieillot, 1818)	1
Encephalartos septentrionalis Schweinf.	Plantae|Cycadophyta|Cycadopsida|Cycadales|Zamiaceae|Encephalartos|septentrionalis|Encephalartos septentrionalis Schweinf.	1
Piliostigma reticulatum (DC.) Hochst.	Plantae|Tracheophyta|Magnoliopsida|Fabales|Fabaceae|Bauhinia|reticulatum|Piliostigma reticulatum (DC.) Hochst.	1
Peristrophe bicalyculata Nees	Plantae|Magnoliophyta|Magnoliopsida|Lamiales|Acanthaceae|Peristrophe|bicalyculata|Peristrophe bicalyculata Nees	1
Crotalaria bongensis Baker f.	Plantae|Tracheophyta|Magnoliopsida|Fabales|Fabaceae|Crotalaria|bongensis|Crotalaria bongensis Baker f.	1
Peucedanum grantii Kingston ex Oliv.	Plantae|Tracheophyta|Magnoliopsida|Apiales|Apiaceae|Lefebvrea|grantii|Peucedanum grantii Kingston ex Oliv.	1
Fimbristylis aestivalis Vahl	Plantae|Magnoliophyta|Liliopsida|Poales|Cyperaceae|Fimbristylis|aestivalis|Fimbristylis aestivalis Vahl	1
Psammophis mossambicus Peters, 1882	Animalia|Chordata|Reptilia|Squamata|Colubridae|Psammophis|mossambicus|Psammophis mossambicus Peters, 1882	1
Bitis arietans (Merrem, 1820)	Animalia|Chordata|Reptilia|Squamata|Viperidae|Bitis|arietans|Bitis arietans (Merrem, 1820)	1
Brachiaria brizantha (A.Rich.) Stapf	Plantae|Magnoliophyta|Liliopsida|Poales|Poaceae|Brachiaria|brizantha|Brachiaria brizantha (A.Rich.) Stapf	1
Hyparrhenia rufa (Nees) Stapf	Plantae|Magnoliophyta|Liliopsida|Poales|Poaceae|Hyparrhenia|rufa|Hyparrhenia rufa (Nees) Stapf	1
Nephila Leach, 1815	Animalia|Arthropoda|Arachnida|Araneae|Nephilidae|Nephila||Nephila Leach, 1815	1
Plectranthus bojeri (Benth.) Hedge	Plantae|Magnoliophyta|Magnoliopsida|Lamiales|Lamiaceae|Plectranthus|bojeri|Plectranthus bojeri (Benth.) Hedge	1
Justicia ladanoides Lam.	Plantae|Magnoliophyta|Magnoliopsida|Lamiales|Acanthaceae|Justicia|ladanoides|Justicia ladanoides Lam.	1
Actiniopteris semiflabellata Pichi-Serm.	Plantae|Tracheophyta|Polypodiopsida|Polypodiales|Pteridaceae|Actiniopteris|semiflabellata|Actiniopteris semiflabellata Pichi-Serm.	1
Commelina schweinfurthii C.B.Clarke	Plantae|Tracheophyta|Liliopsida|Commelinales|Commelinaceae|Commelina|schweinfurthii|Commelina schweinfurthii C.B.Clarke	1
Accipitriformes	Animalia|Chordata|Aves|Accipitriformes||||Accipitriformes	1
Campephaga phoenicea (Latham, 1790)	Animalia|Chordata|Aves|Passeriformes|Campephagidae|Campephaga|phoenicea|Campephaga phoenicea (Latham, 1790)	1
Trachylepis quinquetaeniata Lichtenstein, 1823	Animalia|Chordata|Reptilia|Squamata|Scincidae|Trachylepis|quinquetaeniata|Trachylepis quinquetaeniata Lichtenstein, 1823	1
Bistrispinaria magniceps (Bezzi, 1918)	Animalia|Arthropoda|Insecta|Diptera|Tephritidae|Bistrispinaria|magniceps|Bistrispinaria magniceps (Bezzi, 1918)	1
Lanistes nyassanus Dohrn, 1865	Animalia|Mollusca|Gastropoda|Architaenioglossa|Ampullariidae|Lanistes|nyassanus|Lanistes nyassanus Dohrn, 1865	1
Psammophis sibilans Linnaeus, 1758	Animalia|Chordata|Reptilia|Squamata|Colubridae|Psammophis|sibilans|Psammophis sibilans Linnaeus, 1758	1
Commelina schweinfurthii C.B.Clarke	Plantae|Magnoliophyta|Liliopsida|Commelinales|Commelinaceae|Commelina|schweinfurthii|Commelina schweinfurthii C.B.Clarke	1
Xeromphis nilotica (Stapf) Keay	Plantae|Magnoliophyta|Magnoliopsida|Gentianales|Rubiaceae|Catunaregam|nilotica|Xeromphis nilotica (Stapf) Keay	1
Borreria chaetocephala (DC.) Hepper	Plantae|Magnoliophyta|Magnoliopsida|Gentianales|Rubiaceae|Spermacoce|chaetocephala|Borreria chaetocephala (DC.) Hepper	1
Ipomoea coptica (L.) Roth ex Roem. & Schult.	Plantae|Magnoliophyta|Magnoliopsida|Solanales|Convolvulaceae|Ipomoea|coptica|Ipomoea coptica (L.) Roth ex Roem. & Schult.	1
Crotalaria aculeata De Wild.	Plantae|Tracheophyta|Magnoliopsida|Fabales|Fabaceae|Crotalaria|aculeata|Crotalaria aculeata De Wild.	1
Nycteris grandis Peters, 1865	Animalia|Chordata|Mammalia|Chiroptera|Nycteridae|Nycteris|grandis|Nycteris grandis Peters, 1865	1
Actophilornis africanus (Gmelin, 1789)	Animalia|Chordata|Aves|Charadriiformes|Jacanidae|Actophilornis|africanus|Actophilornis africanus (Gmelin, 1789)	1
Vidua obtusa (Chapin, 1922)	Animalia|Chordata|Aves|Passeriformes|Viduidae|Vidua|obtusa|Vidua obtusa (Chapin, 1922)	1
Craibia laurentii (De Wild.) De Wild.	Plantae|Magnoliophyta|Magnoliopsida|Fabales|Fabaceae|Craibia|laurentii|Craibia laurentii (De Wild.) De Wild.	1
Brachystephanus sudanicus (Friis & Vollesen) Champl.	Plantae|Tracheophyta|Magnoliopsida|Lamiales|Acanthaceae|Brachystephanus|sudanicus|Brachystephanus sudanicus (Friis & Vollesen) Champl.	1
Crocidura turba Dollman, 1910	Animalia|Chordata|Mammalia|Soricomorpha|Soricidae|Crocidura|turba|Crocidura turba Dollman, 1910	1
Pogoniulus chrysoconus chrysoconus	Animalia|Chordata|Aves|Piciformes|Ramphastidae|Pogoniulus|chrysoconus|Pogoniulus chrysoconus chrysoconus	1
Agapornis pullarius (Linnaeus, 1758)	Animalia|Chordata|Aves|Psittaciformes|Psittacidae|Agapornis|pullarius|Agapornis pullarius (Linnaeus, 1758)	1
Mylothris chloris (Fabricius, 1775)	Animalia|Arthropoda|Insecta|Lepidoptera|Pieridae|Mylothris|chloris|Mylothris chloris (Fabricius, 1775)	1
Dactyloctenium aegyptium (L.) Willd.	Plantae|Tracheophyta|Liliopsida|Poales|Poaceae|Dactyloctenium|aegyptium|Dactyloctenium aegyptium (L.) Willd.	1
Brachiaria mutica (Forssk.) Stapf	Plantae|Tracheophyta|Liliopsida|Poales|Poaceae|Brachiaria|mutica|Brachiaria mutica (Forssk.) Stapf	1
Accipiter badius sphenurus (Rüppell, 1836)	Animalia|Chordata|Aves|Accipitriformes|Accipitridae|Accipiter|badius|Accipiter badius sphenurus (Rüppell, 1836)	1
Synodontis Cuvier, 1816	Animalia|Chordata|Actinopterygii|Siluriformes|Mochokidae|Synodontis||Synodontis Cuvier, 1816	1
Fimbristylis miliacea (L.) Vahl	Plantae|Tracheophyta|Liliopsida|Poales|Cyperaceae|Fimbristylis|miliacea|Fimbristylis miliacea (L.) Vahl	1
Dendropicos goertae abessinicus (Reichenow, 1900)	Animalia|Chordata|Aves|Piciformes|Picidae|Dendropicos|goertae|Dendropicos goertae abessinicus (Reichenow, 1900)	1
Talinum portulacifolium (Forssk.) Asch. ex Schweinf.	Plantae|Magnoliophyta|Magnoliopsida|Caryophyllales|Talinaceae|Talinum|portulacifolium|Talinum portulacifolium (Forssk.) Asch. ex Schweinf.	1
Sphenostylis schweinfurthii Harms	Plantae|Magnoliophyta|Magnoliopsida|Fabales|Fabaceae|Sphenostylis|schweinfurthii|Sphenostylis schweinfurthii Harms	1
Harrisonia abyssinica Oliv.	Plantae|Magnoliophyta|Magnoliopsida|Sapindales|Rutaceae|Harrisonia|abyssinica|Harrisonia abyssinica Oliv.	1
Saxicola torquatus axillaris	Animalia|Chordata|Aves|Passeriformes|Muscicapidae|Saxicola|torquatus|Saxicola torquatus axillaris	1
Solanum anguivi Lam.	Plantae|Tracheophyta|Magnoliopsida|Solanales|Solanaceae|Solanum|anguivi|Solanum anguivi Lam.	1
Strychnos inocua subsp. inocua	Plantae|Tracheophyta|Magnoliopsida|Gentianales|Loganiaceae|Strychnos|inocua|Strychnos inocua subsp. inocua	1
Canscora decussata (Roxb.) Schult.	Plantae|Tracheophyta|Magnoliopsida|Gentianales|Gentianaceae|Canscora|decussata|Canscora decussata (Roxb.) Schult.	1
Amietophrynus	Animalia|Chordata|Amphibia|Anura|Bufonidae|Amietophrynus||Amietophrynus	1
Rousettus aegyptiacus (E. Geoffroy, 1810)	Animalia|Chordata|Mammalia|Chiroptera|Pteropodidae|Rousettus|aegyptiacus|Rousettus aegyptiacus (E. Geoffroy, 1810)	1
Ficus Linnaeus, 1753	Plantae|Magnoliophyta|Magnoliopsida|Rosales|Moraceae|Ficus||Ficus Linnaeus, 1753	1
Potamogeton octandrus Poir.	Plantae|Tracheophyta|Liliopsida|Alismatales|Potamogetonaceae|Potamogeton|octandrus|Potamogeton octandrus Poir.	1
Solanum dasyphyllum Schumach. & Thonn.	Plantae|Tracheophyta|Magnoliopsida|Solanales|Solanaceae|Solanum|dasyphyllum|Solanum dasyphyllum Schumach. & Thonn.	1
Riparia cincta erlangeri	Animalia|Chordata|Aves|Passeriformes|Hirundinidae|Riparia|cincta|Riparia cincta erlangeri	1
Pytilia melba (Linnaeus, 1758)	Animalia|Chordata|Aves|Passeriformes|Estrildidae|Pytilia|melba|Pytilia melba (Linnaeus, 1758)	1
Hyptis suaveolens (L.) Poit.	Plantae|Magnoliophyta|Magnoliopsida|Lamiales|Lamiaceae|Hyptis|suaveolens|Hyptis suaveolens (L.) Poit.	1
Fimbristylis ferruginea (L.) Vahl	Plantae|Magnoliophyta|Liliopsida|Poales|Cyperaceae|Fimbristylis|ferruginea|Fimbristylis ferruginea (L.) Vahl	1
Lissotis melanogaster (Ruppell, 1835)	Animalia|Chordata|Aves|Otidiformes|Otididae|Lissotis|melanogaster|Lissotis melanogaster (Ruppell, 1835)	1
Chassalia cristata (Hiern) Bremek.	Plantae|Tracheophyta|Magnoliopsida|Gentianales|Rubiaceae|Chassalia|cristata|Chassalia cristata (Hiern) Bremek.	1
Francolinus coqui (A. Smith, 1836)	Animalia|Chordata|Aves|Galliformes|Phasianidae|Francolinus|coqui|Francolinus coqui (A. Smith, 1836)	1
Solanum giganteum Jacq.	Plantae|Tracheophyta|Magnoliopsida|Solanales|Solanaceae|Solanum|giganteum|Solanum giganteum Jacq.	1
Hyptis spicigera Lam.	Plantae|Tracheophyta|Magnoliopsida|Lamiales|Lamiaceae|Cantinoa|spicigera|Hyptis spicigera Lam.	1
Pennisetum glaucum (L.) R.Br.	Plantae|Magnoliophyta|Liliopsida|Poales|Poaceae|Pennisetum|glaucum|Pennisetum glaucum (L.) R.Br.	1
Aneilema lanceolatum Benth.	Plantae|Tracheophyta|Liliopsida|Commelinales|Commelinaceae|Aneilema|lanceolatum|Aneilema lanceolatum Benth.	1
Talinum portulacifolium (Forsk.) Aschers. ex Schweinf.	Plantae|Tracheophyta|Magnoliopsida|Caryophyllales|Talinaceae|Talinum|portulacifolium|Talinum portulacifolium (Forsk.) Aschers. ex Schweinf.	1
Hyliota flavigaster flavigaster	Animalia|Chordata|Aves|Passeriformes|Hyliotidae|Hyliota|flavigaster|Hyliota flavigaster flavigaster	1
Galactosomum spinetum (Braun, 1901)	Animalia|Platyhelminthes|Trematoda|Plagiorchiida|Heterophyidae|Galactosomum|spinetum|Galactosomum spinetum (Braun, 1901)	1
Gomphrena celosioides Mart.	Plantae|Magnoliophyta|Magnoliopsida|Caryophyllales|Amaranthaceae|Gomphrena|celosioides|Gomphrena celosioides Mart.	1
Ludwigia perennis Burm. f.	Plantae|Magnoliophyta|Magnoliopsida|Myrtales|Onagraceae|Ludwigia|perennis|Ludwigia perennis Burm. f.	1
Commelina erecta subsp. livingstonii (C.B.Clarke) J.K.Morton	Plantae|Tracheophyta|Liliopsida|Commelinales|Commelinaceae|Commelina|erecta|Commelina erecta subsp. livingstonii (C.B.Clarke) J.K.Morton	1
Duosperma glabratum Vollesen	Plantae|Magnoliophyta|Magnoliopsida|Lamiales|Acanthaceae|Duosperma|glabratum|Duosperma glabratum Vollesen	1
Acacia sieberiana var. sieberiana	Plantae|Magnoliophyta|Magnoliopsida|Fabales|Fabaceae|Acacia|sieberiana|Acacia sieberiana var. sieberiana	1
Justicia ladanoides Lam.	Plantae|Tracheophyta|Magnoliopsida|Lamiales|Acanthaceae|Justicia|ladanoides|Justicia ladanoides Lam.	1
Ploceus cucullatus subsp. bohndorffi	Animalia|Chordata|Aves|Passeriformes|Ploceidae|Ploceus|cucullatus|Ploceus cucullatus subsp. bohndorffi	1
Digitaria longiflora (Retz.) Pers.	Plantae|Tracheophyta|Liliopsida|Poales|Poaceae|Digitaria|longiflora|Digitaria longiflora (Retz.) Pers.	1
Pytilia melba subsp. belli	Animalia|Chordata|Aves|Passeriformes|Estrildidae|Pytilia|melba|Pytilia melba subsp. belli	1
Canscora decussata (Roxb.) Roem. & Schult.	Plantae|Magnoliophyta|Magnoliopsida|Gentianales|Gentianaceae|Canscora|decussata|Canscora decussata (Roxb.) Roem. & Schult.	1
Aethomys Thomas, 1915	Animalia|Chordata|Mammalia|Rodentia|Muridae|Aethomys||Aethomys Thomas, 1915	1
Urochloa P. Beauv.	Plantae|Magnoliophyta|Liliopsida|Poales|Poaceae|Urochloa||Urochloa P. Beauv.	1
Commelina benghalensis var. hirsuta	Plantae|Magnoliophyta|Liliopsida|Commelinales|Commelinaceae|Commelina|benghalensis|Commelina benghalensis var. hirsuta	1
Picoides obsoletus	Animalia|Chordata|Aves|Piciformes|Picidae|Dendrocopos|obsoletus|Picoides obsoletus	1
Psittacula krameri (Scopoli, 1769)	Animalia|Chordata|Aves|Psittaciformes|Psittacidae|Psittacula|krameri|Psittacula krameri (Scopoli, 1769)	1
Eulophia petersii (Rchb.f.) Rchb.f.	Plantae|Magnoliophyta|Liliopsida|Asparagales|Orchidaceae|Eulophia|petersii|Eulophia petersii (Rchb.f.) Rchb.f.	1
Commelina benghalensis var. hirsuta C.B.Clarke	Plantae|Tracheophyta|Liliopsida|Commelinales|Commelinaceae|Commelina|benghalensis|Commelina benghalensis var. hirsuta C.B.Clarke	1
Opilia amentacea Roxb.	Plantae|Magnoliophyta|Magnoliopsida|Santalales|Opiliaceae|Opilia|amentacea|Opilia amentacea Roxb.	1
Hymenocoleus hirsutus (Benth.) Robbr.	Plantae|Tracheophyta|Magnoliopsida|Gentianales|Rubiaceae|Hymenocoleus|hirsutus|Hymenocoleus hirsutus (Benth.) Robbr.	1
Sporobolus festivus Hochst. ex A.Rich.	Plantae|Magnoliophyta|Liliopsida|Poales|Poaceae|Sporobolus|festivus|Sporobolus festivus Hochst. ex A.Rich.	1
Monodora angolensis Welw.	Plantae|Magnoliophyta|Magnoliopsida|Magnoliales|Annonaceae|Monodora|angolensis|Monodora angolensis Welw.	1
Dendropicos poecilolaemus Reichenow, 1893	Animalia|Chordata|Aves|Piciformes|Picidae|Dendropicos|poecilolaemus|Dendropicos poecilolaemus Reichenow, 1893	1
Peucedanum grantii Kingston ex Oliv.	Plantae|Magnoliophyta|Magnoliopsida|Apiales|Apiaceae|Lefebvrea|grantii|Peucedanum grantii Kingston ex Oliv.	1
Hyliota flavigaster subsp. flavigaster	Animalia|Chordata|Aves|Passeriformes|Sylviidae|Hyliota|flavigaster|Hyliota flavigaster subsp. flavigaster	1
Megaceryle maximus	Animalia|Chordata|Aves|Coraciiformes|Alcedinidae|Megaceryle|maximus|Megaceryle maximus	1
Nymphaea nouchali var. caerulea (Savigny) B. Verdcourt	Plantae|Tracheophyta|Magnoliopsida|Nymphaeales|Nymphaeaceae|Nymphaea|nouchali|Nymphaea nouchali var. caerulea (Savigny) B. Verdcourt	1
Ipomoea aquatica Forsk.	Plantae|Tracheophyta|Magnoliopsida|Solanales|Convolvulaceae|Ipomoea|aquatica|Ipomoea aquatica Forsk.	1
Indigofera simplicifolia Lam.	Plantae|Magnoliophyta|Magnoliopsida|Fabales|Fabaceae|Indigofera|simplicifolia|Indigofera simplicifolia Lam.	1
Merremia tridentata subsp. angustifolia (Jacq.) Ooststr.	Plantae|Tracheophyta|Magnoliopsida|Solanales|Convolvulaceae|Xenostegia|tridentata|Merremia tridentata subsp. angustifolia (Jacq.) Ooststr.	1
Laniarius aethiopicus (Gmelin, 1789)	Animalia|Chordata|Aves|Passeriformes|Malaconotidae|Laniarius|aethiopicus|Laniarius aethiopicus (Gmelin, 1789)	1
Crotalaria intermedia sensu auct.	Plantae|Magnoliophyta|Magnoliopsida|Fabales|Fabaceae|Crotalaria|intermedia|Crotalaria intermedia sensu auct.	1
Junonia chorimene Guérin-Méneville, 1844	Animalia|Arthropoda|Insecta|Lepidoptera|Nymphalidae|Junonia|chorimene|Junonia chorimene Guérin-Méneville, 1844	1
Cypsiurus parvus (Lichtenstein, 1823)	Animalia|Chordata|Aves|Apodiformes|Apodidae|Cypsiurus|parvus|Cypsiurus parvus (Lichtenstein, 1823)	1
Cyperus papyrus L.	Plantae|Magnoliophyta|Liliopsida|Poales|Cyperaceae|Cyperus|papyrus|Cyperus papyrus L.	1
Bridelia scleroneura subsp. scleroneura	Plantae|Tracheophyta|Magnoliopsida|Malpighiales|Phyllanthaceae|Bridelia|scleroneura|Bridelia scleroneura subsp. scleroneura	1
Persicaria decipiens (R. Br.) K.L. Wilson	Plantae|Magnoliophyta|Magnoliopsida|Caryophyllales|Polygonaceae|Persicaria|decipiens|Persicaria decipiens (R. Br.) K.L. Wilson	1
Danaus chrysippus Linnaeus, 1758	Animalia|Arthropoda|Insecta|Lepidoptera|Nymphalidae|Danaus|chrysippus|Danaus chrysippus Linnaeus, 1758	1
Cossypha heuglini heuglini	Animalia|Chordata|Aves|Passeriformes|Muscicapidae|Cossypha|heuglini|Cossypha heuglini heuglini	1
Accipiter badius (Gmelin, 1788)	Animalia|Chordata|Aves|Accipitriformes|Accipitridae|Accipiter|badius|Accipiter badius (Gmelin, 1788)	1
Varanus niloticus (Linnaeus, 1766)	Animalia|Chordata|Reptilia|Squamata|Varanidae|Varanus|niloticus|Varanus niloticus (Linnaeus, 1766)	1
Lagonosticta rubricata (Lichtenstein, 1823)	Animalia|Chordata|Aves|Passeriformes|Estrildidae|Lagonosticta|rubricata|Lagonosticta rubricata (Lichtenstein, 1823)	1
Sesamum angustifolium Engl.	Plantae|Magnoliophyta|Magnoliopsida|Lamiales|Pedaliaceae|Sesamum|angustifolium|Sesamum angustifolium Engl.	1
Chrysopogon nigritanus (Benth.) Veldkamp	Plantae|Magnoliophyta|Liliopsida|Poales|Poaceae|Chrysopogon|nigritanus|Chrysopogon nigritanus (Benth.) Veldkamp	1
Ipomoea obscura (L.) Ker Gawl.	Plantae|Magnoliophyta|Magnoliopsida|Solanales|Convolvulaceae|Ipomoea|obscura|Ipomoea obscura (L.) Ker Gawl.	1
Cyperus iria L.	Plantae|Tracheophyta|Liliopsida|Poales|Cyperaceae|Cyperus|iria|Cyperus iria L.	1
Anura	Animalia|Chordata|Amphibia|Anura||||Anura	1
Maranthes polyandra (Benth.) Prance	Plantae|Magnoliophyta|Magnoliopsida|Malpighiales|Chrysobalanaceae|Maranthes|polyandra|Maranthes polyandra (Benth.) Prance	1
Platysteira cyanea (Statius Muller, 1776)	Animalia|Chordata|Aves|Passeriformes|Platysteiridae|Platysteira|cyanea|Platysteira cyanea (Statius Muller, 1776)	1
Hyparrhenia figariana (Chiov.) Clayton	Plantae|Tracheophyta|Liliopsida|Poales|Poaceae|Hyparrhenia|figariana|Hyparrhenia figariana (Chiov.) Clayton	1
Squamata Oppel, 1811	Animalia|Chordata|Reptilia|Squamata||||Squamata Oppel, 1811	1
Isolepis filamentosa (Vahl) Roem. & Schult.	Plantae|Magnoliophyta|Liliopsida|Poales|Cyperaceae|Bulbostylis|filamentosa|Isolepis filamentosa (Vahl) Roem. & Schult.	1
Dendropicos goertae (Statius Muller, 1776)	Animalia|Chordata|Aves|Piciformes|Picidae|Dendropicos|goertae|Dendropicos goertae (Statius Muller, 1776)	1
Sesamum angustifolium (Oliv.) Engl.	Plantae|Tracheophyta|Magnoliopsida|Lamiales|Pedaliaceae|Sesamum|angustifolium|Sesamum angustifolium (Oliv.) Engl.	1
Coleoptera Linnaeus, 1758	Animalia|Arthropoda|Insecta|Coleoptera||||Coleoptera Linnaeus, 1758	1
Commelina benghalensis L.	Plantae|Tracheophyta|Liliopsida|Commelinales|Commelinaceae|Commelina|benghalensis|Commelina benghalensis L.	1
Coracias naevius Daudin, 1800	Animalia|Chordata|Aves|Coraciiformes|Coraciidae|Coracias|naevius|Coracias naevius Daudin, 1800	1
Papilio demodocus Esper, 1798	Animalia|Arthropoda|Insecta|Lepidoptera|Papilionidae|Papilio|demodocus|Papilio demodocus Esper, 1798	1
Indigofera arecta A.Rich.	Plantae|Magnoliophyta|Magnoliopsida|Fabales|Fabaceae|Indigofera|arecta|Indigofera arecta A.Rich.	1
Passiflora L.	Plantae|Magnoliophyta|Magnoliopsida|Malpighiales|Passifloraceae|Passiflora||Passiflora L.	1
Parnopes Latreille, 1797	Animalia|Arthropoda|Insecta|Hymenoptera|Chrysididae|Parnopes||Parnopes Latreille, 1797	1
Mucuna poggei Taub.	Plantae|Magnoliophyta|Magnoliopsida|Fabales|Fabaceae|Mucuna|poggei|Mucuna poggei Taub.	1
Gardenia ternifolia var. goetzei (Stapf & Hutch.) Verdc.	Plantae|Tracheophyta|Magnoliopsida|Gentianales|Rubiaceae|Gardenia|ternifolia|Gardenia ternifolia var. goetzei (Stapf & Hutch.) Verdc.	1
Ethulia conyzoides L.f.	Plantae|Tracheophyta|Magnoliopsida|Asterales|Asteraceae|Ethulia|conyzoides|Ethulia conyzoides L.f.	1
Albizzia Benth.	Plantae|Tracheophyta|Magnoliopsida|Fabales|Fabaceae|Albizzia||Albizzia Benth.	1
Euchrysops malathana Boisduval, 1833	Animalia|Arthropoda|Insecta|Lepidoptera|Lycaenidae|Euchrysops|malathana|Euchrysops malathana Boisduval, 1833	1
Panicum L.	Plantae|Tracheophyta|Liliopsida|Poales|Poaceae|Panicum||Panicum L.	1
Melaenornis pallidus (von Müller, 1851)	Animalia|Chordata|Aves|Passeriformes|Muscicapidae|Bradornis|pallidus|Melaenornis pallidus (von Müller, 1851)	1
Pennisetum Rich.	Plantae|Tracheophyta|Liliopsida|Poales|Poaceae|Pennisetum||Pennisetum Rich.	1
Basella L.	Plantae|Tracheophyta|Magnoliopsida|Caryophyllales|Basellaceae|Basella||Basella L.	1
Ekebergia capensis Sparrm.	Plantae|Tracheophyta|Magnoliopsida|Sapindales|Meliaceae|Ekebergia|capensis|Ekebergia capensis Sparrm.	1
Lagonosticta rara rara	Animalia|Chordata|Aves|Passeriformes|Estrildidae|Lagonosticta|rara|Lagonosticta rara rara	1
Aldrovanda vesiculosa L.	Plantae|Tracheophyta|Magnoliopsida|Caryophyllales|Droseraceae|Aldrovanda|vesiculosa|Aldrovanda vesiculosa L.	1
Lamiaceae Martinov	Plantae|Magnoliophyta|Magnoliopsida|Lamiales|Lamiaceae|||Lamiaceae Martinov	1
Homalium N.J. Jacquin, 1760	Plantae|Magnoliophyta|Magnoliopsida|Malpighiales|Salicaceae|Homalium||Homalium N.J. Jacquin, 1760	1
Oxyanthus subpunctatus (Hiern) Keay	Plantae|Tracheophyta|Magnoliopsida|Gentianales|Rubiaceae|Oxyanthus|subpunctatus|Oxyanthus subpunctatus (Hiern) Keay	1
Rhus natalensis Bernh. ex Krauss	Plantae|Tracheophyta|Magnoliopsida|Sapindales|Anacardiaceae|Searsia|natalensis|Rhus natalensis Bernh. ex Krauss	1
Prionops plumatus subsp. vinaceigularis	Animalia|Chordata|Aves|Passeriformes|Malaconotidae|Prionops|plumatus|Prionops plumatus subsp. vinaceigularis	1
Psychotria mahonii var. puberula	Plantae|Magnoliophyta|Magnoliopsida|Gentianales|Rubiaceae|Psychotria|mahonii|Psychotria mahonii var. puberula	1
Spirostreptidae	Animalia|Arthropoda|Diplopoda|Spirostreptida|Spirostreptidae|||Spirostreptidae	1
Heteropogon contortus (L.) P.Beauv. ex Roem. & Schult.	Plantae|Magnoliophyta|Liliopsida|Poales|Poaceae|Heteropogon|contortus|Heteropogon contortus (L.) P.Beauv. ex Roem. & Schult.	1
Oldenlandia corymbosa L.	Plantae|Magnoliophyta|Magnoliopsida|Gentianales|Rubiaceae|Oldenlandia|corymbosa|Oldenlandia corymbosa L.	1
Sida alba L.	Plantae|Tracheophyta|Magnoliopsida|Malvales|Malvaceae|Sida|alba|Sida alba L.	1
Urochloa P. Beauv.	Plantae|Tracheophyta|Liliopsida|Poales|Poaceae|Urochloa||Urochloa P. Beauv.	1
Varanus Merrem, 1820	Animalia|Chordata|Reptilia|Squamata|Varanidae|Varanus||Varanus Merrem, 1820	1
Eclipta prostrata (L.) L.	Plantae|Magnoliophyta|Magnoliopsida|Asterales|Asteraceae|Eclipta|prostrata|Eclipta prostrata (L.) L.	1
Sceliphron Klug, 1801	Animalia|Arthropoda|Insecta|Hymenoptera|Sphecidae|Sceliphron||Sceliphron Klug, 1801	1
Craibia laurentii (De Wild.) De Wild.	Plantae|Tracheophyta|Magnoliopsida|Fabales|Fabaceae|Craibia|laurentii|Craibia laurentii (De Wild.) De Wild.	1
Hippopotamus amphibius Linnaeus, 1758	Animalia|Chordata|Mammalia|Artiodactyla|Hippopotamidae|Hippopotamus|amphibius|Hippopotamus amphibius Linnaeus, 1758	1
Agama finchi	Animalia|Chordata|Reptilia|Squamata|Agamidae|Agama|Agama finchi	1
Adenium obesum (Forssk.) Roem. & Schult.	Plantae|Magnoliophyta|Magnoliopsida|Gentianales|Apocynaceae|Adenium|obesum|Adenium obesum (Forssk.) Roem. & Schult.	1
Lamiaceae	Plantae|Tracheophyta|Magnoliopsida|Lamiales|Lamiaceae|||Lamiaceae	1
Chelifera Macquart, 1823	Animalia|Arthropoda|Insecta|Diptera|Empididae|Chelifera||Chelifera Macquart, 1823	1
Bidens negriana (Sherff) Cufod.	Plantae|Magnoliophyta|Magnoliopsida|Asterales|Asteraceae||negriana|Bidens negriana (Sherff) Cufod.	1
Eriosema pulcherrimum Taub.	Plantae|Magnoliophyta|Magnoliopsida|Fabales|Fabaceae|Eriosema|pulcherrimum|Eriosema pulcherrimum Taub.	1
Praomys Thomas, 1915	Animalia|Chordata|Mammalia|Rodentia|Muridae|Praomys||Praomys Thomas, 1915	1
Platycerium elephantotis Schweinf.	Plantae|Tracheophyta|Polypodiopsida|Polypodiales|Polypodiaceae|Platycerium|elephantotis|Platycerium elephantotis Schweinf.	1
Cyanotis axillaris (L.) D.Don ex Sweet	Plantae|Magnoliophyta|Liliopsida|Commelinales|Commelinaceae|Cyanotis|axillaris|Cyanotis axillaris (L.) D.Don ex Sweet	1
Ziziphus mauritiana Lam.	Plantae|Magnoliophyta|Magnoliopsida|Rosales|Rhamnaceae|Ziziphus|mauritiana|Ziziphus mauritiana Lam.	1
Crotalaria aculeata subsp. claessensii (De Wild.) Polhill	Plantae|Magnoliophyta|Magnoliopsida|Fabales|Fabaceae|Crotalaria|aculeata|Crotalaria aculeata subsp. claessensii (De Wild.) Polhill	1
Neoromicia rendalli (Thomas, 1889)	Animalia|Chordata|Mammalia|Chiroptera|Vespertilionidae|Neoromicia|rendalli|Neoromicia rendalli (Thomas, 1889)	1
Cadaba farinosa Forssk.	Plantae|Tracheophyta|Magnoliopsida|Brassicales|Capparaceae|Cadaba|farinosa|Cadaba farinosa Forssk.	1
Ethulia conyzoides L. f.	Plantae|Magnoliophyta|Magnoliopsida|Asterales|Asteraceae|Ethulia|conyzoides|Ethulia conyzoides L. f.	1
Phalacrocoracidae Reichenbach, 1849	Animalia|Chordata|Aves|Suliformes|Phalacrocoracidae|||Phalacrocoracidae Reichenbach, 1849	1
Elaphoglossum kivuense Schelpe	Plantae|Tracheophyta|Polypodiopsida|Polypodiales|Dryopteridaceae|Elaphoglossum|kivuense|Elaphoglossum kivuense Schelpe	1
Circaetus cinerascens J. W. Von Muller, 1851	Animalia|Chordata|Aves|Accipitriformes|Accipitridae|Circaetus|cinerascens|Circaetus cinerascens J. W. Von Muller, 1851	1
Bridelia scleroneuroides Pax	Plantae|Magnoliophyta|Magnoliopsida|Malpighiales|Phyllanthaceae|Bridelia|scleroneuroides|Bridelia scleroneuroides Pax	1
Striga asiatica (L.) Kuntze	Plantae|Magnoliophyta|Magnoliopsida|Lamiales|Orobanchaceae|Striga|asiatica|Striga asiatica (L.) Kuntze	1
Potamogeton nodosus Poir.	Plantae|Magnoliophyta|Liliopsida|Alismatales|Potamogetonaceae|Potamogeton|nodosus|Potamogeton nodosus Poir.	1
Panicum L.	Plantae|Magnoliophyta|Liliopsida|Poales|Poaceae|Panicum||Panicum L.	1
Crocidura luna Dollman, 1910	Animalia|Chordata|Mammalia|Soricomorpha|Soricidae|Crocidura|luna|Crocidura luna Dollman, 1910	1
Rhynchosia minima (L.) DC.	Plantae|Tracheophyta|Magnoliopsida|Fabales|Fabaceae|Rhynchosia|minima|Rhynchosia minima (L.) DC.	1
Phoeniculus purpureus niloticus (Neumann, 1903)	Animalia|Chordata|Aves|Upupiformes|Phoeniculidae|Phoeniculus|purpureus|Phoeniculus purpureus niloticus (Neumann, 1903)	1
Caridina togoensis Hilgendorf, 1893	Animalia|Arthropoda|Malacostraca|Decapoda|Atyidae|Caridina|togoensis|Caridina togoensis Hilgendorf, 1893	1
Halcyon chelicuti (Stanley, 1814)	Animalia|Chordata|Aves|Coraciiformes|Alcedinidae|Halcyon|chelicuti|Halcyon chelicuti (Stanley, 1814)	1
Halcyon Swainson, 1821	Animalia|Chordata|Aves|Coraciiformes|Alcedinidae|Halcyon||Halcyon Swainson, 1821	1
Aspilia kotschyi var. alba Berhaut	Plantae|Magnoliophyta|Magnoliopsida|Asterales|Asteraceae||kotschyi|Aspilia kotschyi var. alba Berhaut	1
Sorghum Moench	Plantae|Tracheophyta|Liliopsida|Poales|Poaceae|Sorghum||Sorghum Moench	1
Pennisetum glaucum (L.) R.Br.	Plantae|Tracheophyta|Liliopsida|Poales|Poaceae|Pennisetum|glaucum|Pennisetum glaucum (L.) R.Br.	1
Saxicola torquatus subsp. axillaris	Animalia|Chordata|Aves|Passeriformes|Muscicapidae|Saxicola|torquatus|Saxicola torquatus subsp. axillaris	1
Lamprophis fuliginosus Boie, 1827	Animalia|Chordata|Reptilia|Squamata|Lamprophiidae|Lamprophis|fuliginosus|Lamprophis fuliginosus Boie, 1827	1
Ludwigia perennis L.	Plantae|Tracheophyta|Magnoliopsida|Myrtales|Onagraceae|Ludwigia|perennis|Ludwigia perennis L.	1
Pennisetum Rich.	Plantae|Magnoliophyta|Liliopsida|Poales|Poaceae|Pennisetum||Pennisetum Rich.	1
Erythrocebus patas	Animalia|Chordata|Mammalia|Primates|Cercopithecidae|Erythrocebus|Erythrocebus patas	1
Cyperus angolensis Boeckeler	Plantae|Tracheophyta|Liliopsida|Poales|Cyperaceae|Cyperus|angolensis|Cyperus angolensis Boeckeler	1
Graphiurus Smuts, 1832	Animalia|Chordata|Mammalia|Rodentia|Gliridae|Graphiurus||Graphiurus Smuts, 1832	1
Rhinolophus Lacepède, 1799	Animalia|Chordata|Mammalia|Chiroptera|Rhinolophidae|Rhinolophus||Rhinolophus Lacepède, 1799	1
Chaerephon pumilus (Cretzschmar, 1826)	Animalia|Chordata|Mammalia|Chiroptera|Molossidae|Chaerephon|pumilus|Chaerephon pumilus (Cretzschmar, 1826)	1
Bicyclus Kirby, 1871	Animalia|Arthropoda|Insecta|Lepidoptera|Nymphalidae|Bicyclus||Bicyclus Kirby, 1871	1
Terpsiphone viridis (Müller, 1776)	Animalia|Chordata|Aves|Passeriformes|Monarchidae|Terpsiphone|viridis|Terpsiphone viridis (Müller, 1776)	1
Clitoria ternatea L.	Plantae|Magnoliophyta|Magnoliopsida|Fabales|Fabaceae|Clitoria|ternatea|Clitoria ternatea L.	1
Coracina pectoralis (Jardine & Selby, 1828)	Animalia|Chordata|Aves|Passeriformes|Campephagidae|Coracina|pectoralis|Coracina pectoralis (Jardine & Selby, 1828)	1
Eriospermum abyssinicum Baker	Plantae|Tracheophyta|Liliopsida|Asparagales|Asparagaceae|Eriospermum|abyssinicum|Eriospermum abyssinicum Baker	1
Erythrocebus patas (Schreber, 1775)	Animalia|Chordata|Mammalia|Primates|Cercopithecidae|Erythrocebus|patas|Erythrocebus patas (Schreber, 1775)	1
Gymnema sylvestre (Retz.) R. Br. ex Schult.	Plantae|Magnoliophyta|Magnoliopsida|Gentianales|Apocynaceae|Gymnema|sylvestre|Gymnema sylvestre (Retz.) R. Br. ex Schult.	1
Euphorbiaceae	Plantae|Tracheophyta|Magnoliopsida|Malpighiales|Euphorbiaceae|||Euphorbiaceae	1
Ephippiorhynchus senegalensis (Shaw, 1800)	Animalia|Chordata|Aves|Ciconiiformes|Ciconiidae|Ephippiorhynchus|senegalensis|Ephippiorhynchus senegalensis (Shaw, 1800)	1
Cossypha niveicapilla (Lafresnaye, 1838)	Animalia|Chordata|Aves|Passeriformes|Muscicapidae|Cossypha|niveicapilla|Cossypha niveicapilla (Lafresnaye, 1838)	1
Ploceus cucullatus bohndorffi	Animalia|Chordata|Aves|Passeriformes|Ploceidae|Ploceus|cucullatus|Ploceus cucullatus bohndorffi	1
Catunaregam taylorii (S.Moore) Bridson	Plantae|Magnoliophyta|Magnoliopsida|Gentianales|Rubiaceae|Catunaregam|taylorii|Catunaregam taylorii (S.Moore) Bridson	1
Dicrurus adsimilis divaricatus	Animalia|Chordata|Aves|Passeriformes|Dicruridae|Dicrurus|adsimilis|Dicrurus adsimilis divaricatus	1
Encephalartos septentrionalis Schweinf.	Plantae|Tracheophyta|Cycadopsida|Cycadales|Zamiaceae|Encephalartos|septentrionalis|Encephalartos septentrionalis Schweinf.	1
Plumeria L.	Plantae|Magnoliophyta|Magnoliopsida|Gentianales|Apocynaceae|Plumeria||Plumeria L.	1
Orthoptera	Animalia|Arthropoda|Insecta|Orthoptera||||Orthoptera	1
Nectarinia venusta (Shaw, 1799)	Animalia|Chordata|Aves|Passeriformes|Nectariniidae|Cinnyris|venusta|Nectarinia venusta (Shaw, 1799)	1
Adiantum poiretii Wikstr.	Plantae|Tracheophyta|Polypodiopsida|Polypodiales|Pteridaceae|Adiantum|poiretii|Adiantum poiretii Wikstr.	1
Fimbristylis aestivalis (Retz.) Vahl	Plantae|Tracheophyta|Liliopsida|Poales|Cyperaceae|Fimbristylis|aestivalis|Fimbristylis aestivalis (Retz.) Vahl	1
Amaranthus Linnaeus, 1753	Plantae|Magnoliophyta|Magnoliopsida|Caryophyllales|Amaranthaceae|Amaranthus||Amaranthus Linnaeus, 1753	1
Camaroptera brachyura (Vieillot, 1821)	Animalia|Chordata|Aves|Passeriformes|Cisticolidae|Camaroptera|brachyura|Camaroptera brachyura (Vieillot, 1821)	1
Amblyomma variegatum Fabricius, 1794	Animalia|Arthropoda|Arachnida|Ixodida|Ixodidae|Amblyomma|variegatum|Amblyomma variegatum Fabricius, 1794	1