taxonName	taxonPath	recordCount
Arctocephalus gazella (Peters, 1875)	Animalia|Chordata|Mammalia|Carnivora|Otariidae|Arctocephalus|gazella|Arctocephalus gazella (Peters, 1875)	15597
Aptenodytes patagonicus J. F. Miller, 1778	Animalia|Chordata|Aves|Sphenisciformes|Spheniscidae|Aptenodytes|patagonicus|Aptenodytes patagonicus J. F. Miller, 1778	9557
Thalassarche melanophris (Temminck, 1828)	Animalia|Chordata|Aves|Procellariiformes|Diomedeidae|Thalassarche|melanophris|Thalassarche melanophris (Temminck, 1828)	1254
Thalassarche melanophrys (Temminck, 1828)	Animalia|Chordata|Aves|Procellariiformes|Diomedeidae|Thalassarche|melanophrys|Thalassarche melanophrys (Temminck, 1828)	1253
Eudyptes chrysolophus (Brandt, 1837)	Animalia|Chordata|Aves|Sphenisciformes|Spheniscidae|Eudyptes|chrysolophus|Eudyptes chrysolophus (Brandt, 1837)	890
Mirounga leonina (Linnaeus, 1758)	Animalia|Chordata|Mammalia|Carnivora|Phocidae|Mirounga|leonina|Mirounga leonina (Linnaeus, 1758)	832
Phoebetria palpebrata (J. R. Forster, 1785)	Animalia|Chordata|Aves|Procellariiformes|Diomedeidae|Phoebetria|palpebrata|Phoebetria palpebrata (J. R. Forster, 1785)	377
Macronectes giganteus (Gmelin, 1789)	Animalia|Chordata|Aves|Procellariiformes|Procellariidae|Macronectes|giganteus|Macronectes giganteus (Gmelin, 1789)	313
Anatalanta aptera Eaton, 1875	Animalia|Arthropoda|Insecta|Diptera|Sphaeroceridae|Anatalanta|aptera|Anatalanta aptera Eaton, 1875	288
Catharacta skua Brunnich, 1764	Animalia|Chordata|Aves|Charadriiformes|Stercorariidae|Stercorarius|skua|Catharacta skua Brunnich, 1764	182
Hydrurga leptonyx (de Blainville, 1820)	Animalia|Chordata|Mammalia|Carnivora|Phocidae|Hydrurga|leptonyx|Hydrurga leptonyx (de Blainville, 1820)	139
Ectemnorhinus viridis G.R. Waterhouse	Animalia|Arthropoda|Insecta|Coleoptera|Curculionidae|Ectemnorhinus|viridis|Ectemnorhinus viridis G.R. Waterhouse	135
Ectemnorhinus Waterhouse, 1853	Animalia|Arthropoda|Insecta|Coleoptera|Curculionidae|Ectemnorhinus||Ectemnorhinus Waterhouse, 1853	135
Myro kerguelenensis crozetensis Enderlein, 1903	Animalia|Arthropoda|Arachnida|Araneae|Desidae|Myro|kerguelenensis|Myro kerguelenensis crozetensis Enderlein, 1903	126
Myro kerguelenensis O. Pickard-Cambridge, 1876	Animalia|Arthropoda|Arachnida|Araneae|Desidae|Myro|kerguelenensis|Myro kerguelenensis O. Pickard-Cambridge, 1876	126
Phalacrocorax nivalis	Animalia|Chordata|Aves|Suliformes|Phalacrocoracidae|Phalacrocorax|nivalis|Phalacrocorax nivalis	92
Canonopsis sericeus C.O. Waterhouse, 1875	Animalia|Arthropoda|Insecta|Coleoptera|Curculionidae|Canonopsis|sericeus|Canonopsis sericeus C.O. Waterhouse, 1875	87
Canonopsis Waterhouse, 1875	Animalia|Arthropoda|Insecta|Coleoptera|Curculionidae|Canonopsis||Canonopsis Waterhouse, 1875	87
Bothrometopus Jeannel, 1940	Animalia|Arthropoda|Insecta|Coleoptera|Curculionidae|Bothrometopus||Bothrometopus Jeannel, 1940	70
Bothrometopus brevis C.O. Waterhouse, 1875	Animalia|Arthropoda|Insecta|Coleoptera|Curculionidae|Bothrometopus|brevis|Bothrometopus brevis C.O. Waterhouse, 1875	61
Pelecanoides georgicus Murphy & Harper, 1916	Animalia|Chordata|Aves|Procellariiformes|Pelecanoididae|Pelecanoides|georgicus|Pelecanoides georgicus Murphy & Harper, 1916	55
Dicranoweisia Lindb. ex Milde	Plantae|Bryophyta|Bryopsida|Dicranales|Dicranaceae|Dicranoweisia||Dicranoweisia Lindb. ex Milde	55
Ditrichum Hampe	Plantae|Bryophyta|Bryopsida|Dicranales|Ditrichaceae|Ditrichum||Ditrichum Hampe	53
Polytrichastrum alpinum (Hedw.) G. L. Sm.	Plantae|Bryophyta|Bryopsida|Polytrichales|Polytrichaceae|Polytrichastrum|alpinum|Polytrichastrum alpinum (Hedw.) G. L. Sm.	52
Ditrichum immersum Zanten in Zinderen Bakker, Winterbottom & R. A. Dyer, 1971	Plantae|Bryophyta|Bryopsida|Dicranales|Ditrichaceae|Ditrichum|immersum|Ditrichum immersum Zanten in Zinderen Bakker, Winterbottom & R. A. Dyer, 1971	52
Eudyptes schlegeli Finsch, 1876	Animalia|Chordata|Aves|Sphenisciformes|Spheniscidae|Eudyptes|schlegeli|Eudyptes schlegeli Finsch, 1876	48
Calycopteryx mosleyi Eaton, 1875	Animalia|Arthropoda|Insecta|Diptera|Micropezidae|Calycopteryx|mosleyi|Calycopteryx mosleyi Eaton, 1875	48
Pachyptila desolata (Gmelin, 1789)	Animalia|Chordata|Aves|Procellariiformes|Procellariidae|Pachyptila|desolata|Pachyptila desolata (Gmelin, 1789)	47
Catharacta lonnbergi Mathews, 1912	Animalia|Chordata|Aves|Charadriiformes|Stercorariidae|Stercorarius|lonnbergi|Catharacta lonnbergi Mathews, 1912	43
Dicranoweisia breviseta Cardot, 1905	Plantae|Bryophyta|Bryopsida|Dicranales|Dicranaceae|Dicranoweisia|breviseta|Dicranoweisia breviseta Cardot, 1905	42
Poa cookii (Hook.f.) Hook.f.	Plantae|Tracheophyta|Liliopsida|Poales|Poaceae|Poa|cookii|Poa cookii (Hook.f.) Hook.f.	38
Fossombronia australis Mitt.	Plantae|Marchantiophyta|Jungermanniopsida|Fossombroniales|Fossombroniaceae|Austrofossombronia|australis|Fossombronia australis Mitt.	38
Daption capense subsp. capense	Animalia|Chordata|Aves|Procellariiformes|Procellariidae|Daption|capense|Daption capense subsp. capense	36
Pygoscelis papua papua	Animalia|Chordata|Aves|Sphenisciformes|Spheniscidae|Pygoscelis|papua|Pygoscelis papua papua	34
Dicranoweisia brevipes Cardot, 1905	Plantae|Bryophyta|Bryopsida|Dicranales|Dicranaceae|Dicranoweisia|brevipes|Dicranoweisia brevipes Cardot, 1905	33
Pelecanoides urinatrix subsp. exsul Salvin, 1896	Animalia|Chordata|Aves|Procellariiformes|Pelecanoididae|Pelecanoides|urinatrix|Pelecanoides urinatrix subsp. exsul Salvin, 1896	32
Daption capense (Linnaeus, 1758)	Animalia|Chordata|Aves|Procellariiformes|Procellariidae|Daption|capense|Daption capense (Linnaeus, 1758)	31
Azorella selago Hook. fil.	Plantae|Tracheophyta|Magnoliopsida|Apiales|Apiaceae|Azorella|selago|Azorella selago Hook. fil.	30
Larus dominicanus subsp. dominicanus	Animalia|Chordata|Aves|Charadriiformes|Laridae|Larus|dominicanus|Larus dominicanus subsp. dominicanus	30
Ditrichum conicum Mitten, 1879	Plantae|Bryophyta|Bryopsida|Dicranales|Ditrichaceae|Ditrichum|conicum|Ditrichum conicum Mitten, 1879	29
Pygoscelis papua (J. R. Forster, 1781)	Animalia|Chordata|Aves|Sphenisciformes|Spheniscidae|Pygoscelis|papua|Pygoscelis papua (J. R. Forster, 1781)	28
Bartramia patens Bridel, 1803	Plantae|Bryophyta|Bryopsida|Bryales|Bartramiaceae|Bartramia|patens|Bartramia patens Bridel, 1803	28
Eudyptes chrysocome (J. R. Forster, 1781)	Animalia|Chordata|Aves|Sphenisciformes|Spheniscidae|Eudyptes|chrysocome|Eudyptes chrysocome (J. R. Forster, 1781)	27
Poa kerguelensis (Hook.f.) Steud.	Plantae|Tracheophyta|Liliopsida|Poales|Poaceae|Poa|kerguelensis|Poa kerguelensis (Hook.f.) Steud.	25
Pachyptila crassirostris (Mathews, 1912)	Animalia|Chordata|Aves|Procellariiformes|Procellariidae|Pachyptila|crassirostris|Pachyptila crassirostris (Mathews, 1912)	24
Notodiscus hookeri (Reeve, 1854)	Animalia|Mollusca|Gastropoda|Stylommatophora|Charopidae|Notodiscus|hookeri|Notodiscus hookeri (Reeve, 1854)	22
Ceratodon purpureus C. Müller, 1885	Plantae|Bryophyta|Bryopsida|Dicranales|Ditrichaceae|Ceratodon|purpureus|Ceratodon purpureus C. Müller, 1885	22
Embryonopsis halticella Eaton, 1875	Animalia|Arthropoda|Insecta|Lepidoptera|Plutellidae|Embryonopsis|halticella|Embryonopsis halticella Eaton, 1875	20
Eudyptes chrysocome subsp. filholi Hutton, 1879	Animalia|Chordata|Aves|Sphenisciformes|Spheniscidae|Eudyptes|chrysocome|Eudyptes chrysocome subsp. filholi Hutton, 1879	20
Deschampsia antarctica É.Desv.	Plantae|Tracheophyta|Liliopsida|Poales|Poaceae|Deschampsia|antarctica|Deschampsia antarctica É.Desv.	19
Muelleriella crassifolia Dusén, 1905	Plantae|Bryophyta|Bryopsida|Orthotrichales|Orthotrichaceae|Muelleriella|crassifolia|Muelleriella crassifolia Dusén, 1905	19
Oceanites oceanicus subsp. exasperatus Mathews, 1912	Animalia|Chordata|Aves|Procellariiformes|Hydrobatidae|Oceanites|oceanicus|Oceanites oceanicus subsp. exasperatus Mathews, 1912	18
Racomitrium crispulum J. D. Hooker & Wilson, 1854	Plantae|Bryophyta|Bryopsida|Grimmiales|Grimmiaceae|Racomitrium|crispulum|Racomitrium crispulum J. D. Hooker & Wilson, 1854	18
Dicranoweisia antarctica Paris, 1895	Plantae|Bryophyta|Bryopsida|Dicranales|Dicranaceae|Dicranoweisia|antarctica|Dicranoweisia antarctica Paris, 1895	18
Notodiscus hookeri	Animalia|Mollusca|Gastropoda|Stylommatophora|Charopidae|Notodiscus|hookeri|Notodiscus hookeri	17
Pygoscelis papua papua (J. R. Forster, 1781)	Animalia|Chordata|Aves|Sphenisciformes|Spheniscidae|Pygoscelis|papua|Pygoscelis papua papua (J. R. Forster, 1781)	16
Amalopteryx maritima Eaton, 1875	Animalia|Arthropoda|Insecta|Diptera|Ephydridae|Amalopteryx|maritima|Amalopteryx maritima Eaton, 1875	16
Cephaloziella varians (Gottsche) Steph.	Plantae|Marchantiophyta|Jungermanniopsida|Jungermanniales|Cephaloziellaceae|Cephaloziella|varians|Cephaloziella varians (Gottsche) Steph.	16
Callitriche antarctica Engelm. ex Hegelm.	Plantae|Tracheophyta|Magnoliopsida|Lamiales|Plantaginaceae|Callitriche|antarctica|Callitriche antarctica Engelm. ex Hegelm.	15
Plantae	Plantae|||||||Plantae	15
Grimmia immersoleucophaea (Müll. Hal.) Paris	Plantae|Bryophyta|Bryopsida|Grimmiales|Grimmiaceae|Grimmia|immersoleucophaea|Grimmia immersoleucophaea (Müll. Hal.) Paris	14
Colobanthus kerguelensis Hook. fil.	Plantae|Tracheophyta|Magnoliopsida|Caryophyllales|Caryophyllaceae|Colobanthus|kerguelensis|Colobanthus kerguelensis Hook. fil.	14
Sanionia uncinata Loeske, 1907	Plantae|Bryophyta|Bryopsida|Hypnales|Amblystegiaceae|Sanionia|uncinata|Sanionia uncinata Loeske, 1907	14
Drepanocladus uncinatus (Hedw.) Warnst.	Plantae|Bryophyta|Bryopsida|Hypnales|Amblystegiaceae|Harpidium|uncinatus|Drepanocladus uncinatus (Hedw.) Warnst.	13
Ceratodon purpureus Bridel, 1826	Plantae|Bryophyta|Bryopsida|Dicranales|Ditrichaceae|Ceratodon|purpureus|Ceratodon purpureus Bridel, 1826	13
Pelecanoides urinatrix exsul Salvin, 1896	Animalia|Chordata|Aves|Procellariiformes|Pelecanoididae|Pelecanoides|urinatrix|Pelecanoides urinatrix exsul Salvin, 1896	12
Diomedea melanophris Temminck, 1828	Animalia|Chordata|Aves|Procellariiformes|Diomedeidae|Thalassarche|melanophris|Diomedea melanophris Temminck, 1828	12
Drepanocladus (Müll.Hal.) Roth	Plantae|Bryophyta|Bryopsida|Hypnales|Amblystegiaceae|Drepanocladus||Drepanocladus (Müll.Hal.) Roth	11
Jungermannia L.	Plantae|Marchantiophyta|Jungermanniopsida|Jungermanniales|Jungermanniaceae|Jungermannia||Jungermannia L.	11
Pelecanoides urinatrix (Gmelin, 1789)	Animalia|Chordata|Aves|Procellariiformes|Pelecanoididae|Pelecanoides|urinatrix|Pelecanoides urinatrix (Gmelin, 1789)	10
Eudyptes chrysocome filholi Hutton, 1879	Animalia|Chordata|Aves|Sphenisciformes|Spheniscidae|Eudyptes|chrysocome|Eudyptes chrysocome filholi Hutton, 1879	10
Calyptronema mawsoni Mawson, 1958	Animalia|Nematoda|Adenophorea|Enoplida|Symplocostomatidae|Calyptronema|mawsoni|Calyptronema mawsoni Mawson, 1958	10
Enoplus michaelseni Linstow, 1896	Animalia|Nematoda|Adenophorea|Enoplida|Enoplidae|Enoplus|michaelseni|Enoplus michaelseni Linstow, 1896	10
Anticoma kerguelensis Mawson, 1958	Animalia|Nematoda|Adenophorea|Enoplida|Anticomidae|Anticoma|kerguelensis|Anticoma kerguelensis Mawson, 1958	10
Oceanites oceanicus (Kuhl, 1820)	Animalia|Chordata|Aves|Procellariiformes|Hydrobatidae|Oceanites|oceanicus|Oceanites oceanicus (Kuhl, 1820)	10
Eurystomina fenestella Wieser, 1953	Animalia|Nematoda|Adenophorea|Enoplida|Eurystominidae|Eurystomina|fenestella|Eurystomina fenestella Wieser, 1953	10
Fungi	Fungi|||||||Fungi	10
Syntrichia anderssonii Zander, 1993	Plantae|Bryophyta|Bryopsida|Pottiales|Pottiaceae|Syntrichia|anderssonii|Syntrichia anderssonii Zander, 1993	10
Anticoma columba Wieser, 1953	Animalia|Nematoda|Adenophorea|Enoplida|Anticomidae|Anticoma|columba|Anticoma columba Wieser, 1953	10
Bothrometopus gracilipes C.O. Waterhouse	Animalia|Arthropoda|Insecta|Coleoptera|Curculionidae|Bothrometopus|gracilipes|Bothrometopus gracilipes C.O. Waterhouse	9
Oceanites oceanicus exasperatus Mathews, 1912	Animalia|Chordata|Aves|Procellariiformes|Hydrobatidae|Oceanites|oceanicus|Oceanites oceanicus exasperatus Mathews, 1912	9
Herzogobryum vermiculare (Schiffn.) Grolle	Plantae|Marchantiophyta|Jungermanniopsida|Jungermanniales|Gymnomitriaceae|Herzogobryum|vermiculare|Herzogobryum vermiculare (Schiffn.) Grolle	9
Grimmia Hedw.	Plantae|Bryophyta|Bryopsida|Grimmiales|Grimmiaceae|Grimmia||Grimmia Hedw.	8
Cryptochila grandiflora (Lindenb. & Gottsche) Grolle	Plantae|Marchantiophyta|Jungermanniopsida|Jungermanniales|Jamesoniellaceae|Cryptochila|grandiflora|Cryptochila grandiflora (Lindenb. & Gottsche) Grolle	8
Acaena magellanica (Lam.) Vahl	Plantae|Tracheophyta|Magnoliopsida|Rosales|Rosaceae|Acaena|magellanica|Acaena magellanica (Lam.) Vahl	8
Leucocarbo atriceps (King, 1828)	Animalia|Chordata|Aves|Suliformes|Phalacrocoracidae|Leucocarbo|atriceps|Leucocarbo atriceps (King, 1828)	8
Tortula geheebiaeopsis (Müll. Hal.) Broth.	Plantae|Bryophyta|Bryopsida|Pottiales|Pottiaceae|Syntrichia|geheebiaeopsis|Tortula geheebiaeopsis (Müll. Hal.) Broth.	7
Andreaea mutabilis J. D. Hooker & Wilson, 1844	Plantae|Bryophyta|Andreaeopsida|Andreaeales|Andreaeaceae|Andreaea|mutabilis|Andreaea mutabilis J. D. Hooker & Wilson, 1844	7
Ceratodon Brid.	Plantae|Bryophyta|Bryopsida|Dicranales|Ditrichaceae|Ceratodon||Ceratodon Brid.	7
Pedinophyllopsis abdita (Sull.) R.M.Schust. & Inoue	Plantae|Marchantiophyta|Jungermanniopsida|Jungermanniales|Plagiochilaceae|Pedinophyllopsis|abdita|Pedinophyllopsis abdita (Sull.) R.M.Schust. & Inoue	7
Ptychostomum Hornschuch, 1822	Plantae|Bryophyta|Bryopsida|Bryales|Bryaceae|Ptychostomum||Ptychostomum Hornschuch, 1822	7
Chionis minor subsp. nasicornis Reichenow, 1904	Animalia|Chordata|Aves|Charadriiformes|Chionidae|Chionis|minor|Chionis minor subsp. nasicornis Reichenow, 1904	7
Ptychostomum pseudotriquetrum (Hedw.) J.R. Spence & H.P. Ramsay	Plantae|Bryophyta|Bryopsida|Bryales|Bryaceae|Plagiobryum|pseudotriquetrum|Ptychostomum pseudotriquetrum (Hedw.) J.R. Spence & H.P. Ramsay	7
Caloplaca cribrosa (Hue) Zahlbr., 1931	Fungi|Ascomycota|Lecanoromycetes|Teloschistales|Teloschistaceae|Caloplaca|cribrosa|Caloplaca cribrosa (Hue) Zahlbr., 1931	7
Lophocolea (Dumort.) Dumort.	Plantae|Marchantiophyta|Jungermanniopsida|Jungermanniales|Geocalycaceae|Lophocolea||Lophocolea (Dumort.) Dumort.	7
Polytrichum juniperinum Hedwig, 1801	Plantae|Bryophyta|Bryopsida|Polytrichales|Polytrichaceae|Polytrichum|juniperinum|Polytrichum juniperinum Hedwig, 1801	7
Pohlia wahlenbergii Andrews in Grout, 1935	Plantae|Bryophyta|Bryopsida|Bryales|Bryaceae|Pohlia|wahlenbergii|Pohlia wahlenbergii Andrews in Grout, 1935	6
Pachyglossa grolleana Vána	Plantae|Marchantiophyta|Jungermanniopsida|Jungermanniales|Lophocoleaceae|Chiloscyphus|grolleana|Pachyglossa grolleana Vána	6
Anasterias mawsoni (Koehler, 1920)	Animalia|Echinodermata|Asteroidea|Forcipulatida|Asteriidae|Anasterias|mawsoni|Anasterias mawsoni (Koehler, 1920)	6
Sterna vittata Gmelin, 1789	Animalia|Chordata|Aves|Charadriiformes|Laridae|Sterna|vittata|Sterna vittata Gmelin, 1789	6
Chionis minor Hartlaub, 1841	Animalia|Chordata|Aves|Charadriiformes|Chionidae|Chionis|minor|Chionis minor Hartlaub, 1841	6
	|||||||	6
Eudyptes sclateri Buller, 1888	Animalia|Chordata|Aves|Sphenisciformes|Spheniscidae|Eudyptes|sclateri|Eudyptes sclateri Buller, 1888	6
Leuconia joubini (Topsent, 1907)	Animalia|Porifera|Calcarea|Baerida|Baeriidae|Leuconia|joubini|Leuconia joubini (Topsent, 1907)	6
Schistidium apocarpum Bruch & W. P. Schimper in B.S.G., 1845	Plantae|Bryophyta|Bryopsida|Grimmiales|Grimmiaceae|Schistidium|apocarpum|Schistidium apocarpum Bruch & W. P. Schimper in B.S.G., 1845	6
Brachythecium paradoxum Jaeger, 1878	Plantae|Bryophyta|Bryopsida|Hypnales|Brachytheciaceae|Brachythecium|paradoxum|Brachythecium paradoxum Jaeger, 1878	6
Pringlea antiscorbutica R. Br. ex Hook. f.	Plantae|Tracheophyta|Magnoliopsida|Brassicales|Brassicaceae|Pringlea|antiscorbutica|Pringlea antiscorbutica R. Br. ex Hook. f.	6
Adoncholaimus crassicaudatus	Animalia|Nematoda|Adenophorea|Enoplida|Oncholaimidae|Adoncholaimus|crassicaudatus|Adoncholaimus crassicaudatus	6
Laevilitorina heardensis Dell, 1964	Animalia|Mollusca|Gastropoda|Littorinimorpha|Littorinidae|Laevilitorina|heardensis|Laevilitorina heardensis Dell, 1964	5
Herzogobryum atrocapillum (Hook.f. & Taylor) Grolle	Plantae|Marchantiophyta|Jungermanniopsida|Jungermanniales|Gymnomitriaceae|Herzogobryum|atrocapillum|Herzogobryum atrocapillum (Hook.f. & Taylor) Grolle	5
Usnea antarctica Du Rietz, 1926	Fungi|Ascomycota|Lecanoromycetes|Lecanorales|Parmeliaceae|Usnea|antarctica|Usnea antarctica Du Rietz, 1926	5
Polytrichastrum alpinum G. L. Smith, 1971	Plantae|Bryophyta|Bryopsida|Polytrichales|Polytrichaceae|Polytrichastrum|alpinum|Polytrichastrum alpinum G. L. Smith, 1971	5
Chiloscyphus gremmenii Váňa	Plantae|Marchantiophyta|Jungermanniopsida|Jungermanniales|Lophocoleaceae|Chiloscyphus|gremmenii|Chiloscyphus gremmenii Váňa	5
Jamesoniella (Spruce) Carring.	Plantae|Marchantiophyta|Jungermanniopsida|Jungermanniales|Jungermanniaceae|Jamesoniella||Jamesoniella (Spruce) Carring.	5
Poa annua L.	Plantae|Tracheophyta|Liliopsida|Poales|Poaceae|Poa|annua|Poa annua L.	5
Marchantia berteroana Lehm. & Lindenb.	Plantae|Marchantiophyta|Marchantiopsida|Marchantiales|Marchantiaceae|Marchantia|berteroana|Marchantia berteroana Lehm. & Lindenb.	5
Placopsis bicolor (Tuck.) B. de Lesd.	Fungi|Ascomycota|Lecanoromycetes|Baeomycetales|Trapeliaceae|Placopsis|bicolor|Placopsis bicolor (Tuck.) B. de Lesd.	5
Jungermanniaceae	Plantae|Marchantiophyta|Jungermanniopsida|Jungermanniales|Jungermanniaceae|||Jungermanniaceae	5
Stercorarius antarcticus (Lesson, 1831)	Animalia|Chordata|Aves|Charadriiformes|Stercorariidae|Stercorarius|antarcticus|Stercorarius antarcticus (Lesson, 1831)	5
Larus dominicanus Lichtenstein, 1823	Animalia|Chordata|Aves|Charadriiformes|Laridae|Larus|dominicanus|Larus dominicanus Lichtenstein, 1823	5
Fossombronia Raddi	Plantae|Marchantiophyta|Jungermanniopsida|Fossombroniales|Fossombroniaceae|Fossombronia||Fossombronia Raddi	5
Philobrya laevis Thiele, 1912	Animalia|Mollusca|Bivalvia|Arcoida|Philobryidae|Philobrya|laevis|Philobrya laevis Thiele, 1912	4
Psilopilum australe (Hook. f. & Wilson) Mitt.	Plantae|Bryophyta|Bryopsida|Polytrichales|Polytrichaceae|Notoligotrichum|australe|Psilopilum australe (Hook. f. & Wilson) Mitt.	4
Brachythecium Schimp.	Plantae|Bryophyta|Bryopsida|Hypnales|Brachytheciaceae|Brachythecium||Brachythecium Schimp.	4
Pygoscelis antarcticus (J. R. Forster, 1781)	Animalia|Chordata|Aves|Sphenisciformes|Spheniscidae|Pygoscelis|antarcticus|Pygoscelis antarcticus (J. R. Forster, 1781)	4
Verrucidens Cardot in Nordenskjöld, 1908	Plantae|Bryophyta|Bryopsida|Dicranales|Dicranaceae|Verrucidens||Verrucidens Cardot in Nordenskjöld, 1908	4
Hyperoodon planifrons Flower, 1882	Animalia|Chordata|Mammalia|Cetacea|Hyperoodontidae|Hyperoodon|planifrons|Hyperoodon planifrons Flower, 1882	4
Andreaea acuminata Mitten in J. D. Hooker & Wilson, 1859	Plantae|Bryophyta|Andreaeopsida|Andreaeales|Andreaeaceae|Andreaea|acuminata|Andreaea acuminata Mitten in J. D. Hooker & Wilson, 1859	4
Sterna vittata vittata	Animalia|Chordata|Aves|Charadriiformes|Laridae|Sterna|vittata|Sterna vittata vittata	4
Blindia robusta Hampe, 1860	Plantae|Bryophyta|Bryopsida|Seligerales|Seligeriaceae|Blindia|robusta|Blindia robusta Hampe, 1860	4
Ditrichum subaustrale Brotherus, 1908	Plantae|Bryophyta|Bryopsida|Dicranales|Ditrichaceae|Ditrichum|subaustrale|Ditrichum subaustrale Brotherus, 1908	4
Pachyptila desolata banksi	Animalia|Chordata|Aves|Procellariiformes|Procellariidae|Pachyptila|desolata|Pachyptila desolata banksi	4
Adoncholaimus crassicaudatus Wieser, 1953	Animalia|Nematoda|Adenophorea|Enoplida|Oncholaimidae|Adoncholaimus|crassicaudatus|Adoncholaimus crassicaudatus Wieser, 1953	4
Rhizocarpon kerguelense Dodge	Fungi|Ascomycota|Lecanoromycetes|Lecanorales|Rhizocarpaceae|Rhizocarpon|kerguelense|Rhizocarpon kerguelense Dodge	4
Dicranoloma billardieri Paris, 1904	Plantae|Bryophyta|Bryopsida|Dicranales|Dicranaceae|Dicranoloma|billardieri|Dicranoloma billardieri Paris, 1904	4
Mesoplodon layardii (Gray, 1865)	Animalia|Chordata|Mammalia|Cetacea|Hyperoodontidae|Mesoplodon|layardii|Mesoplodon layardii (Gray, 1865)	4
Grimmia kidderi T. P. James, 1875	Plantae|Bryophyta|Bryopsida|Grimmiales|Grimmiaceae|Grimmia|kidderi|Grimmia kidderi T. P. James, 1875	4
Balaenoptera bonaerensis Burmeister, 1867	Animalia|Chordata|Mammalia|Cetacea|Balaenopteridae|Balaenoptera|bonaerensis|Balaenoptera bonaerensis Burmeister, 1867	4
Bryum Hedw.	Plantae|Bryophyta|Bryopsida|Bryales|Bryaceae|Bryum||Bryum Hedw.	4
Pannaria xanthorioides P. M. Jørg.	Fungi|Ascomycota|Lecanoromycetes|Peltigerales|Pannariaceae|Psoroma|xanthorioides|Pannaria xanthorioides P. M. Jørg.	4
Syntrichia filaris Zander, 1993	Plantae|Bryophyta|Bryopsida|Pottiales|Pottiaceae|Syntrichia|filaris|Syntrichia filaris Zander, 1993	4
Andreaea flabellata C. Müller, 1883	Plantae|Bryophyta|Andreaeopsida|Andreaeales|Andreaeaceae|Andreaea|flabellata|Andreaea flabellata C. Müller, 1883	3
Amphilectus fucorum (Esper, 1794)	Animalia|Porifera|Demospongiae|Poecilosclerida|Esperiopsidae|Amphilectus|fucorum|Amphilectus fucorum (Esper, 1794)	3
Myxilla chilensis Thiele, 1905	Animalia|Porifera|Demospongiae|Poecilosclerida|Myxillidae|Myxilla|chilensis|Myxilla chilensis Thiele, 1905	3
Nacella macquariensis (Finlay, 1926)	Animalia|Mollusca|Gastropoda||Nacellidae|Nacella|macquariensis|Nacella macquariensis (Finlay, 1926)	3
Aspiciliopsis macrophthalma (Hook. f. & Taylor) B. de Lesd.	Fungi|Ascomycota|Lecanoromycetes|Agyriales|Agyriaceae|Placopsis|macrophthalma|Aspiciliopsis macrophthalma (Hook. f. & Taylor) B. de Lesd.	3
Racomitrium Brid.	Plantae|Bryophyta|Bryopsida|Grimmiales|Grimmiaceae|Racomitrium||Racomitrium Brid.	3
Notoligotrichum australe (Hook. f. & Wilson) G.L. Sm.	Plantae|Bryophyta|Bryopsida|Polytrichales|Polytrichaceae|Notoligotrichum|australe|Notoligotrichum australe (Hook. f. & Wilson) G.L. Sm.	3
Willia calobolax Lightowlers, 1985	Plantae|Bryophyta|Bryopsida|Pottiales|Pottiaceae|Willia|calobolax|Willia calobolax Lightowlers, 1985	3
Chionis minor nasicornis Reichenow, 1904	Animalia|Chordata|Aves|Charadriiformes|Chionidae|Chionis|minor|Chionis minor nasicornis Reichenow, 1904	3
Tylopleuroxus Frey, 1993	Animalia|Arthropoda|Branchiopoda|Diplostraca|Chydoridae|Pleuroxus||Tylopleuroxus Frey, 1993	3
Odontaster meridionalis (E. A. Smith, 1876)	Animalia|Echinodermata|Asteroidea|Valvatida|Odontasteridae|Odontaster|meridionalis|Odontaster meridionalis (E. A. Smith, 1876)	3
Arctocephalus tropicalis (J. E. Gray, 1872)	Animalia|Chordata|Mammalia|Carnivora|Otariidae|Arctocephalus|tropicalis|Arctocephalus tropicalis (J. E. Gray, 1872)	3
Haliclona topsenti (Thiele, 1905)	Animalia|Porifera|Demospongiae|Haplosclerida|Chalinidae|Haliclona|topsenti|Haliclona topsenti (Thiele, 1905)	3
Gemmabryum dichotomum (Hedw.) J.R. Spence & H.P. Ramsay	Plantae|Bryophyta|Bryopsida|Bryales|Bryaceae|Bryum|dichotomum|Gemmabryum dichotomum (Hedw.) J.R. Spence & H.P. Ramsay	3
Pottia heimii (Hedw.) Hampe	Plantae|Bryophyta|Bryopsida|Pottiales|Pottiaceae|Pottia|heimii|Pottia heimii (Hedw.) Hampe	3
Haliclona similis (Topsent, 1897)	Animalia|Porifera|Demospongiae|Haplosclerida|Chalinidae|Haliclona|similis|Haliclona similis (Topsent, 1897)	3
Isodictya kerguelenensis (Ridley & Dendy, 1886)	Animalia|Porifera|Demospongiae|Poecilosclerida|Isodictyidae|Isodictya|kerguelenensis|Isodictya kerguelenensis (Ridley & Dendy, 1886)	3
Notoligotrichum australe G. L. Smith, 1971	Plantae|Bryophyta|Bryopsida|Polytrichales|Polytrichaceae|Notoligotrichum|australe|Notoligotrichum australe G. L. Smith, 1971	3
Gemmabryum J.R. Spence & H.P. Ramsay, 2005	Plantae|Bryophyta|Bryopsida|Bryales|Bryaceae|Gemmabryum||Gemmabryum J.R. Spence & H.P. Ramsay, 2005	3
Buellia tristiuscula (Nyl.) Zahlbr.	Fungi|Ascomycota|Lecanoromycetes|Teloschistales|Physciaceae|Buellia|tristiuscula|Buellia tristiuscula (Nyl.) Zahlbr.	3
Pertusaria DC.	Fungi|Ascomycota|Lecanoromycetes|Pertusariales|Pertusariaceae|Pertusaria||Pertusaria DC.	3
Carbonea assentiens (Nyl.) Hertel	Fungi|Ascomycota|Lecanoromycetes|Lecanorales|Lecanoraceae|Carbonea|assentiens|Carbonea assentiens (Nyl.) Hertel	3
Drepanocladus aduncus Warnstorf, 1903	Plantae|Bryophyta|Bryopsida|Hypnales|Amblystegiaceae|Drepanocladus|aduncus|Drepanocladus aduncus Warnstorf, 1903	3
Philonotis angustifolia Kaalaas, 1912	Plantae|Bryophyta|Bryopsida|Bryales|Bartramiaceae|Philonotis|angustifolia|Philonotis angustifolia Kaalaas, 1912	3
Haematomma erythromma (Nyl.) Zahlbr.	Fungi|Ascomycota|Lecanoromycetes|Lecanorales|Haematommataceae|Haematomma|erythromma|Haematomma erythromma (Nyl.) Zahlbr.	3
Dendrilla membranosa (Pallas, 1766)	Animalia|Porifera|Demospongiae|Dendroceratida|Darwinellidae|Dendrilla|membranosa|Dendrilla membranosa (Pallas, 1766)	3
Cassidinopsis emarginata (Guerin-Meneville, 1843)	Animalia|Arthropoda|Malacostraca|Isopoda|Sphaeromatidae|Cassidinopsis|emarginata|Cassidinopsis emarginata (Guerin-Meneville, 1843)	3
Diastylopsis annulata (Zimmer, 1902)	Animalia|Arthropoda|Malacostraca|Cumacea|Diastylidae|Diastylopsis|annulata|Diastylopsis annulata (Zimmer, 1902)	3
Dicranoweisia grimmiacea Brotherus, 1901	Plantae|Bryophyta|Bryopsida|Dicranales|Dicranaceae|Dicranoweisia|grimmiacea|Dicranoweisia grimmiacea Brotherus, 1901	2
Canthocamptus Westwood, 1836	Animalia|Arthropoda|Maxillopoda|Harpacticoida|Canthocamptidae|Canthocamptus||Canthocamptus Westwood, 1836	2
Azorella selago Hook.f.	Plantae|Magnoliophyta|Magnoliopsida|Apiales|Apiaceae|Azorella|selago|Azorella selago Hook.f.	2
Pachyglossa fissa (Mitt.) Herzog & Grolle	Plantae|Marchantiophyta|Jungermanniopsida|Jungermanniales|Lophocoleaceae|Chiloscyphus|fissa|Pachyglossa fissa (Mitt.) Herzog & Grolle	2
Halichondria panicea (Pallas, 1766)	Animalia|Porifera|Demospongiae|Suberitida|Halichondriidae|Halichondria|panicea|Halichondria panicea (Pallas, 1766)	2
Aplysina minima Hentschel, 1914	Animalia|Porifera|Demospongiae|Verongiida|Aplysinidae|Aplysina|minima|Aplysina minima Hentschel, 1914	2
Phalacrocorax atriceps subsp. nivalis Falla, 1937	Animalia|Chordata|Aves|Suliformes|Phalacrocoracidae|Leucocarbo|atriceps|Phalacrocorax atriceps subsp. nivalis Falla, 1937	2
Phyllopyrenia tessellata C.W. Dodge	Fungi|Ascomycota|Eurotiomycetes|Verrucariales|Verrucariaceae|Verrucaria|tessellata|Phyllopyrenia tessellata C.W. Dodge	2
Hymeniacidon fernandezi Thiele, 1905	Animalia|Porifera|Demospongiae|Suberitida|Halichondriidae|Hymeniacidon|fernandezi|Hymeniacidon fernandezi Thiele, 1905	2
Verrucidens tortifolius (Hook. f. & Wilson) Reimers	Plantae|Bryophyta|Bryopsida|Seligerales|Seligeriaceae|Verrucidens|tortifolius|Verrucidens tortifolius (Hook. f. & Wilson) Reimers	2
Tephromela atra (Huds.) Hafellner, 1983	Fungi|Ascomycota|Lecanoromycetes|Lecanorales|Mycoblastaceae|Tephromela|atra|Tephromela atra (Huds.) Hafellner, 1983	2
Pteraster affinis Smith, 1876	Animalia|Echinodermata|Asteroidea|Velatida|Pterasteridae|Pteraster|affinis|Pteraster affinis Smith, 1876	2
Plocamium hookeri Harvey	Plantae|Rhodophyta|Florideophyceae|Plocamiales|Plocamiaceae|Plocamium|hookeri|Plocamium hookeri Harvey	2
Montia fontana L.	Plantae|Tracheophyta|Magnoliopsida|Caryophyllales|Montiaceae|Montia|fontana|Montia fontana L.	2
Notocarbo Siegel-Causey, 1988	Animalia|Chordata|Aves|Suliformes|Phalacrocoracidae|Notocarbo||Notocarbo Siegel-Causey, 1988	2
Porania antarctica (E. A. Smith, 1876)	Animalia|Echinodermata|Asteroidea|Valvatida|Poraniidae|Glabraster|antarctica|Porania antarctica (E. A. Smith, 1876)	2
Scytothalia obscura Dickie	Chromista|Ochrophyta|Phaeophyceae|Fucales|Seirococcaceae|Scytothalia|obscura|Scytothalia obscura Dickie	2
Plocamium hookeri Harvey, 1845	Plantae|Rhodophyta|Florideophyceae|Plocamiales|Plocamiaceae|Plocamium|hookeri|Plocamium hookeri Harvey, 1845	2
Montia fontana subsp. fontana	Plantae|Tracheophyta|Magnoliopsida|Caryophyllales|Montiaceae|Montia|fontana|Montia fontana subsp. fontana	2
Globicephala melas (Traill, 1809)	Animalia|Chordata|Mammalia|Cetacea|Delphinidae|Globicephala|melas|Globicephala melas (Traill, 1809)	2
Notoplites Harmer, 1923	Animalia|Bryozoa|Gymnolaemata|Cheilostomatida|Candidae|Notoplites||Notoplites Harmer, 1923	2
Schistidium falcatum B. Bremer, 1980	Plantae|Bryophyta|Bryopsida|Grimmiales|Grimmiaceae|Schistidium|falcatum|Schistidium falcatum B. Bremer, 1980	2
Epactophanes richardi Mrazek, 1893	Animalia|Arthropoda|Maxillopoda|Harpacticoida|Canthocamptidae|Epactophanes|richardi|Epactophanes richardi Mrazek, 1893	2
Apohyale hirtipalma (Dana, 1852)	Animalia|Arthropoda|Malacostraca|Amphipoda|Hyalidae|Apohyale|hirtipalma|Apohyale hirtipalma (Dana, 1852)	2
Hyperia spinigera Bovallius, 1889	Animalia|Arthropoda|Malacostraca|Amphipoda|Hyperiidae|Hyperia|spinigera|Hyperia spinigera Bovallius, 1889	2
Riccardia georgiensis (Stephani) Hässel de Menéndez	Plantae|Marchantiophyta|Jungermanniopsida|Metzgeriales|Aneuraceae|Riccardia|georgiensis|Riccardia georgiensis (Stephani) Hässel de Menéndez	2
Poa cookii (Hook.f.) Hook.f.	Plantae|Magnoliophyta|Liliopsida|Poales|Poaceae|Poa|cookii|Poa cookii (Hook.f.) Hook.f.	2
Orceolina kerguelensis (Tuck.) Hertel	Fungi|Ascomycota|Lecanoromycetes|Baeomycetales|Trapeliaceae|Orceolina|kerguelensis|Orceolina kerguelensis (Tuck.) Hertel	2
Laevilitorina heardensis Dell, 1964	Animalia|Mollusca|Gastropoda|Neotaenioglossa|Littorinidae|Laevilitorina|heardensis|Laevilitorina heardensis Dell, 1964	2
Clasmatocolea rigens (Hook. f. & Taylor) J.J. Engel	Plantae|Marchantiophyta|Jungermanniopsida|Jungermanniales|Lophocoleaceae|Clasmatocolea|rigens|Clasmatocolea rigens (Hook. f. & Taylor) J.J. Engel	2
Polytrichum piliferum Hedwig, 1801	Plantae|Bryophyta|Bryopsida|Polytrichales|Polytrichaceae|Polytrichum|piliferum|Polytrichum piliferum Hedwig, 1801	2
Gallirallus australis subsp. scotti (Ogilvie-Grant, 1905)	Animalia|Chordata|Aves|Gruiformes|Rallidae|Gallirallus|australis|Gallirallus australis subsp. scotti (Ogilvie-Grant, 1905)	2
Polytrichum alpinum Hedw.	Plantae|Bryophyta|Bryopsida|Polytrichales|Polytrichaceae|Polytrichastrum|alpinum|Polytrichum alpinum Hedw.	2
Hennediella heimii Zander, 1993	Plantae|Bryophyta|Bryopsida|Pottiales|Pottiaceae|Hennediella|heimii|Hennediella heimii Zander, 1993	2
Gondogeneia chosroides (Nicholls, 1938)	Animalia|Arthropoda|Malacostraca|Amphipoda|Eusiridae|Gondogeneia|chosroides|Gondogeneia chosroides (Nicholls, 1938)	2
Dicranella (Müll.Hal.) Schimp.	Plantae|Bryophyta|Bryopsida|Dicranales|Dicranaceae|Dicranella||Dicranella (Müll.Hal.) Schimp.	2
Placopsis (Nyl.) Linds.	Fungi|Ascomycota|Lecanoromycetes|Agyriales|Agyriaceae|Placopsis||Placopsis (Nyl.) Linds.	2
Chlanidota vestita (Martens, 1878)	Animalia|Mollusca|Gastropoda|Neogastropoda|Buccinidae|Chlanidota|vestita|Chlanidota vestita (Martens, 1878)	2
Dicranella (Müller Hal.) W.P. Schimper, 1856	Plantae|Bryophyta|Bryopsida|Dicranales|Dicranaceae|Dicranella||Dicranella (Müller Hal.) W.P. Schimper, 1856	2
Oceanites oceanicus oceanicus	Animalia|Chordata|Aves|Procellariiformes|Hydrobatidae|Oceanites|oceanicus|Oceanites oceanicus oceanicus	2
Leuconia primigenia (Haeckel, 1872)	Animalia|Porifera|Calcarea|Clathrinida|Leucettidae|Leucetta|primigenia|Leuconia primigenia (Haeckel, 1872)	2
Anas eatoni eatoni	Animalia|Chordata|Aves|Anseriformes|Anatidae|Anas|eatoni|Anas eatoni eatoni	2
Scytothalia obscura Dickie, 1876	Chromista|Ochrophyta|Phaeophyceae|Fucales|Seirococcaceae|Scytothalia|obscura|Scytothalia obscura Dickie, 1876	2
Orthotrichum Hedw.	Plantae|Bryophyta|Bryopsida|Orthotrichales|Orthotrichaceae|Orthotrichum||Orthotrichum Hedw.	2
Racomitrium pruinosum C. Müller, 1869	Plantae|Bryophyta|Bryopsida|Grimmiales|Grimmiaceae|Racomitrium|pruinosum|Racomitrium pruinosum C. Müller, 1869	2
Drepanocladus (Müller Hal.) G. Roth, 1899	Plantae|Bryophyta|Bryopsida|Hypnales|Amblystegiaceae|Drepanocladus||Drepanocladus (Müller Hal.) G. Roth, 1899	2
Sterna vittata vittata Gmelin, 1789	Animalia|Chordata|Aves|Charadriiformes|Laridae|Sterna|vittata|Sterna vittata vittata Gmelin, 1789	2
Iotrochota Ridley, 1884	Animalia|Porifera|Demospongiae|Poecilosclerida|Iotrochotidae|Iotrochota||Iotrochota Ridley, 1884	2
Ca Dyar, 1914	Animalia|Arthropoda|Insecta|Lepidoptera|Dalceridae|Ca||Ca Dyar, 1914	2
Chorisodontium (Mitten) V.F. Brotherus in Engler & Prantl, 1924	Plantae|Bryophyta|Bryopsida|Dicranales|Dicranaceae|Chorisodontium||Chorisodontium (Mitten) V.F. Brotherus in Engler & Prantl, 1924	2
Nacella kerguelenensis (E. A. Smith, 1877)	Animalia|Mollusca|Gastropoda||Nacellidae|Nacella|kerguelenensis|Nacella kerguelenensis (E. A. Smith, 1877)	2
Ranunculus crassipes Hook. fil.	Plantae|Tracheophyta|Magnoliopsida|Ranunculales|Ranunculaceae|Ranunculus|crassipes|Ranunculus crassipes Hook. fil.	2
Lagenorhynchus cruciger (Quoy & Gaimard, 1824)	Animalia|Chordata|Mammalia|Cetacea|Delphinidae|Lagenorhynchus|cruciger|Lagenorhynchus cruciger (Quoy & Gaimard, 1824)	2
Lecidea interstita Nyl.	Fungi|Ascomycota|Lecanoromycetes|Lecanorales|Lecideaceae|Lecidea|interstita|Lecidea interstita Nyl.	2
Kidderia bicolor (Martens, 1885)	Animalia|Arthropoda|Malacostraca|Amphipoda|Cyamidae|Kidderia|bicolor|Kidderia bicolor (Martens, 1885)	2
Laetmonice producta Grube, 1876	Animalia|Annelida|Polychaeta|Phyllodocida|Aphroditidae|Laetmonice|producta|Laetmonice producta Grube, 1876	1
Xanthosiphonia austrogeorgica Skottsberg, 1907	Chromista|Ochrophyta|Phaeophyceae|Ectocarpales|Pylaiellaceae|Phaearthron|austrogeorgica|Xanthosiphonia austrogeorgica Skottsberg, 1907	1
Lolium L.	Plantae|Tracheophyta|Liliopsida|Poales|Poaceae|Lolium||Lolium L.	1
Gammaropsis Lilljeborg, 1855	Animalia|Arthropoda|Malacostraca|Amphipoda|Isaeidae|Gammaropsis||Gammaropsis Lilljeborg, 1855	1
Proclea Saint-Joseph, 1894	Animalia|Annelida|Polychaeta|Terebellida|Terebellidae|Proclea||Proclea Saint-Joseph, 1894	1
Iridaea cordata (Turner) Bory de Saint-Vincent, 1826	Plantae|Rhodophyta|Florideophyceae|Gigartinales|Gigartinaceae|Iridaea|cordata|Iridaea cordata (Turner) Bory de Saint-Vincent, 1826	1
Omalogyra atomus (Philippi, 1841)	Animalia|Mollusca|Gastropoda||Omalogyridae|Omalogyra|atomus|Omalogyra atomus (Philippi, 1841)	1
Nothogenia fastigiata (Bory de Saint-Vincent) P.G.Parkinson, 1983	Plantae|Rhodophyta|Florideophyceae|Nemaliales|Scinaiaceae|Nothogenia|fastigiata|Nothogenia fastigiata (Bory de Saint-Vincent) P.G.Parkinson, 1983	1
Onoba H. Adams & A. Adams, 1852	Animalia|Mollusca|Gastropoda|Littorinimorpha|Rissoidae|Onoba||Onoba H. Adams & A. Adams, 1852	1
Caecianiropsis ectiformis (Vanhöffen, 1914)	Animalia|Arthropoda|Malacostraca|Isopoda|Janiridae|Caecianiropsis|ectiformis|Caecianiropsis ectiformis (Vanhöffen, 1914)	1
Lecanora disjungenda (Cromb.) Hertel & Rambold	Fungi|Ascomycota|Lecanoromycetes|Lecanorales|Lecanoraceae|Lecanora|disjungenda|Lecanora disjungenda (Cromb.) Hertel & Rambold	1
Acaena adscendens (Lam.) Vahl	Plantae|Tracheophyta|Magnoliopsida|Rosales|Rosaceae|Acaena|adscendens|Acaena adscendens (Lam.) Vahl	1
Califanthura pingouin (Kensley, 1980)	Animalia|Arthropoda|Malacostraca|Isopoda|Paranthuridae|Califanthura|pingouin|Califanthura pingouin (Kensley, 1980)	1
Steinera glaucella (Tuck.) Dodge	Fungi|Ascomycota|Lecanoromycetes|Peltigerales|Coccocarpiaceae|Steinera|glaucella|Steinera glaucella (Tuck.) Dodge	1
Bryoerythrophyllum recurvirostrum Chen Pan-chieh, 1941	Plantae|Bryophyta|Bryopsida|Pottiales|Pottiaceae|Bryoerythrophyllum|recurvirostrum|Bryoerythrophyllum recurvirostrum Chen Pan-chieh, 1941	1
Neobuccinum eatoni (E. A. Smith, 1875)	Animalia|Mollusca|Gastropoda|Neogastropoda|Buccinidae|Neobuccinum|eatoni|Neobuccinum eatoni (E. A. Smith, 1875)	1
Santia marmorata (Vanhöffen, 1914)	Animalia|Arthropoda|Malacostraca|Isopoda|Santiidae|Santia|marmorata|Santia marmorata (Vanhöffen, 1914)	1
Phocaena dioptrica Lahille, 1912	Animalia|Chordata|Mammalia|Cetacea|Phocoenidae|Phocoena|dioptrica|Phocaena dioptrica Lahille, 1912	1
Etmopterus bigelowi Shirai & Tachikawa, 1993	Animalia|Chordata|Elasmobranchii|Squaliformes|Etmopteridae|Etmopterus|bigelowi|Etmopterus bigelowi Shirai & Tachikawa, 1993	1
Hymeniacidon fernandezi Thiele, 1905	Animalia|Porifera|Demospongiae|Halichondrida|Halichondriidae|Hymeniacidon|fernandezi|Hymeniacidon fernandezi Thiele, 1905	1
Microrhinus carnosus (Reinsch) Skottsberg, 1923	Plantae|Rhodophyta|Florideophyceae|Ceramiales|Delesseriaceae|Microrhinus|carnosus|Microrhinus carnosus (Reinsch) Skottsberg, 1923	1
Aglaophamus macroura (Schmarda, 1861)	Animalia|Annelida|Polychaeta|Phyllodocida|Nephtyidae|Aglaophamus|macroura|Aglaophamus macroura (Schmarda, 1861)	1
Rhynchospio glutaea (Ehlers, 1897)	Animalia|Annelida|Polychaeta|Spionida|Spionidae|Rhynchospio|glutaea|Rhynchospio glutaea (Ehlers, 1897)	1
Fulmarus glacialoides (A. Smith, 1840)	Animalia|Chordata|Aves|Procellariiformes|Procellariidae|Fulmarus|glacialoides|Fulmarus glacialoides (A. Smith, 1840)	1
Marchantia polymorpha L.	Plantae|Marchantiophyta|Marchantiopsida|Marchantiales|Marchantiaceae|Marchantia|polymorpha|Marchantia polymorpha L.	1
Aphrodroma brevirostris (Lesson, 1831)	Animalia|Chordata|Aves|Procellariiformes|Procellariidae|Aphrodroma|brevirostris|Aphrodroma brevirostris (Lesson, 1831)	1
Racomitrium lanuginosum Bridel, 1819	Plantae|Bryophyta|Bryopsida|Grimmiales|Grimmiaceae|Racomitrium|lanuginosum|Racomitrium lanuginosum Bridel, 1819	1
Iophon spatulatus Kirkpatrick, 1907	Animalia|Porifera|Demospongiae|Poecilosclerida|Acarnidae|Iophon|spatulatus|Iophon spatulatus Kirkpatrick, 1907	1
Placopsis brevilobata (Zahlbr.) I.M. Lamb	Fungi|Ascomycota|Lecanoromycetes|Baeomycetales|Trapeliaceae|Placopsis|brevilobata|Placopsis brevilobata (Zahlbr.) I.M. Lamb	1
Clitellata	Animalia|Annelida|Clitellata|||||Clitellata	1
Parschisturella Andres, 1983	Animalia|Arthropoda|Malacostraca|Amphipoda|Uristidae|Parschisturella||Parschisturella Andres, 1983	1
Kidderia bicolor (Martens, 1885)	Animalia|Mollusca|Bivalvia|Veneroida|Cyamiidae|Kidderia|bicolor|Kidderia bicolor (Martens, 1885)	1
Gaimardia Gould, 1852	Animalia|Mollusca|Bivalvia|Veneroida|Gaimardiidae|Gaimardia||Gaimardia Gould, 1852	1
Uristes barbatipes (Stebbing, 1888)	Animalia|Arthropoda|Malacostraca|Amphipoda|Uristidae|Uristes|barbatipes|Uristes barbatipes (Stebbing, 1888)	1
Uristes gigas Dana, 1849	Animalia|Arthropoda|Malacostraca|Amphipoda|Uristidae|Uristes|gigas|Uristes gigas Dana, 1849	1
Probolisca ovata (Stebbing, 1888)	Animalia|Arthropoda|Malacostraca|Amphipoda|Stenothoidae|Probolisca|ovata|Probolisca ovata (Stebbing, 1888)	1
Capitella Blainville, 1828	Animalia|Annelida|Polychaeta||Capitellidae|Capitella||Capitella Blainville, 1828	1
Placopsis	Fungi|Ascomycota|Lecanoromycetes|Baeomycetales|Trapeliaceae|Placopsis||Placopsis	1
Eatoniella caliginosa (E. A. Smith, 1875)	Animalia|Mollusca|Gastropoda|Littorinimorpha|Eatoniellidae|Eatoniella|caliginosa|Eatoniella caliginosa (E. A. Smith, 1875)	1
Metopoides Della Valle, 1893	Animalia|Arthropoda|Malacostraca|Amphipoda|Stenothoidae|Metopoides||Metopoides Della Valle, 1893	1
Lessonia flavicans Bory de Saint-Vincent	Chromista|Ochrophyta|Phaeophyceae|Laminariales|Lessoniaceae|Lessonia|flavicans|Lessonia flavicans Bory de Saint-Vincent	1
Festuca kerguelensis (Hook.) F.Muell.	Plantae|Magnoliophyta|Liliopsida|Poales|Poaceae|Festuca|kerguelensis|Festuca kerguelensis (Hook.) F.Muell.	1
Diomedea exulans Linnaeus, 1758	Animalia|Chordata|Aves|Procellariiformes|Diomedeidae|Diomedea|exulans|Diomedea exulans Linnaeus, 1758	1
Sycozoa quoyi (Herdman, 1886)	Animalia|Chordata|Ascidiacea|Enterogona|Holozoidae|Sycozoa|quoyi|Sycozoa quoyi (Herdman, 1886)	1
Phalacrocorax atriceps nivalis Falla, 1937	Animalia|Chordata|Aves|Suliformes|Phalacrocoracidae|Leucocarbo|atriceps|Phalacrocorax atriceps nivalis Falla, 1937	1
Pringlea antiscorbutica R. Br.	Plantae|Tracheophyta|Magnoliopsida|Brassicales|Brassicaceae|Pringlea|antiscorbutica|Pringlea antiscorbutica R. Br.	1
Festuca cookii Hook.f.	Plantae|Tracheophyta|Liliopsida|Poales|Poaceae|Poa|cookii|Festuca cookii Hook.f.	1
Notopoma oppositus (K.H. Barnard, 1932)	Animalia|Arthropoda|Malacostraca|Amphipoda|Ischyroceridae|Notopoma|oppositus|Notopoma oppositus (K.H. Barnard, 1932)	1
Amphiporus spinosus Bürger, 1893	Animalia|Nemertea|Enopla|Monostilifera|Amphiporidae|Amphiporus|spinosus|Amphiporus spinosus Bürger, 1893	1
Garrodia nereis (Gould, 1841)	Animalia|Chordata|Aves|Procellariiformes|Hydrobatidae|Garrodia|nereis|Garrodia nereis (Gould, 1841)	1
Pringlea antiscorbutica R. Br.	Plantae|Magnoliophyta|Magnoliopsida|Brassicales|Brassicaceae|Pringlea|antiscorbutica|Pringlea antiscorbutica R. Br.	1
Umbilicaria decussata (Vill.) Zahlbr.	Fungi|Ascomycota|Lecanoromycetes|Umbilicariales|Umbilicariaceae|Umbilicaria|decussata|Umbilicaria decussata (Vill.) Zahlbr.	1
Neuropogon Nees & Flot.	Fungi|Ascomycota|Lecanoromycetes|Lecanorales|Parmeliaceae|Usnea||Neuropogon Nees & Flot.	1
Ulvaceae	Plantae|Chlorophyta|Ulvophyceae|Ulvales|Ulvaceae|||Ulvaceae	1
Paramoera Miers, 1875	Animalia|Arthropoda|Malacostraca|Amphipoda|Eusiridae|Paramoera||Paramoera Miers, 1875	1
Bryoerythrophyllum Chen	Plantae|Bryophyta|Bryopsida|Pottiales|Pottiaceae|Bryoerythrophyllum||Bryoerythrophyllum Chen	1
Podocerus Leach, 1814	Animalia|Arthropoda|Malacostraca|Amphipoda|Podoceridae|Podocerus||Podocerus Leach, 1814	1
Durvillaea antarctica (Chamisso) Hariot, 1892	Chromista|Ochrophyta|Phaeophyceae|Fucales|Durvillaeaceae|Durvillaea|antarctica|Durvillaea antarctica (Chamisso) Hariot, 1892	1
Paramoera kergueleni Bellan-Santini & Ledoyer, 1974	Animalia|Arthropoda|Malacostraca|Amphipoda|Eusiridae|Paramoera|kergueleni|Paramoera kergueleni Bellan-Santini & Ledoyer, 1974	1
Placopsis parellina (Nyl.) I.M. Lamb	Fungi|Ascomycota|Lecanoromycetes|Agyriales|Agyriaceae|Placopsis|parellina|Placopsis parellina (Nyl.) I.M. Lamb	1
Chaetozone setosa Malmgren, 1867	Animalia|Annelida|Polychaeta|Terebellida|Cirratulidae|Chaetozone|setosa|Chaetozone setosa Malmgren, 1867	1
Benthoctopus Grimpe, 1921	Animalia|Mollusca|Cephalopoda|Octopoda|Octopodidae|Benthoctopus||Benthoctopus Grimpe, 1921	1
Thalassiosira P. T. Cleve	Chromista|Ochrophyta|Coscinodiscophyceae|Thalassiosirales|Thallassiosiraceae|Thalassiosira||Thalassiosira P. T. Cleve	1
Anasterias sphoerulata (Koehler, 1920)	Animalia|Echinodermata|Asteroidea|Forcipulatida|Asteriidae|Anasterias|sphoerulata|Anasterias sphoerulata (Koehler, 1920)	1
Eunoe Malmgren, 1866	Animalia|Annelida|Polychaeta|Phyllodocida|Polynoidae|Eunoe||Eunoe Malmgren, 1866	1
Cladonia fimbriata (L.) Fr.	Fungi|Ascomycota|Lecanoromycetes|Lecanorales|Cladoniaceae|Cladonia|fimbriata|Cladonia fimbriata (L.) Fr.	1
Halichondria panicea (Pallas, 1766)	Animalia|Porifera|Demospongiae|Halichondrida|Halichondriidae|Halichondria|panicea|Halichondria panicea (Pallas, 1766)	1
Leucetta primigenia Haeckel, 1872	Animalia|Porifera|Calcarea|Clathrinida|Leucettidae|Leucetta|primigenia|Leucetta primigenia Haeckel, 1872	1
Ischyrocerus Krøyer, 1838	Animalia|Arthropoda|Malacostraca|Amphipoda|Ischyroceridae|Ischyrocerus||Ischyrocerus Krøyer, 1838	1
Deyeuxia Clarion ex P. Beauv.	Plantae|Tracheophyta|Liliopsida|Poales|Poaceae|Calamagrostis||Deyeuxia Clarion ex P. Beauv.	1
Asteraceae	Plantae|Tracheophyta|Magnoliopsida|Asterales|Asteraceae|||Asteraceae	1
Diomedea epomophora Lesson, 1825	Animalia|Chordata|Aves|Procellariiformes|Diomedeidae|Diomedea|epomophora|Diomedea epomophora Lesson, 1825	1
Iophon spatulatum Kirkpatrick, 1907	Animalia|Porifera|Demospongiae|Poecilosclerida|Acarnidae|Iophon|spatulatum|Iophon spatulatum Kirkpatrick, 1907	1
Neobuccinum eatoni (Smith, 1875)	Animalia|Mollusca|Gastropoda|Neogastropoda|Buccinidae|Neobuccinum|eatoni|Neobuccinum eatoni (Smith, 1875)	1
Fuscidea V.Wirth & Vìzda	Fungi|Ascomycota|Lecanoromycetes|Teloschistales|Fuscideaceae|Fuscidea||Fuscidea V.Wirth & Vìzda	1
Tortula J. Hedwig, 1801	Plantae|Bryophyta|Bryopsida|Pottiales|Pottiaceae|Tortula||Tortula J. Hedwig, 1801	1
Amblystegium serpens W. P. Schimper in B.S.G., 1853	Plantae|Bryophyta|Bryopsida|Hypnales|Amblystegiaceae|Amblystegium|serpens|Amblystegium serpens W. P. Schimper in B.S.G., 1853	1
Ballia callitricha (C.Agardh) Kützing, 1843	Plantae|Rhodophyta|Florideophyceae|Balliales|Balliaceae|Ballia|callitricha|Ballia callitricha (C.Agardh) Kützing, 1843	1
Lessonia flavicans Bory de Saint-Vincent, 1825	Chromista|Ochrophyta|Phaeophyceae|Laminariales|Lessoniaceae|Lessonia|flavicans|Lessonia flavicans Bory de Saint-Vincent, 1825	1
Eurhynchium Schimp. in B.S.G.	Plantae|Bryophyta|Bryopsida|Hypnales|Brachytheciaceae|Eurhynchium||Eurhynchium Schimp. in B.S.G.	1
Gallirallus australis scotti (Ogilvie-Grant, 1905)	Animalia|Chordata|Aves|Gruiformes|Rallidae|Gallirallus|australis|Gallirallus australis scotti (Ogilvie-Grant, 1905)	1
Aplysina minima Hentschel, 1914	Animalia|Porifera|Demospongiae|Verongida|Aplysinidae|Aplysina|minima|Aplysina minima Hentschel, 1914	1
Blepharidophyllum densifolium (Hook.) Ångstr.	Plantae|Marchantiophyta|Jungermanniopsida|Jungermanniales|Blepharidophyllaceae|Blepharidophyllum|densifolium|Blepharidophyllum densifolium (Hook.) Ångstr.	1
Procellaria aequinoctialis Linnaeus, 1758	Animalia|Chordata|Aves|Procellariiformes|Procellariidae|Procellaria|aequinoctialis|Procellaria aequinoctialis Linnaeus, 1758	1
Schraderia gracilis Pfeffer, 1888	Animalia|Arthropoda|Malacostraca|Amphipoda|Eusiridae|Schraderia|gracilis|Schraderia gracilis Pfeffer, 1888	1
Pohlia Hedw.	Plantae|Bryophyta|Bryopsida|Bryales|Bryaceae|Pohlia||Pohlia Hedw.	1
Caloplaca lucens (Nyl.) Zahlbr.	Fungi|Ascomycota|Lecanoromycetes|Teloschistales|Teloschistaceae|Caloplaca|lucens|Caloplaca lucens (Nyl.) Zahlbr.	1
Usnea trachycarpa (Stirt.) Müll. Arg.	Fungi|Ascomycota|Lecanoromycetes|Lecanorales|Parmeliaceae|Neuropogon|trachycarpa|Usnea trachycarpa (Stirt.) Müll. Arg.	1
Pygoscelis antarctica (J. R. Forster, 1781)	Animalia|Chordata|Aves|Sphenisciformes|Spheniscidae|Pygoscelis|antarctica|Pygoscelis antarctica (J. R. Forster, 1781)	1
Pugiodactylus antarcticus (Beddard, 1886)	Animalia|Arthropoda|Malacostraca|Tanaidacea|Apseudidae|Pugiodactylus|antarcticus|Pugiodactylus antarcticus (Beddard, 1886)	1
Halobaena caerulea (Gmelin, 1789)	Animalia|Chordata|Aves|Procellariiformes|Procellariidae|Halobaena|caerulea|Halobaena caerulea (Gmelin, 1789)	1
Brachythecium austrosalebrosum Paris, 1894	Plantae|Bryophyta|Bryopsida|Hypnales|Brachytheciaceae|Brachythecium|austrosalebrosum|Brachythecium austrosalebrosum Paris, 1894	1
Pottia (Reichenb.) Fürnr.	Plantae|Bryophyta|Bryopsida|Pottiales|Pottiaceae|Pottia||Pottia (Reichenb.) Fürnr.	1
Bartramia Hedw.	Plantae|Bryophyta|Bryopsida|Bryales|Bartramiaceae|Bartramia||Bartramia Hedw.	1
Muelleriella crassifolia var. acuta (Müll. Hal.) Vitt	Plantae|Bryophyta|Bryopsida|Orthotrichales|Orthotrichaceae|Muelleriella|crassifolia|Muelleriella crassifolia var. acuta (Müll. Hal.) Vitt	1
Skenella sinapi (Watson, 1886)	Animalia|Mollusca|Gastropoda|Littorinimorpha|Cingulopsidae|Skenella|sinapi|Skenella sinapi (Watson, 1886)	1
Pottia Fürnrohr, 1829	Plantae|Bryophyta|Bryopsida|Pottiales|Pottiaceae|Pottia||Pottia Fürnrohr, 1829	1
Uristes barbatipes (Stebbing, 1888)	Animalia|Arthropoda|Malacostraca|Amphipoda|Lysianassidae|Tasmanosa|barbatipes|Uristes barbatipes (Stebbing, 1888)	1
Placopsis fusciduloides D. J. Galloway	Fungi|Ascomycota|Lecanoromycetes|Baeomycetales|Trapeliaceae|Placopsis|fusciduloides|Placopsis fusciduloides D. J. Galloway	1
Festuca cookii Hook.f.	Plantae|Magnoliophyta|Liliopsida|Poales|Poaceae|Poa|cookii|Festuca cookii Hook.f.	1
Oradarea tridentata K.H. Barnard, 1932	Animalia|Arthropoda|Malacostraca|Amphipoda|Calliopiidae|Oradarea|tridentata|Oradarea tridentata K.H. Barnard, 1932	1
Arctomia latispora Øvstedal	Fungi|Ascomycota|Lecanoromycetes|Lecanorales|Arctomiaceae|Arctomia|latispora|Arctomia latispora Øvstedal	1
Iophon unicorne Topsent, 1907	Animalia|Porifera|Demospongiae|Poecilosclerida|Acarnidae|Iophon|unicorne|Iophon unicorne Topsent, 1907	1
Gitanopsis squamosa (Thomson, 1880)	Animalia|Arthropoda|Malacostraca|Amphipoda|Amphilochidae|Gitanopsis|squamosa|Gitanopsis squamosa (Thomson, 1880)	1
Nototanais dimorphus (Beddard, 1886)	Animalia|Arthropoda|Malacostraca|Tanaidacea|Nototanaidae|Nototanais|dimorphus|Nototanais dimorphus (Beddard, 1886)	1
Ditrichum punctulatum Mitten, 1879	Plantae|Bryophyta|Bryopsida|Dicranales|Ditrichaceae|Ditrichum|punctulatum|Ditrichum punctulatum Mitten, 1879	1
Pyropia columbina (Montagne) W.A.Nelson, 2011	Plantae|Rhodophyta|Bangiophyceae|Bangiales|Bangiaceae|Pyropia|columbina|Pyropia columbina (Montagne) W.A.Nelson, 2011	1
Jassa Leach, 1814	Animalia|Arthropoda|Malacostraca|Amphipoda|Ischyroceridae|Jassa||Jassa Leach, 1814	1
Amblystegium serpens (Limpricht) Meylan, 1905	Plantae|Bryophyta|Bryopsida|Hypnales|Amblystegiaceae|Amblystegium|serpens|Amblystegium serpens (Limpricht) Meylan, 1905	1
Laevilitorina hamiltoni (E. A. Smith, 1898)	Animalia|Mollusca|Gastropoda|Littorinimorpha|Littorinidae|Laevilitorina|hamiltoni|Laevilitorina hamiltoni (E. A. Smith, 1898)	1
Xanthoria (Fr.) Th. Fr., 1861	Fungi|Ascomycota|Lecanoromycetes|Teloschistales|Teloschistaceae|Xanthoria||Xanthoria (Fr.) Th. Fr., 1861	1
Anas eatoni eatoni (Sharpe, 1875)	Animalia|Chordata|Aves|Anseriformes|Anatidae|Anas|eatoni|Anas eatoni eatoni (Sharpe, 1875)	1
Pelecanoides Lacepède, 1799	Animalia|Chordata|Aves|Procellariiformes|Pelecanoididae|Pelecanoides||Pelecanoides Lacepède, 1799	1
Verrucaria H.A.Schrader, 1794	Fungi|Ascomycota|Eurotiomycetes|Verrucariales|Verrucariaceae|Verrucaria||Verrucaria H.A.Schrader, 1794	1
Cladonia chlorophaea (Flörke ex Sommerf.) Spreng.	Fungi|Ascomycota|Lecanoromycetes|Lecanorales|Cladoniaceae|Cladonia|chlorophaea|Cladonia chlorophaea (Flörke ex Sommerf.) Spreng.	1
Nacella mytilina (Helbling, 1779)	Animalia|Mollusca|Gastropoda||Nacellidae|Nacella|mytilina|Nacella mytilina (Helbling, 1779)	1
Lecania A.Massal.	Fungi|Ascomycota|Lecanoromycetes|Lecanorales|Ramalinaceae|Lecania||Lecania A.Massal.	1
Palmaria georgica (Reinsch) R.W.Ricker, 1987	Plantae|Rhodophyta|Florideophyceae|Palmariales|Palmariaceae|Palmaria|georgica|Palmaria georgica (Reinsch) R.W.Ricker, 1987	1
Hemiarthrum setulosum Carpenter in Dall, 1876	Animalia|Mollusca|Polyplacophora|Chitonida|Hemiarthridae|Hemiarthrum|setulosum|Hemiarthrum setulosum Carpenter in Dall, 1876	1
Macronectes halli Mathews, 1912	Animalia|Chordata|Aves|Procellariiformes|Procellariidae|Macronectes|halli|Macronectes halli Mathews, 1912	1
Oreosoma atlanticum Cuvier, 1829	Animalia|Chordata|Actinopterygii|Zeiformes|Oreosomatidae|Oreosoma|atlanticum|Oreosoma atlanticum Cuvier, 1829	1
Phleum pratense L.	Plantae|Tracheophyta|Liliopsida|Poales|Poaceae|Phleum|pratense|Phleum pratense L.	1
Trophon albolabratus E. A. Smith, 1875	Animalia|Mollusca|Gastropoda|Neogastropoda|Muricidae|Trophon|albolabratus|Trophon albolabratus E. A. Smith, 1875	1
Fregetta tropica (Gould, 1844)	Animalia|Chordata|Aves|Procellariiformes|Hydrobatidae|Fregetta|tropica|Fregetta tropica (Gould, 1844)	1
Lachnagrostis Trin.	Plantae|Tracheophyta|Liliopsida|Poales|Poaceae|Agrostis||Lachnagrostis Trin.	1
Bostrychia vaga J.D.Hooker & Harvey, 1845	Plantae|Rhodophyta|Florideophyceae|Ceramiales|Rhodomelaceae|Bostrychia|vaga|Bostrychia vaga J.D.Hooker & Harvey, 1845	1
Muelleriella crassifolia subsp. crassifolia	Plantae|Bryophyta|Bryopsida|Orthotrichales|Orthotrichaceae|Muelleriella|crassifolia|Muelleriella crassifolia subsp. crassifolia	1
Thalassiosira Cleve, 1873	Chromista|Ochrophyta|Bacillariophyceae|Thalassiosirales|Thalassiosiraceae|Thalassiosira||Thalassiosira Cleve, 1873	1
Rinodina otagensis (Zahlbr.) H. Mayrhofer	Fungi|Ascomycota|Lecanoromycetes|Teloschistales|Physciaceae|Amandinea|otagensis|Rinodina otagensis (Zahlbr.) H. Mayrhofer	1
Protolaeospira tricostalis (Lamarck, 1818)	Animalia|Annelida|Polychaeta|Sabellida|Serpulidae|Spirorbis|tricostalis|Protolaeospira tricostalis (Lamarck, 1818)	1
Callitriche Linnaeus, 1753	Plantae|Magnoliophyta|Magnoliopsida|Lamiales|Plantaginaceae|Callitriche||Callitriche Linnaeus, 1753	1
Trophon albolabratus E. A. Smith, 1875	Animalia|Mollusca|Gastropoda|Neogastropoda||Trophon|albolabratus|Trophon albolabratus E. A. Smith, 1875	1
Paraliparis copei Goode & Bean, 1896	Animalia|Chordata|Actinopterygii|Scorpaeniformes|Liparidae|Paraliparis|copei|Paraliparis copei Goode & Bean, 1896	1
Nacella macquariensis (Finlay, 1927)	Animalia|Mollusca|Gastropoda|Archaeogastropoda|Nacellidae|Nacella|macquariensis|Nacella macquariensis (Finlay, 1927)	1
Enteromorpha bulbosa (Suhr) Montagne, 1846	Plantae|Chlorophyta|Ulvophyceae|Ulvales|Ulvaceae|Ulva|bulbosa|Enteromorpha bulbosa (Suhr) Montagne, 1846	1
Pachyptila belcheri (Mathews, 1912)	Animalia|Chordata|Aves|Procellariiformes|Procellariidae|Pachyptila|belcheri|Pachyptila belcheri (Mathews, 1912)	1
Thalassarche melanophris subsp. melanophris	Animalia|Chordata|Aves|Procellariiformes|Diomedeidae|Thalassarche|melanophris|Thalassarche melanophris subsp. melanophris	1
Philobrya aviculoides (Vélain, 1877)	Animalia|Mollusca|Bivalvia|Arcoida|Philobryidae|Philobrya|aviculoides|Philobrya aviculoides (Vélain, 1877)	1