taxonName	taxonPath	recordCount
Larus dominicanus Lichtenstein, 1823	Animalia|Chordata|Aves|Charadriiformes|Laridae|Larus|dominicanus|Larus dominicanus Lichtenstein, 1823	147
Macronectes halli Mathews, 1912	Animalia|Chordata|Aves|Procellariiformes|Procellariidae|Macronectes|halli|Macronectes halli Mathews, 1912	141
Phalacrocorax verrucosus (Cabanis, 1875)	Animalia|Chordata|Aves|Suliformes|Phalacrocoracidae|Leucocarbo|verrucosus|Phalacrocorax verrucosus (Cabanis, 1875)	138
	|||||||	125
Anas eatoni (Sharpe, 1875)	Animalia|Chordata|Aves|Anseriformes|Anatidae|Anas|eatoni|Anas eatoni (Sharpe, 1875)	110
Sterna virgata Cabanis, 1875	Animalia|Chordata|Aves|Charadriiformes|Laridae|Sterna|virgata|Sterna virgata Cabanis, 1875	100
Stercorarius antarcticus (Lesson, 1831)	Animalia|Chordata|Aves|Charadriiformes|Stercorariidae|Stercorarius|antarcticus|Stercorarius antarcticus (Lesson, 1831)	95
Pygoscelis papua (J. R. Forster, 1781)	Animalia|Chordata|Aves|Sphenisciformes|Spheniscidae|Pygoscelis|papua|Pygoscelis papua (J. R. Forster, 1781)	70
Poaceae	Plantae|Tracheophyta|Liliopsida|Poales|Poaceae|||Poaceae	43
Psammothidium Bukhtiyarova & Round	Plantae|Bacillariophyta|Bacillariophyceae|Acnanthales|Achnanthidiaceae|Psammothidium||Psammothidium Bukhtiyarova & Round	41
Psammothidium L.Buhtkiyarova & Round, 1996	Chromista|Ochrophyta|Bacillariophyceae|Achnanthales|Achnanthidiaceae|Psammothidium||Psammothidium L.Buhtkiyarova & Round, 1996	41
Stauroforma R.Flower, V.Jones & Round	Chromista|Ochrophyta|Coscinodiscophyceae|Fragilariales|Fragilariaceae|Stauroforma||Stauroforma R.Flower, V.Jones & Round	41
Stauroforma R.Flower, V.Jones & Round	Chromista|Ochrophyta|Bacillariophyceae|Fragilariales|Fragilariaceae|Stauroforma||Stauroforma R.Flower, V.Jones & Round	41
Phoebetria palpebrata (J. R. Forster, 1785)	Animalia|Chordata|Aves|Procellariiformes|Diomedeidae|Phoebetria|palpebrata|Phoebetria palpebrata (J. R. Forster, 1785)	40
Pinnularia C.G. Ehrenberg, 1843	Plantae|Bacillariophyta|Bacillariophyceae|Naviculales|Pinnulariaceae|Pinnularia||Pinnularia C.G. Ehrenberg, 1843	39
Pinnularia Ehrenberg, 1843	Chromista|Ochrophyta|Bacillariophyceae|Naviculales|Pinnulariaceae|Pinnularia||Pinnularia Ehrenberg, 1843	39
Fragilaria Lyngbye, 1819	Chromista|Ochrophyta|Bacillariophyceae|Fragilariales|Fragilariaceae|Fragilaria||Fragilaria Lyngbye, 1819	39
Fragilaria Lyngbye, 1819	Chromista|Ochrophyta|Coscinodiscophyceae|Fragilariales|Fragilariaceae|Fragilaria||Fragilaria Lyngbye, 1819	39
Achnanthidium Kütz.	Plantae|Bacillariophyta|Bacillariophyceae|Acnanthales|Achnanthidiaceae|Achnanthidium||Achnanthidium Kütz.	36
Achnanthidium	Chromista|Ochrophyta|Bacillariophyceae|Achnanthales|Achnanthidiaceae|Achnanthidium||Achnanthidium	36
Cavinula D.G.Mann & A.J.Stickle, 1990	Chromista|Ochrophyta|Bacillariophyceae|Naviculales|Cavinulaceae|Cavinula||Cavinula D.G.Mann & A.J.Stickle, 1990	32
Pterodroma macroptera (A. Smith, 1840)	Animalia|Chordata|Aves|Procellariiformes|Procellariidae|Pterodroma|macroptera|Pterodroma macroptera (A. Smith, 1840)	32
Navicula Bory de St.-Vincent, 1822	Plantae|Bacillariophyta|Bacillariophyceae|Naviculales|Naviculaceae|Navicula||Navicula Bory de St.-Vincent, 1822	32
Aulacoseira Thwaites, 1848	Chromista|Ochrophyta|Bacillariophyceae|Aulacoseirales|Aulacoseiraceae|Aulacoseira||Aulacoseira Thwaites, 1848	32
Cavinula Mann & Stickle in Round, Crawford & Mann	Plantae|Bacillariophyta|Bacillariophyceae|Naviculales|Cavinulaceae|Cavinula||Cavinula Mann & Stickle in Round, Crawford & Mann	32
Aulacoseira Thwaites	Chromista|Ochrophyta|Coscinodiscophyceae|Aulacoseirales|Aulacoseiraceae|Aulacoseira||Aulacoseira Thwaites	32
Navicula Bory de Saint-Vincent, 1822	Chromista|Ochrophyta|Bacillariophyceae|Naviculales|Naviculaceae|Navicula||Navicula Bory de Saint-Vincent, 1822	32
Poa kerguelensis (Hook.f.) Steud.	Plantae|Tracheophyta|Liliopsida|Poales|Poaceae|Poa|kerguelensis|Poa kerguelensis (Hook.f.) Steud.	31
Sterna vittata Gmelin, 1789	Animalia|Chordata|Aves|Charadriiformes|Laridae|Sterna|vittata|Sterna vittata Gmelin, 1789	31
Chionis minor Hartlaub, 1841	Animalia|Chordata|Aves|Charadriiformes|Chionidae|Chionis|minor|Chionis minor Hartlaub, 1841	31
Aptenodytes patagonicus J. F. Miller, 1778	Animalia|Chordata|Aves|Sphenisciformes|Spheniscidae|Aptenodytes|patagonicus|Aptenodytes patagonicus J. F. Miller, 1778	31
Planothidium Round & L.Bukhtiyarova, 1996	Chromista|Ochrophyta|Bacillariophyceae|Achnanthales|Achnanthidiaceae|Planothidium||Planothidium Round & L.Bukhtiyarova, 1996	31
Planothidium Round & Bukhtiyarova	Plantae|Bacillariophyta|Bacillariophyceae|Acnanthales|Achnanthidiaceae|Planothidium||Planothidium Round & Bukhtiyarova	31
Paramoera fissicauda (Dana, 1852)	Animalia|Arthropoda|Malacostraca|Amphipoda|Eusiridae|Paramoera|fissicauda|Paramoera fissicauda (Dana, 1852)	30
Procellaria aequinoctialis Linnaeus, 1758	Animalia|Chordata|Aves|Procellariiformes|Procellariidae|Procellaria|aequinoctialis|Procellaria aequinoctialis Linnaeus, 1758	30
Nitzschia Hassall, 1845	Chromista|Ochrophyta|Bacillariophyceae|Bacillariales|Bacillariaceae|Nitzschia||Nitzschia Hassall, 1845	30
Nitzschia Hassall, 1845	Plantae|Bacillariophyta|Bacillariophyceae|Bacillariales|Bacillariaceae|Nitzschia||Nitzschia Hassall, 1845	30
Aphrodroma brevirostris (Lesson, 1831)	Animalia|Chordata|Aves|Procellariiformes|Procellariidae|Aphrodroma|brevirostris|Aphrodroma brevirostris (Lesson, 1831)	29
Eunotia Ehrenberg, 1837	Chromista|Ochrophyta|Bacillariophyceae|Eunotiales|Eunotiaceae|Eunotia||Eunotia Ehrenberg, 1837	29
Staurosirella D.M.Williams & Round, 1988	Chromista|Ochrophyta|Coscinodiscophyceae|Fragilariales|Fragilariaceae|Staurosirella||Staurosirella D.M.Williams & Round, 1988	29
Staurosirella D.M.Williams & Round, 1988	Chromista|Ochrophyta|Bacillariophyceae|Fragilariales|Fragilariaceae|Staurosirella||Staurosirella D.M.Williams & Round, 1988	29
Halobaena caerulea (Gmelin, 1789)	Animalia|Chordata|Aves|Procellariiformes|Procellariidae|Halobaena|caerulea|Halobaena caerulea (Gmelin, 1789)	29
Eunotia Ehrenberg	Plantae|Bacillariophyta|Bacillariophyceae|Eunotiales|Eunotiaceae|Eunotia||Eunotia Ehrenberg	29
Diadesmis Kütz.	Plantae|Bacillariophyta|Bacillariophyceae|Naviculales|Diadesmidaceae|Diadesmis||Diadesmis Kütz.	28
Gomphonema Ehrenberg, 1832	Chromista|Ochrophyta|Bacillariophyceae|Cymbellales|Gomphonemataceae|Gomphonema||Gomphonema Ehrenberg, 1832	28
Diadesmis Kützing, 1844	Chromista|Ochrophyta|Bacillariophyceae|Naviculales|Diadesmidaceae|Diadesmis||Diadesmis Kützing, 1844	28
Poa kerguelensis (Hook.f.) Steud.	Plantae|Magnoliophyta|Liliopsida|Poales|Poaceae|Festuca|kerguelensis|Poa kerguelensis (Hook.f.) Steud.	28
Gomphonema C.G. Ehrenberg, 1832	Plantae|Bacillariophyta|Bacillariophyceae|Cymbellales|Gomophonemataceae|Gomphonema||Gomphonema C.G. Ehrenberg, 1832	28
Procellaria cinerea Gmelin, 1789	Animalia|Chordata|Aves|Procellariiformes|Procellariidae|Procellaria|cinerea|Procellaria cinerea Gmelin, 1789	26
Kobayasiella Lange-Bertalot, 1999	Plantae|Bacillariophyta|Bacillariophyceae|Naviculales|Naviculaceae|Kobayasiella||Kobayasiella Lange-Bertalot, 1999	26
Kobayasiella Lange-Bertalot, 1999	Chromista|Ochrophyta|Bacillariophyceae|Naviculales|Naviculaceae|Kobayasiella||Kobayasiella Lange-Bertalot, 1999	26
Callitriche L.	Plantae|Tracheophyta|Magnoliopsida|Lamiales|Plantaginaceae|Callitriche||Callitriche L.	25
Azorella selago Hook. fil.	Plantae|Tracheophyta|Magnoliopsida|Apiales|Apiaceae|Azorella|selago|Azorella selago Hook. fil.	25
Colobanthus kerguelensis Hook. fil.	Plantae|Tracheophyta|Magnoliopsida|Caryophyllales|Caryophyllaceae|Colobanthus|kerguelensis|Colobanthus kerguelensis Hook. fil.	24
Lycopodium magellanicum (P. Beauv.) Sw.	Plantae|Tracheophyta|Lycopodiopsida|Lycopodiales|Lycopodiaceae|Austrolycopodium|magellanicum|Lycopodium magellanicum (P. Beauv.) Sw.	24
Cotula plumosa (Hook.f.) Hook.f.	Plantae|Magnoliophyta|Magnoliopsida|Asterales|Asteraceae||plumosa|Cotula plumosa (Hook.f.) Hook.f.	23
Cotula plumosa (Hook.f.) Hook.f.	Plantae|Tracheophyta|Magnoliopsida|Asterales|Asteraceae|Leptinella|plumosa|Cotula plumosa (Hook.f.) Hook.f.	23
Azorella selago Hook.f.	Plantae|Magnoliophyta|Magnoliopsida|Apiales|Apiaceae|Azorella|selago|Azorella selago Hook.f.	23
Lycopodium magellanicum	Plantae|Lycopodiophyta|Lycopodiopsida|Lycopodiales|Lycopodiaceae|Lycopodium|magellanicum|Lycopodium magellanicum	22
Colobanthus kerguelensis Hook.f.	Plantae|Magnoliophyta|Magnoliopsida|Caryophyllales|Caryophyllaceae|Colobanthus|kerguelensis|Colobanthus kerguelensis Hook.f.	22
Pringlea antiscorbutica R. Br. ex Hook. f.	Plantae|Tracheophyta|Magnoliopsida|Brassicales|Brassicaceae|Pringlea|antiscorbutica|Pringlea antiscorbutica R. Br. ex Hook. f.	22
Diomedea exulans Linnaeus, 1758	Animalia|Chordata|Aves|Procellariiformes|Diomedeidae|Diomedea|exulans|Diomedea exulans Linnaeus, 1758	21
Acaena magellanica (Lam.) Vahl	Plantae|Tracheophyta|Magnoliopsida|Rosales|Rosaceae|Acaena|magellanica|Acaena magellanica (Lam.) Vahl	20
Pterodroma lessonii (Garnot, 1826)	Animalia|Chordata|Aves|Procellariiformes|Procellariidae|Pterodroma|lessonii|Pterodroma lessonii (Garnot, 1826)	20
Diploneis Ehrenberg ex Cleve, 1894	Chromista|Ochrophyta|Bacillariophyceae|Naviculales|Diploneidaceae|Diploneis||Diploneis Ehrenberg ex Cleve, 1894	20
Diploneis Ehrenberg ex Cleve	Plantae|Bacillariophyta|Bacillariophyceae|Naviculales|Diploneidaceae|Diploneis||Diploneis Ehrenberg ex Cleve	20
Diatomella Grev.	Plantae|Bacillariophyta|Bacillariophyceae|Naviculales|Pinnulariaceae|Diatomella||Diatomella Grev.	19
Pringlea antiscorbutica R. Br.	Plantae|Magnoliophyta|Magnoliopsida|Brassicales|Brassicaceae|Pringlea|antiscorbutica|Pringlea antiscorbutica R. Br.	19
Acaena magellanica (Lam.) Vahl	Plantae|Magnoliophyta|Magnoliopsida|Rosales|Rosaceae|Acaena|magellanica|Acaena magellanica (Lam.) Vahl	19
Diatomella Greville, 1855	Chromista|Ochrophyta|Bacillariophyceae|Naviculales|Pinnulariaceae|Diatomella||Diatomella Greville, 1855	19
Racomitrium Brid.	Plantae|Bryophyta|Bryopsida|Grimmiales|Grimmiaceae|Racomitrium||Racomitrium Brid.	18
Thalassarche melanophris (Temminck, 1828)	Animalia|Chordata|Aves|Procellariiformes|Diomedeidae|Thalassarche|melanophris|Thalassarche melanophris (Temminck, 1828)	18
Notogrammitis crassior (Kirk) Parris	Plantae|Tracheophyta|Polypodiopsida|Polypodiales|Polypodiaceae|Notogrammitis|crassior|Notogrammitis crassior (Kirk) Parris	18
Cicadosa cicadoides (Stebbing, 1888)	Animalia|Arthropoda|Malacostraca|Amphipoda|Uristidae|Cicadosa|cicadoides|Cicadosa cicadoides (Stebbing, 1888)	18
Montia fontana L.	Plantae|Tracheophyta|Magnoliopsida|Caryophyllales|Montiaceae|Montia|fontana|Montia fontana L.	18
Poa annua L.	Plantae|Tracheophyta|Liliopsida|Poales|Poaceae|Poa|annua|Poa annua L.	18
Montia fontana L.	Plantae|Magnoliophyta|Magnoliopsida|Caryophyllales|Montiaceae|Montia|fontana|Montia fontana L.	17
Poa cookii (Hook.f.) Hook.f.	Plantae|Tracheophyta|Liliopsida|Poales|Poaceae|Poa|cookii|Poa cookii (Hook.f.) Hook.f.	17
Poa annua L.	Plantae|Magnoliophyta|Liliopsida|Poales|Poaceae|Poa|annua|Poa annua L.	17
Bryum Hedw.	Plantae|Bryophyta|Bryopsida|Bryales|Bryaceae|Bryum||Bryum Hedw.	17
Dodecas elongata Stebbing, 1883	Animalia|Arthropoda|Malacostraca|Amphipoda|Caprellidae|Dodecas|elongata|Dodecas elongata Stebbing, 1883	16
Poa cookii (Hook.f.) Hook.f.	Plantae|Magnoliophyta|Liliopsida|Poales|Poaceae|Poa|cookii|Poa cookii (Hook.f.) Hook.f.	15
Acontiostoma marionis Stebbing, 1888	Animalia|Arthropoda|Malacostraca|Amphipoda|Lysianassidae|Acontiostoma|marionis|Acontiostoma marionis Stebbing, 1888	15
Scrophularia L.	Plantae|Tracheophyta|Magnoliopsida|Lamiales|Scrophulariaceae|Scrophularia||Scrophularia L.	14
Polycheria antarctica (Stebbing, 1875)	Animalia|Arthropoda|Malacostraca|Amphipoda|Dexaminidae|Polycheria|antarctica|Polycheria antarctica (Stebbing, 1875)	14
Galium antarcticum Hook.f.	Plantae|Magnoliophyta|Magnoliopsida|Gentianales|Rubiaceae|Galium|antarcticum|Galium antarcticum Hook.f.	14
Grimmia J. Hedwig, 1801	Plantae|Bryophyta|Bryopsida|Grimmiales|Grimmiaceae|Grimmia||Grimmia J. Hedwig, 1801	14
Galium antarcticum Hook.f.	Plantae|Tracheophyta|Magnoliopsida|Gentianales|Rubiaceae|Galium|antarcticum|Galium antarcticum Hook.f.	14
Crassula moschata Forst.	Plantae|Tracheophyta|Magnoliopsida|Saxifragales|Crassulaceae|Crassula|moschata|Crassula moschata Forst.	14
Deschampsia antarctica É.Desv.	Plantae|Magnoliophyta|Liliopsida|Poales|Poaceae|Deschampsia|antarctica|Deschampsia antarctica É.Desv.	14
Cymbella C.Agardh, 1830	Chromista|Ochrophyta|Bacillariophyceae|Cymbellales|Cymbellaceae|Cymbella||Cymbella C.Agardh, 1830	14
Deschampsia antarctica É.Desv.	Plantae|Tracheophyta|Liliopsida|Poales|Poaceae|Deschampsia|antarctica|Deschampsia antarctica É.Desv.	14
Myxilla kerguelensis (Hentschel, 1914)	Animalia|Porifera|Demospongiae|Poecilosclerida|Myxillidae|Myxilla|kerguelensis|Myxilla kerguelensis (Hentschel, 1914)	14
Cymbella C.A. Agardh, 1830	Plantae|Bacillariophyta|Bacillariophyceae|Cymbellales|Cymbellaceae|Cymbella||Cymbella C.A. Agardh, 1830	14
Zaramilla kergueleni Stebbing, 1888	Animalia|Arthropoda|Malacostraca|Amphipoda|Pontoporeiidae|Zaramilla|kergueleni|Zaramilla kergueleni Stebbing, 1888	14
Blechnum penna-marina (Poir.) Kuhn	Plantae|Tracheophyta|Polypodiopsida|Polypodiales|Blechnaceae|Blechnum|penna-marina|Blechnum penna-marina (Poir.) Kuhn	13
Crassula moschata Forst.	Plantae|Magnoliophyta|Magnoliopsida|Saxifragales|Crassulaceae|Crassula|moschata|Crassula moschata Forst.	13
Scrophularia L.	Plantae|Magnoliophyta|Magnoliopsida|Lamiales|Scrophulariaceae|Scrophularia||Scrophularia L.	13
Pterodroma mollis (Gould, 1844)	Animalia|Chordata|Aves|Procellariiformes|Procellariidae|Pterodroma|mollis|Pterodroma mollis (Gould, 1844)	13
Amphiporus moseleyi Hubrecht, 1887	Animalia|Nemertea|Enopla|Monostilifera|Amphiporidae|Amphiporus|moseleyi|Amphiporus moseleyi Hubrecht, 1887	13
Bartramia patens Bridel, 1803	Plantae|Bryophyta|Bryopsida|Bryales|Bartramiaceae|Bartramia|patens|Bartramia patens Bridel, 1803	13
Syntrichia magellanica Zander, 1993	Plantae|Bryophyta|Bryopsida|Pottiales|Pottiaceae|Syntrichia|magellanica|Syntrichia magellanica Zander, 1993	12
Limatula pygmaea (Philippi, 1845)	Animalia|Mollusca|Bivalvia|Limoida|Limidae|Limea|pygmaea|Limatula pygmaea (Philippi, 1845)	12
Cystopteris fragilis (L.) Bernh.	Plantae|Tracheophyta|Polypodiopsida|Polypodiales|Cystopteridaceae|Cystopteris|fragilis|Cystopteris fragilis (L.) Bernh.	12
Apohyale hirtipalma (Dana, 1852)	Animalia|Arthropoda|Malacostraca|Amphipoda|Hyalidae|Apohyale|hirtipalma|Apohyale hirtipalma (Dana, 1852)	12
Polycheria kergueleni (Stebbing, 1888)	Animalia|Arthropoda|Malacostraca|Amphipoda|Dexaminidae|Polycheria|kergueleni|Polycheria kergueleni (Stebbing, 1888)	12
Blechnum penna-marina (Poir.) Kuhn	Plantae|Pteridophyta|Polypodiopsida|Polypodiales|Blechnaceae|Blechnum|penna-marina|Blechnum penna-marina (Poir.) Kuhn	11
Agrostis magellanica Lam.	Plantae|Magnoliophyta|Liliopsida|Poales|Poaceae|Agrostis|magellanica|Agrostis magellanica Lam.	11
Agrostis magellanica Lam.	Plantae|Tracheophyta|Liliopsida|Poales|Poaceae|Agrostis|magellanica|Agrostis magellanica Lam.	11
Cystopteris fragilis (L.) Bernh.	Plantae|Pteridophyta|Polypodiopsida|Polypodiales|Woodsiaceae|Cystopteris|fragilis|Cystopteris fragilis (L.) Bernh.	11
Chamaepinnularia Lange-Bertalot & Krammer, 1996	Chromista|Ochrophyta|Bacillariophyceae|Naviculales|Naviculaceae|Chamaepinnularia||Chamaepinnularia Lange-Bertalot & Krammer, 1996	10
Catharacta lonnbergi Mathews, 1912	Animalia|Chordata|Aves|Charadriiformes|Stercorariidae|Stercorarius|lonnbergi|Catharacta lonnbergi Mathews, 1912	10
Cotula L.	Plantae|Tracheophyta|Magnoliopsida|Asterales|Asteraceae|Cotula||Cotula L.	10
Daption capense (Linnaeus, 1758)	Animalia|Chordata|Aves|Procellariiformes|Procellariidae|Daption|capense|Daption capense (Linnaeus, 1758)	10
Hymenophyllum peltatum (Poir.) Desv.	Plantae|Tracheophyta|Polypodiopsida|Hymenophyllales|Hymenophyllaceae|Hymenophyllum|peltatum|Hymenophyllum peltatum (Poir.) Desv.	10
Chamaepinnularia Lange-Bert. & Krammer in Lange-Bertalot & Metzeltin	Plantae|Bacillariophyta|Bacillariophyceae|Naviculales|Naviculaceae|Chamaepinnularia||Chamaepinnularia Lange-Bert. & Krammer in Lange-Bertalot & Metzeltin	10
Paramoera Miers, 1875	Animalia|Arthropoda|Malacostraca|Amphipoda|Eusiridae|Paramoera||Paramoera Miers, 1875	10
Festuca L.	Plantae|Tracheophyta|Liliopsida|Poales|Poaceae|Festuca||Festuca L.	10
Cotula L.	Plantae|Magnoliophyta|Magnoliopsida|Asterales|Asteraceae|Cotula||Cotula L.	10
Parawaldeckia kidderi Lowry & Stoddard, 1983	Animalia|Arthropoda|Malacostraca|Amphipoda|Lysianassidae|Parawaldeckia|kidderi|Parawaldeckia kidderi Lowry & Stoddard, 1983	10
Polypodium vulgare var. eatonii Bak.	Plantae|Tracheophyta|Polypodiopsida|Polypodiales|Polypodiaceae|Polypodium|vulgare|Polypodium vulgare var. eatonii Bak.	10
Cerastium holosteoides Fr.	Plantae|Tracheophyta|Magnoliopsida|Caryophyllales|Caryophyllaceae|Cerastium|holosteoides|Cerastium holosteoides Fr.	10
Polycheria gracilipes Schellenberg, 1931	Animalia|Arthropoda|Malacostraca|Amphipoda|Dexaminidae|Polycheria|gracilipes|Polycheria gracilipes Schellenberg, 1931	10
Ceradocopsis kergueleni Schellenberg, 1926	Animalia|Arthropoda|Malacostraca|Amphipoda|Melitidae|Ceradocopsis|kergueleni|Ceradocopsis kergueleni Schellenberg, 1926	10
Cerastium holosteoides auct. non Fr.	Plantae|Magnoliophyta|Magnoliopsida|Caryophyllales|Caryophyllaceae|Cerastium|holosteoides|Cerastium holosteoides auct. non Fr.	10
Juncus scheuchzerioides Gaudich.	Plantae|Magnoliophyta|Liliopsida|Poales|Juncaceae|Juncus|scheuchzerioides|Juncus scheuchzerioides Gaudich.	9
Limosella australis R. Br.	Plantae|Magnoliophyta|Magnoliopsida|Lamiales|Plantaginaceae|Limosella|australis|Limosella australis R. Br.	9
Limosella australis R. Br.	Plantae|Tracheophyta|Magnoliopsida|Lamiales|Scrophulariaceae|Limosella|australis|Limosella australis R. Br.	9
Sagina procumbens L.	Plantae|Tracheophyta|Magnoliopsida|Caryophyllales|Caryophyllaceae|Sagina|procumbens|Sagina procumbens L.	9
Pertusaria perrimosa Nyl.	Fungi|Ascomycota|Lecanoromycetes|Pertusariales|Pertusariaceae|Pertusaria|perrimosa|Pertusaria perrimosa Nyl.	9
Polypodium vulgare auct. non L.	Plantae|Pteridophyta|Polypodiopsida|Polypodiales|Polypodiaceae|Polypodium|vulgare|Polypodium vulgare auct. non L.	9
Juncus scheuchzerioides Gaudich.	Plantae|Tracheophyta|Liliopsida|Poales|Juncaceae|Juncus|scheuchzerioides|Juncus scheuchzerioides Gaudich.	9
Psilopilum Brid.	Plantae|Bryophyta|Bryopsida|Polytrichales|Polytrichaceae|Psilopilum||Psilopilum Brid.	9
Aulacomya ater (Molina, 1782)	Animalia|Mollusca|Bivalvia|Mytiloida|Mytilidae|Aulacomya|ater|Aulacomya ater (Molina, 1782)	9
Grimmia Hedw.	Plantae|Bryophyta|Bryopsida|Grimmiales|Grimmiaceae|Grimmia||Grimmia Hedw.	9
Callitriche antarctica Engelm. ex Hegelm.	Plantae|Tracheophyta|Magnoliopsida|Lamiales|Plantaginaceae|Callitriche|antarctica|Callitriche antarctica Engelm. ex Hegelm.	9
Eudyptes chrysolophus (Brandt, 1837)	Animalia|Chordata|Aves|Sphenisciformes|Spheniscidae|Eudyptes|chrysolophus|Eudyptes chrysolophus (Brandt, 1837)	9
Hymenophyllum peltatum (Poir.) Desv.	Plantae|Pteridophyta|Polypodiopsida|Hymenophyllales|Hymenophyllaceae|Hymenophyllum|peltatum|Hymenophyllum peltatum (Poir.) Desv.	9
Bucklandiella didyma (Mont.) Bednarek-Ochyra & Ochyra	Plantae|Bryophyta|Bryopsida|Grimmiales|Grimmiaceae|Racomitrium|didyma|Bucklandiella didyma (Mont.) Bednarek-Ochyra & Ochyra	8
Azorella Lam.	Plantae|Tracheophyta|Magnoliopsida|Apiales|Apiaceae|Azorella||Azorella Lam.	8
Macronectes giganteus (Gmelin, 1789)	Animalia|Chordata|Aves|Procellariiformes|Procellariidae|Macronectes|giganteus|Macronectes giganteus (Gmelin, 1789)	8
Cerastium L.	Plantae|Tracheophyta|Magnoliopsida|Caryophyllales|Caryophyllaceae|Cerastium||Cerastium L.	8
Stomacontion acutibasalis (Bellan-Santini & Ledoyer, 1974)	Animalia|Arthropoda|Malacostraca|Amphipoda|Lysianassidae|Stomacontion|acutibasalis|Stomacontion acutibasalis (Bellan-Santini & Ledoyer, 1974)	8
Hippomedon kergueleni (Miers, 1875)	Animalia|Arthropoda|Malacostraca|Amphipoda|Lysianassidae|Hippomedon|kergueleni|Hippomedon kergueleni (Miers, 1875)	8
Cerastium glomeratum Thuill.	Plantae|Tracheophyta|Magnoliopsida|Caryophyllales|Caryophyllaceae|Cerastium|glomeratum|Cerastium glomeratum Thuill.	8
Festuca contracta Kirk	Plantae|Tracheophyta|Liliopsida|Poales|Poaceae|Festuca|contracta|Festuca contracta Kirk	8
Stauroneis Ehrenberg, 1843	Chromista|Ochrophyta|Bacillariophyceae|Naviculales|Stauroneidaceae|Stauroneis||Stauroneis Ehrenberg, 1843	8
Stauroneis Ehrenberg	Plantae|Bacillariophyta|Bacillariophyceae|Naviculales|Stauroneidaceae|Stauroneis||Stauroneis Ehrenberg	8
Amphiura antarctica Studer, 1876	Animalia|Echinodermata|Ophiuroidea|Ophiurida|Amphiuridae|Amphiura|antarctica|Amphiura antarctica Studer, 1876	8
Azorella Lam.	Plantae|Magnoliophyta|Magnoliopsida|Apiales|Apiaceae|Azorella||Azorella Lam.	8
Mycale acerata Kirkpatrick, 1907	Animalia|Porifera|Demospongiae|Poecilosclerida|Mycalidae|Mycale|acerata|Mycale acerata Kirkpatrick, 1907	8
Amphora C.G. Ehrenberg ex Kützing, 1844	Plantae|Bacillariophyta|Bacillariophyceae|Thalassiophysales|Catenulaceae|Amphora||Amphora C.G. Ehrenberg ex Kützing, 1844	8
Aora kergueleni Stebbing, 1888	Animalia|Arthropoda|Malacostraca|Amphipoda|Aoridae|Aora|kergueleni|Aora kergueleni Stebbing, 1888	8
Cerastium glomeratum Thuill.	Plantae|Magnoliophyta|Magnoliopsida|Caryophyllales|Caryophyllaceae|Cerastium|glomeratum|Cerastium glomeratum Thuill.	8
Philonotis Brid.	Plantae|Bryophyta|Bryopsida|Bryales|Bartramiaceae|Philonotis||Philonotis Brid.	8
Amphora Ehrenberg ex Kützing, 1844	Chromista|Ochrophyta|Bacillariophyceae|Thalassiophysales|Catenulaceae|Amphora||Amphora Ehrenberg ex Kützing, 1844	8
Festuca contracta Kirk	Plantae|Magnoliophyta|Liliopsida|Poales|Poaceae|Festuca|contracta|Festuca contracta Kirk	8
Pachyptila belcheri (Mathews, 1912)	Animalia|Chordata|Aves|Procellariiformes|Procellariidae|Pachyptila|belcheri|Pachyptila belcheri (Mathews, 1912)	8
Willia calobolax Lightowlers, 1985	Plantae|Bryophyta|Bryopsida|Pottiales|Pottiaceae|Willia|calobolax|Willia calobolax Lightowlers, 1985	8
Mirounga leonina (Linnaeus, 1758)	Animalia|Chordata|Mammalia|Carnivora|Phocidae|Mirounga|leonina|Mirounga leonina (Linnaeus, 1758)	8
Hymenophyllum Sm.	Plantae|Tracheophyta|Polypodiopsida|Hymenophyllales|Hymenophyllaceae|Hymenophyllum||Hymenophyllum Sm.	7
Hymenophyllum Sm.	Plantae|Pteridophyta|Polypodiopsida|Hymenophyllales|Hymenophyllaceae|Hymenophyllum||Hymenophyllum Sm.	7
Sagina procumbens L.	Plantae|Magnoliophyta|Magnoliopsida|Caryophyllales|Caryophyllaceae|Sagina|procumbens|Sagina procumbens L.	7
Cerastium L.	Plantae|Magnoliophyta|Magnoliopsida|Caryophyllales|Caryophyllaceae|Cerastium||Cerastium L.	7
Stellaria media (L.) Vill.	Plantae|Tracheophyta|Magnoliopsida|Caryophyllales|Caryophyllaceae|Stellaria|media|Stellaria media (L.) Vill.	7
Abatus cordatus (Verrill, 1876)	Animalia|Echinodermata|Echinoidea|Spatangoida|Schizasteridae|Abatus|cordatus|Abatus cordatus (Verrill, 1876)	7
Chlanidota vestita (Martens, 1878)	Animalia|Mollusca|Gastropoda|Neogastropoda|Buccinidae|Chlanidota|vestita|Chlanidota vestita (Martens, 1878)	7
Caloneis P. T. Cleve	Plantae|Bacillariophyta|Bacillariophyceae|Naviculales|Naviculaceae|Caloneis||Caloneis P. T. Cleve	7
Poa L.	Plantae|Tracheophyta|Liliopsida|Poales|Poaceae|Poa||Poa L.	7
Caloneis P.Cleve, 1894	Chromista|Ochrophyta|Bacillariophyceae|Naviculales|Naviculaceae|Caloneis||Caloneis P.Cleve, 1894	7
Poa L.	Plantae|Magnoliophyta|Liliopsida|Poales|Poaceae|Poa||Poa L.	7
Bryoerythrophyllum Chen	Plantae|Bryophyta|Bryopsida|Pottiales|Pottiaceae|Bryoerythrophyllum||Bryoerythrophyllum Chen	7
Haliclona topsenti (Thiele, 1905)	Animalia|Porifera|Demospongiae|Haplosclerida|Chalinidae|Haliclona|topsenti|Haliclona topsenti (Thiele, 1905)	6
Dicranoweisia grimmiacea Brotherus, 1901	Plantae|Bryophyta|Bryopsida|Dicranales|Dicranaceae|Dicranoweisia|grimmiacea|Dicranoweisia grimmiacea Brotherus, 1901	6
Pachyptila desolata (Gmelin, 1789)	Animalia|Chordata|Aves|Procellariiformes|Procellariidae|Pachyptila|desolata|Pachyptila desolata (Gmelin, 1789)	6
Stellaria media (L.) Vill.	Plantae|Magnoliophyta|Magnoliopsida|Caryophyllales|Caryophyllaceae|Stellaria|media|Stellaria media (L.) Vill.	6
Nymphon gracilipes Miers, E.J., 1875	Animalia|Arthropoda|Pycnogonida||Nymphonidae|Nymphon|gracilipes|Nymphon gracilipes Miers, E.J., 1875	6
Haplocheira barbimana subsp. typica Haswell, 1879	Animalia|Arthropoda|Malacostraca|Amphipoda|Aoridae|Haplocheira|barbimana|Haplocheira barbimana subsp. typica Haswell, 1879	6
Thalassarche chrysostoma (J. R. Forster, 1785)	Animalia|Chordata|Aves|Procellariiformes|Diomedeidae|Thalassarche|chrysostoma|Thalassarche chrysostoma (J. R. Forster, 1785)	6
Spinoserolis latifrons (White, 1847)	Animalia|Arthropoda|Malacostraca|Isopoda|Serolidae|Spinoserolis|latifrons|Spinoserolis latifrons (White, 1847)	6
Psilopilum trichodon (Hook. f. & Wilson) Mitt.	Plantae|Bryophyta|Bryopsida|Polytrichales|Polytrichaceae|Notoligotrichum|trichodon|Psilopilum trichodon (Hook. f. & Wilson) Mitt.	6
Parborlasia corrugatus (McIntosh, 1876)	Animalia|Nemertea|Anopla||Lineidae|Parborlasia|corrugatus|Parborlasia corrugatus (McIntosh, 1876)	6
Haplocheira barbimana typica Haswell, 1879	Animalia|Arthropoda|Malacostraca|Amphipoda|Aoridae|Haplocheira|barbimana|Haplocheira barbimana typica Haswell, 1879	6
Tetilla leptoderma Sollas, 1886	Animalia|Porifera|Demospongiae|Tetractinellida|Tetillidae|Tetilla|leptoderma|Tetilla leptoderma Sollas, 1886	6
Probolisca ovata (Stebbing, 1888)	Animalia|Arthropoda|Malacostraca|Amphipoda|Stenothoidae|Probolisca|ovata|Probolisca ovata (Stebbing, 1888)	6
Abyssorchomene De Broyer, 1984	Animalia|Arthropoda|Malacostraca|Amphipoda|Uristidae|Abyssorchomene||Abyssorchomene De Broyer, 1984	6
Pringlea W.Anderson ex Hook.f.	Plantae|Magnoliophyta|Magnoliopsida|Brassicales|Brassicaceae|Pringlea||Pringlea W.Anderson ex Hook.f.	6
Tetilla leptoderma Sollas, 1886	Animalia|Porifera|Demospongiae|Spirophorida|Tetillidae|Tetilla|leptoderma|Tetilla leptoderma Sollas, 1886	6
Agrostis L.	Plantae|Magnoliophyta|Liliopsida|Poales|Poaceae|Agrostis||Agrostis L.	6
Urothoides lachneessa (Stebbing, 1888)	Animalia|Arthropoda|Malacostraca|Amphipoda|Urothoidae|Urothoides|lachneessa|Urothoides lachneessa (Stebbing, 1888)	6
Luticola D.G. Mann in F.E. Round, R.M. Crawford & D.G. Mann, 1990	Plantae|Bacillariophyta|Bacillariophyceae|Naviculales|Diadesmidaceae|Luticola||Luticola D.G. Mann in F.E. Round, R.M. Crawford & D.G. Mann, 1990	6
Carolobatea schneideri (Stebbing, 1888)	Animalia|Arthropoda|Malacostraca|Amphipoda|Oedicerotidae|Carolobatea|schneideri|Carolobatea schneideri (Stebbing, 1888)	6
Brachythecium Schimp. in B.S.G.	Plantae|Bryophyta|Bryopsida|Hypnales|Brachytheciaceae|Brachythecium||Brachythecium Schimp. in B.S.G.	6
Crassula L.	Plantae|Tracheophyta|Magnoliopsida|Saxifragales|Crassulaceae|Crassula||Crassula L.	6
Tortula J. Hedwig, 1801	Plantae|Bryophyta|Bryopsida|Pottiales|Pottiaceae|Tortula||Tortula J. Hedwig, 1801	6
Bunodactis vanhoeffeni Pax, 1922	Animalia|Cnidaria|Anthozoa|Actiniaria|Actiniidae|Parantheopsis|vanhoeffeni|Bunodactis vanhoeffeni Pax, 1922	6
Luticola D.G.Mann, 1990	Chromista|Ochrophyta|Bacillariophyceae|Naviculales|Diadesmidaceae|Luticola||Luticola D.G.Mann, 1990	6
Metopoides Della Valle, 1893	Animalia|Arthropoda|Malacostraca|Amphipoda|Stenothoidae|Metopoides||Metopoides Della Valle, 1893	6
Tortula geheebiaeopsis (Müll. Hal.) Broth.	Plantae|Bryophyta|Bryopsida|Pottiales|Pottiaceae|Syntrichia|geheebiaeopsis|Tortula geheebiaeopsis (Müll. Hal.) Broth.	6
Tryphosella Bonnier, 1893	Animalia|Arthropoda|Malacostraca|Amphipoda|Lysianassidae|Tryphosella||Tryphosella Bonnier, 1893	6
Anatalanta aptera Eaton, 1875	Animalia|Arthropoda|Insecta|Diptera|Sphaeroceridae|Anatalanta|aptera|Anatalanta aptera Eaton, 1875	6
Colomastix fissilingua Schellenberg, 1926	Animalia|Arthropoda|Malacostraca|Amphipoda|Colomastigidae|Colomastix|fissilingua|Colomastix fissilingua Schellenberg, 1926	6
Vittia pachyloma Ochyra, 1987	Plantae|Bryophyta|Bryopsida|Hypnales|Amblystegiaceae|Vittia|pachyloma|Vittia pachyloma Ochyra, 1987	6
Tryphosella trigonica (Stebbing, 1888)	Animalia|Arthropoda|Malacostraca|Amphipoda|Lysianassidae|Tryphosella|trigonica|Tryphosella trigonica (Stebbing, 1888)	6
Brachythecium Schimp.	Plantae|Bryophyta|Bryopsida|Hypnales|Brachytheciaceae|Brachythecium||Brachythecium Schimp.	6
Orthotrichum Hedw.	Plantae|Bryophyta|Bryopsida|Orthotrichales|Orthotrichaceae|Orthotrichum||Orthotrichum Hedw.	6
Harpinioides drepanocheir Stebbing, 1888	Animalia|Arthropoda|Malacostraca|Amphipoda|Calliopiidae|Harpinioides|drepanocheir|Harpinioides drepanocheir Stebbing, 1888	6
Leuconia joubini (Topsent, 1907)	Animalia|Porifera|Calcarea|Baerida|Baeriidae|Leuconia|joubini|Leuconia joubini (Topsent, 1907)	6
Pringlea W. Anderson ex Hook. f.	Plantae|Tracheophyta|Magnoliopsida|Brassicales|Brassicaceae|Pringlea||Pringlea W. Anderson ex Hook. f.	6
Agrostis antarctica Hook. f.	Plantae|Magnoliophyta|Liliopsida|Poales|Poaceae|Agrostis|antarctica|Agrostis antarctica Hook. f.	6
Exosphaeroma gigas (Leach, 1818)	Animalia|Arthropoda|Malacostraca|Isopoda|Sphaeromatidae|Exosphaeroma|gigas|Exosphaeroma gigas (Leach, 1818)	6
Aerothyris kerguelenensis (Davidson, 1878)	Animalia|Brachiopoda|Rhynchonellata|Terebratulida|Terebratellidae|Aerothyris|kerguelenensis|Aerothyris kerguelenensis (Davidson, 1878)	6
Halcampa purpurea Stud.	Animalia|Cnidaria|Anthozoa|Actiniaria|Halcampoididae|Halcampoides|purpurea|Halcampa purpurea Stud.	6
Agrostis L.	Plantae|Tracheophyta|Liliopsida|Poales|Poaceae|Agrostis||Agrostis L.	6
Agrostis antarctica Hook.f.	Plantae|Tracheophyta|Liliopsida|Poales|Poaceae|Agrostis|antarctica|Agrostis antarctica Hook.f.	6
Gaimardiidae Hedley, 1916	Animalia|Mollusca|Bivalvia|Veneroida|Gaimardiidae|||Gaimardiidae Hedley, 1916	6
Rossella antarctica Carter, 1872	Animalia|Porifera|Hexactinellida|Lyssacinosida|Rossellidae|Rossella|antarctica|Rossella antarctica Carter, 1872	6
Eudyptes crestatus (J. F. Miller, 1784)	Animalia|Chordata|Aves|Sphenisciformes|Spheniscidae|Eudyptes|crestatus|Eudyptes crestatus (J. F. Miller, 1784)	6
Taraxacum F. H. Wigg.	Plantae|Tracheophyta|Magnoliopsida|Asterales|Asteraceae|Taraxacum||Taraxacum F. H. Wigg.	5
Hantzschia Grunow, 1877	Chromista|Ochrophyta|Bacillariophyceae|Bacillariales|Bacillariaceae|Hantzschia||Hantzschia Grunow, 1877	5
Pottia Fürnrohr, 1829	Plantae|Bryophyta|Bryopsida|Pottiales|Pottiaceae|Pottia||Pottia Fürnrohr, 1829	5
Ptychostomum pseudotriquetrum (Hedw.) J.R. Spence & H.P. Ramsay	Plantae|Bryophyta|Bryopsida|Bryales|Bryaceae|Plagiobryum|pseudotriquetrum|Ptychostomum pseudotriquetrum (Hedw.) J.R. Spence & H.P. Ramsay	5
Encyonema Kützing, 1834	Chromista|Ochrophyta|Bacillariophyceae|Cymbellales|Cymbellaceae|Encyonema||Encyonema Kützing, 1834	5
Grimmia bossierei Cardot & Thér.	Plantae|Bryophyta|Bryopsida|Grimmiales|Grimmiaceae|Grimmia|bossierei|Grimmia bossierei Cardot & Thér.	5
Encyonema Kütz.	Plantae|Bacillariophyta|Bacillariophyceae|Cymbellales|Cymbellaceae|Encyonema||Encyonema Kütz.	5
Pottia (Reichenb.) Fürnr.	Plantae|Bryophyta|Bryopsida|Pottiales|Pottiaceae|Pottia||Pottia (Reichenb.) Fürnr.	5
Philonotis scabrifolia Braithwaite, 1893	Plantae|Bryophyta|Bryopsida|Bryales|Bartramiaceae|Philonotis|scabrifolia|Philonotis scabrifolia Braithwaite, 1893	5
Tortula sabinae C. C. Townsend, 1984	Plantae|Bryophyta|Bryopsida|Pottiales|Pottiaceae|Tortula|sabinae|Tortula sabinae C. C. Townsend, 1984	5
Festuca erecta (Huds.) Wallr.	Plantae|Magnoliophyta|Liliopsida|Poales|Poaceae|Bromus|erecta|Festuca erecta (Huds.) Wallr.	5
Tortula arenae (Besch.) Broth.	Plantae|Bryophyta|Bryopsida|Pottiales|Pottiaceae|Barbula|arenae|Tortula arenae (Besch.) Broth.	5
Bacillariophyceae Haeckel, 1878	Plantae|Bacillariophyta|Bacillariophyceae|||||Bacillariophyceae Haeckel, 1878	5
Nemertopsella marri Wheeler, 1940	Animalia|Nemertea|Enopla|Monostilifera|Emplectonematidae|Nemertopsella|marri|Nemertopsella marri Wheeler, 1940	5
Hantzschia Grunow, 1877	Plantae|Bacillariophyta|Bacillariophyceae|Bacillariales|Bacillariaceae|Hantzschia||Hantzschia Grunow, 1877	5
Parborlasia corrugatus (McIntosh, 1876)	Animalia|Nemertea|Anopla||Cerebratulidae|Parborlasia|corrugatus|Parborlasia corrugatus (McIntosh, 1876)	5
Cinachyra barbata Sollas, 1886	Animalia|Porifera|Demospongiae|Spirophorida|Tetillidae|Cinachyra|barbata|Cinachyra barbata Sollas, 1886	5
Taraxacum Zinn, 1757	Plantae|Magnoliophyta|Magnoliopsida|Asterales|Asteraceae|Taraxacum||Taraxacum Zinn, 1757	5
Hymenoloma antarcticum (Müll. Hal.) Ochyra	Plantae|Bryophyta|Bryopsida|Dicranales|Dicranaceae|Hymenoloma|antarcticum|Hymenoloma antarcticum (Müll. Hal.) Ochyra	5
Frustulia Rabenhorst, 1853	Chromista|Ochrophyta|Bacillariophyceae|Naviculales|Amphipleuraceae|Frustulia||Frustulia Rabenhorst, 1853	5
Oceanites oceanicus (Kuhl, 1820)	Animalia|Chordata|Aves|Procellariiformes|Hydrobatidae|Oceanites|oceanicus|Oceanites oceanicus (Kuhl, 1820)	5
Notothenia cyanobrancha Richardson, 1844	Animalia|Chordata|Actinopterygii|Perciformes|Nototheniidae|Notothenia|cyanobrancha|Notothenia cyanobrancha Richardson, 1844	5
Geissleria Lange-Bertalot & Metzeltin, 1996	Chromista|Ochrophyta|Bacillariophyceae|Naviculales|Naviculaceae|Geissleria||Geissleria Lange-Bertalot & Metzeltin, 1996	5
Geissleria Lange-Bert. & Metzeltin	Plantae|Bacillariophyta|Bacillariophyceae|Naviculales|Naviculaceae|Geissleria||Geissleria Lange-Bert. & Metzeltin	5
Cinachyra barbata Sollas, 1886	Animalia|Porifera|Demospongiae|Tetractinellida|Tetillidae|Cinachyra|barbata|Cinachyra barbata Sollas, 1886	5
Thalassarche melanophrys (Temminck, 1828)	Animalia|Chordata|Aves|Procellariiformes|Diomedeidae|Thalassarche|melanophrys|Thalassarche melanophrys (Temminck, 1828)	5
Pellilitorina setosa (E.A. Smith, 1875)	Animalia|Mollusca|Gastropoda|Neotaenioglossa|Littorinidae|Pellilitorina|setosa|Pellilitorina setosa (E.A. Smith, 1875)	4
Perissodonta mirabilis (Smith, 1875)	Animalia|Mollusca|Gastropoda|Neotaenioglossa|Struthiolariidae|Perissodonta|mirabilis|Perissodonta mirabilis (Smith, 1875)	4
Cylindryllioides mawsoni Nicholls, 1938	Animalia|Arthropoda|Malacostraca|Amphipoda|Eophliantidae|Cylindryllioides|mawsoni|Cylindryllioides mawsoni Nicholls, 1938	4
Sophrosyne murrayi Stebbing, 1888	Animalia|Arthropoda|Malacostraca|Amphipoda|Uristidae|Sophrosyne|murrayi|Sophrosyne murrayi Stebbing, 1888	4
Mollusca	Animalia|Mollusca||||||Mollusca	4
Paradmete fragillima (Watson, 1882)	Animalia|Mollusca|Gastropoda|Neogastropoda|Volutomitridae|Paradmete|fragillima|Paradmete fragillima (Watson, 1882)	4
Gondogeneia simplex (Dana, 1852)	Animalia|Arthropoda|Malacostraca|Amphipoda|Eusiridae|Gondogeneia|simplex|Gondogeneia simplex (Dana, 1852)	4
Eusirus Krøyer, 1845	Animalia|Arthropoda|Malacostraca|Amphipoda|Eusiridae|Eusirus||Eusirus Krøyer, 1845	4
Antatelson rostratum Bellan-Santini & Ledoyer, 1974	Animalia|Arthropoda|Malacostraca|Amphipoda|Stenothoidae|Antatelson|rostratum|Antatelson rostratum Bellan-Santini & Ledoyer, 1974	4
Aora trichobostrycha Stebbing, 1888	Animalia|Arthropoda|Malacostraca|Amphipoda|Aoridae|Aora|trichobostrycha|Aora trichobostrycha Stebbing, 1888	4
Leucothoe spinicarpa Abildgaard, 1789	Animalia|Arthropoda|Malacostraca|Amphipoda|Leucothoidae|Leucothoe|spinicarpa|Leucothoe spinicarpa Abildgaard, 1789	4
Labidiaster annulatus Sladen, 1889	Animalia|Echinodermata|Asteroidea|Forcipulatida|Heliasteridae|Labidiaster|annulatus|Labidiaster annulatus Sladen, 1889	4
Pohlia cruda Lindberg, 1879	Plantae|Bryophyta|Bryopsida|Bryales|Bryaceae|Pohlia|cruda|Pohlia cruda Lindberg, 1879	4
Philonotis polymorpha Kindberg, 1889	Plantae|Bryophyta|Bryopsida|Bryales|Bartramiaceae|Philonotis|polymorpha|Philonotis polymorpha Kindberg, 1889	4
Syntrichia saxicola Zander, 1993	Plantae|Bryophyta|Bryopsida|Pottiales|Pottiaceae|Syntrichia|saxicola|Syntrichia saxicola Zander, 1993	4
Dicranoweisia Lindb. ex Milde	Plantae|Bryophyta|Bryopsida|Dicranales|Dicranaceae|Dicranoweisia||Dicranoweisia Lindb. ex Milde	4
Sinuber sculptum (Martens, 1878)	Animalia|Mollusca|Gastropoda|Littorinimorpha|Naticidae|Sinuber|sculptum|Sinuber sculptum (Martens, 1878)	4
Eatoniella kerguelenensis (E. A. Smith, 1875)	Animalia|Mollusca|Gastropoda|Littorinimorpha|Eatoniellidae|Eatoniella|kerguelenensis|Eatoniella kerguelenensis (E. A. Smith, 1875)	4
Iais pubescens (Dana, 1852)	Animalia|Arthropoda|Malacostraca|Isopoda|Janiridae|Iais|pubescens|Iais pubescens (Dana, 1852)	4
Steinera glaucella (Tuck.) C.W. Dodge	Fungi|Ascomycota|Lecanoromycetes|Peltigerales|Coccocarpiaceae|Steinera|glaucella|Steinera glaucella (Tuck.) C.W. Dodge	4
Iais pubescens (Dana, 1853)	Animalia|Arthropoda|Malacostraca|Isopoda|Janiridae|Iais|pubescens|Iais pubescens (Dana, 1853)	4
Lasaea consanguinea (E. A. Smith, 1879)	Animalia|Mollusca|Bivalvia|Veneroida|Lasaeidae|Lasaea|consanguinea|Lasaea consanguinea (E. A. Smith, 1879)	4
Ampithoe kergueleni Stebbing, 1888	Animalia|Arthropoda|Malacostraca|Amphipoda|Ampithoidae|Ampithoe|kergueleni|Ampithoe kergueleni Stebbing, 1888	4
Antatelson antennatum Bellan-Santini & Ledoyer, 1974	Animalia|Arthropoda|Malacostraca|Amphipoda|Stenothoidae|Antatelson|antennatum|Antatelson antennatum Bellan-Santini & Ledoyer, 1974	4
Gammaropsis kergueleni (Schellenberg, 1926)	Animalia|Arthropoda|Malacostraca|Amphipoda|Isaeidae|Gammaropsis|kergueleni|Gammaropsis kergueleni (Schellenberg, 1926)	4
Photis macrocarpa Stebbing, 1888	Animalia|Arthropoda|Malacostraca|Amphipoda|Isaeidae|Photis|macrocarpa|Photis macrocarpa Stebbing, 1888	4
Rhopalodia O. Müll.	Plantae|Bacillariophyta|Bacillariophyceae|Rhopalodiales|Rhopalodiaceae|Rhopalodia||Rhopalodia O. Müll.	4
Amauropsis prasina (Watson, 1881)	Animalia|Mollusca|Gastropoda|Neotaenioglossa|Naticidae|Amauropsis|prasina|Amauropsis prasina (Watson, 1881)	4
Perissodonta mirabilis (E. A. Smith, 1875)	Animalia|Mollusca|Gastropoda|Littorinimorpha|Struthiolariidae|Perissodonta|mirabilis|Perissodonta mirabilis (E. A. Smith, 1875)	4
Poa angustifolia L.	Plantae|Tracheophyta|Liliopsida|Poales|Poaceae|Poa|angustifolia|Poa angustifolia L.	4
Eatoniella kerguelenensis (Smith, 1875)	Animalia|Mollusca|Gastropoda|Neotaenioglossa|Eatoniellidae|Eatoniella|kerguelenensis|Eatoniella kerguelenensis (Smith, 1875)	4
Andreaea flabellata C. Müller, 1883	Plantae|Bryophyta|Andreaeopsida|Andreaeales|Andreaeaceae|Andreaea|flabellata|Andreaea flabellata C. Müller, 1883	4
Calyx kerguelensis (Hentschel, 1914)	Animalia|Porifera|Demospongiae|Haplosclerida|Phloeodictyidae|Calyx|kerguelensis|Calyx kerguelensis (Hentschel, 1914)	4
Admete specularis (Watson, 1882)	Animalia|Mollusca|Gastropoda|Neogastropoda|Cancellariidae|Admete|specularis|Admete specularis (Watson, 1882)	4
Iophon proximum var. reticulare Hentschel, 1914	Animalia|Porifera|Demospongiae|Poecilosclerida|Acarnidae|Iophon|proximum|Iophon proximum var. reticulare Hentschel, 1914	4
Eusirus antarcticus Thomson, 1880	Animalia|Arthropoda|Malacostraca|Amphipoda|Eusiridae|Eusirus|antarcticus|Eusirus antarcticus Thomson, 1880	4
Neobuccinum eatoni (Smith, 1875)	Animalia|Mollusca|Gastropoda|Neogastropoda|Buccinidae|Neobuccinum|eatoni|Neobuccinum eatoni (Smith, 1875)	4
Steinera glaucella (Tuck.) Dodge	Fungi|Ascomycota|Lecanoromycetes|Peltigerales|Coccocarpiaceae|Steinera|glaucella|Steinera glaucella (Tuck.) Dodge	4
Hygroamblystegium Loeske	Plantae|Bryophyta|Bryopsida|Hypnales|Amblystegiaceae|Hygroamblystegium||Hygroamblystegium Loeske	4
Pseudharpinia obtusifrons (Stebbing, 1888)	Animalia|Arthropoda|Malacostraca|Amphipoda|Phoxocephalidae|Pseudharpinia|obtusifrons|Pseudharpinia obtusifrons (Stebbing, 1888)	4
Festuca L.	Plantae|Magnoliophyta|Liliopsida|Poales|Poaceae|Festuca||Festuca L.	4
Neobuccinum eatoni (E. A. Smith, 1875)	Animalia|Mollusca|Gastropoda|Neogastropoda|Buccinidae|Neobuccinum|eatoni|Neobuccinum eatoni (E. A. Smith, 1875)	4
Aira antarctica Hook.	Plantae|Tracheophyta|Liliopsida|Poales|Poaceae|Deschampsia|antarctica|Aira antarctica Hook.	4
Bucklandiella pachydictyon (Cardot) Bednarek-Ochyra & Ochyra	Plantae|Bryophyta|Bryopsida|Grimmiales|Grimmiaceae|Racomitrium|pachydictyon|Bucklandiella pachydictyon (Cardot) Bednarek-Ochyra & Ochyra	4
Colobanthus Bartling, 1830	Plantae|Magnoliophyta|Magnoliopsida|Caryophyllales|Caryophyllaceae|Colobanthus||Colobanthus Bartling, 1830	4
Pareuthria regulus (Watson, 1882)	Animalia|Mollusca|Gastropoda|Neogastropoda|Buccinidae|Pareuthria|regulus|Pareuthria regulus (Watson, 1882)	4
Schistidium Brid., 1819	Plantae|Bryophyta|Bryopsida|Grimmiales|Grimmiaceae|Schistidium||Schistidium Brid., 1819	4
Stegocephalina pacis (Bellan-Santini & Ledoyer, 1974)	Animalia|Arthropoda|Malacostraca|Amphipoda|Stegocephalidae|Stegocephalina|pacis|Stegocephalina pacis (Bellan-Santini & Ledoyer, 1974)	4
Notothenia Richardson, 1844	Animalia|Chordata|Actinopterygii|Perciformes|Nototheniidae|Notothenia||Notothenia Richardson, 1844	4
Iophon flabellodigitatum var. gaussi Hentschel, 1914	Animalia|Porifera|Demospongiae|Poecilosclerida|Acarnidae|Iophon|flabellodigitatum|Iophon flabellodigitatum var. gaussi Hentschel, 1914	4
Rhopalodia Otto Müller, 1895	Chromista|Ochrophyta|Bacillariophyceae|Rhopalodiales|Rhopalodiaceae|Rhopalodia||Rhopalodia Otto Müller, 1895	4
Halcampoides kerguelensis Pax, 1922	Animalia|Cnidaria|Anthozoa|Actiniaria|Halcampoididae|Halcampoides|kerguelensis|Halcampoides kerguelensis Pax, 1922	4
Schistidium Bruch & Schimper in Bruch, Schimper & Gümbel, 1845	Plantae|Bryophyta|Bryopsida|Grimmiales|Grimmiaceae|Schistidium||Schistidium Bruch & Schimper in Bruch, Schimper & Gümbel, 1845	4
Rhachotropis kergueleni Stebbing, 1888	Animalia|Arthropoda|Malacostraca|Amphipoda|Eusiridae|Rhachotropis|kergueleni|Rhachotropis kergueleni Stebbing, 1888	4
Drepanopus pectinatus Brady, 1883	Animalia|Arthropoda|Maxillopoda|Calanoida|Clausocalanidae|Drepanopus|pectinatus|Drepanopus pectinatus Brady, 1883	4
Syntrichia anderssonii Zander, 1993	Plantae|Bryophyta|Bryopsida|Pottiales|Pottiaceae|Syntrichia|anderssonii|Syntrichia anderssonii Zander, 1993	4
Aira antarctica Hook.	Plantae|Magnoliophyta|Liliopsida|Poales|Poaceae|Deschampsia|antarctica|Aira antarctica Hook.	4
Racomitrium lanuginosum Bridel, 1819	Plantae|Bryophyta|Bryopsida|Grimmiales|Grimmiaceae|Racomitrium|lanuginosum|Racomitrium lanuginosum Bridel, 1819	4
Laevilitorina caliginosa (Gould, 1849)	Animalia|Mollusca|Gastropoda|Littorinimorpha|Littorinidae|Laevilitorina|caliginosa|Laevilitorina caliginosa (Gould, 1849)	4
Aora anomala Schellenberg, 1926	Animalia|Arthropoda|Malacostraca|Amphipoda|Aoridae|Aora|anomala|Aora anomala Schellenberg, 1926	4
Trophon albolabratus E. A. Smith, 1875	Animalia|Mollusca|Gastropoda|Neogastropoda|Muricidae|Trophon|albolabratus|Trophon albolabratus E. A. Smith, 1875	4
Amauropsis prasina (Watson, 1881)	Animalia|Mollusca|Gastropoda|Littorinimorpha|Naticidae|Amauropsis|prasina|Amauropsis prasina (Watson, 1881)	4
Probolisca nasutigenes (Stebbing, 1888)	Animalia|Arthropoda|Malacostraca|Amphipoda|Stenothoidae|Probolisca|nasutigenes|Probolisca nasutigenes (Stebbing, 1888)	4
Spanioplon werthi (Hentschel, 1914)	Animalia|Porifera|Demospongiae|Poecilosclerida|Hymedesmiidae|Spanioplon|werthi|Spanioplon werthi (Hentschel, 1914)	4
Falsimohnia albozonata (Watson, 1886)	Animalia|Mollusca|Gastropoda|Neogastropoda|Buccinidae|Falsimohnia|albozonata|Falsimohnia albozonata (Watson, 1886)	4
Fregetta tropica (Gould, 1844)	Animalia|Chordata|Aves|Procellariiformes|Hydrobatidae|Fregetta|tropica|Fregetta tropica (Gould, 1844)	4
Leuconia primigenia (Haeckel, 1872)	Animalia|Porifera|Calcarea|Clathrinida|Leucettidae|Leucetta|primigenia|Leuconia primigenia (Haeckel, 1872)	4
Xestospongia hispida (Ridley & Dendy, 1886)	Animalia|Porifera|Demospongiae|Haplosclerida|Petrosiidae|Xestospongia|hispida|Xestospongia hispida (Ridley & Dendy, 1886)	4
Colobanthus Bartl.	Plantae|Tracheophyta|Magnoliopsida|Caryophyllales|Caryophyllaceae|Colobanthus||Colobanthus Bartl.	4
Paramoera kergueleni Bellan-Santini & Ledoyer, 1974	Animalia|Arthropoda|Malacostraca|Amphipoda|Eusiridae|Paramoera|kergueleni|Paramoera kergueleni Bellan-Santini & Ledoyer, 1974	4
Pellilitorina setosa (E. A. Smith, 1875)	Animalia|Mollusca|Gastropoda|Littorinimorpha|Littorinidae|Pellilitorina|setosa|Pellilitorina setosa (E. A. Smith, 1875)	4
Pareuthria chlorotica (Martens, 1878)	Animalia|Mollusca|Gastropoda|Neogastropoda|Buccinidae|Pareuthria|chlorotica|Pareuthria chlorotica (Martens, 1878)	4
Nacella kerguelenensis (E. A. Smith, 1877)	Animalia|Mollusca|Gastropoda||Nacellidae|Nacella|kerguelenensis|Nacella kerguelenensis (E. A. Smith, 1877)	4
Schraderia acuticauda Bellan-Santini & Ledoyer, 1974	Animalia|Arthropoda|Malacostraca|Amphipoda|Eusiridae|Schraderia|acuticauda|Schraderia acuticauda Bellan-Santini & Ledoyer, 1974	4
Caryophyllaceae	Plantae|Tracheophyta|Magnoliopsida|Caryophyllales|Caryophyllaceae|||Caryophyllaceae	4
Stomacontion pepinii (Stebbing, 1888)	Animalia|Arthropoda|Malacostraca|Amphipoda|Lysianassidae|Stomacontion|pepinii|Stomacontion pepinii (Stebbing, 1888)	4
Aplidium variabile (Herdman, 1886)	Animalia|Chordata|Ascidiacea|Enterogona|Polyclinidae|Aplidium|variabile|Aplidium variabile (Herdman, 1886)	4
Arctocephalus gazella (Peters, 1875)	Animalia|Chordata|Mammalia|Carnivora|Otariidae|Arctocephalus|gazella|Arctocephalus gazella (Peters, 1875)	4
Leucandra gaussii (Brøndsted, 1931)	Animalia|Porifera|Calcarea|Leucosolenida|Grantiidae|Leucandra|gaussii|Leucandra gaussii (Brøndsted, 1931)	4
Gammaropsis (Gammaropsis) kergueleni (Schellenberg, 1926)	Animalia|Arthropoda|Malacostraca|Amphipoda|Isaeidae|Gammaropsis|kergueleni|Gammaropsis (Gammaropsis) kergueleni (Schellenberg, 1926)	4
Cladonia pocillum (Ach.) O.J. Rich.	Fungi|Ascomycota|Lecanoromycetes|Lecanorales|Cladoniaceae|Cladonia|pocillum|Cladonia pocillum (Ach.) O.J. Rich.	4
Polycheria cristata Schellenberg, 1931	Animalia|Arthropoda|Malacostraca|Amphipoda|Dexaminidae|Polycheria|cristata|Polycheria cristata Schellenberg, 1931	4
Sinuber sculptum (Martens, 1878)	Animalia|Mollusca|Gastropoda|Neotaenioglossa|Naticidae|Sinuber|sculptum|Sinuber sculptum (Martens, 1878)	4
Polycheria intermedia Stephensen, 1947	Animalia|Arthropoda|Malacostraca|Amphipoda|Dexaminidae|Polycheria|intermedia|Polycheria intermedia Stephensen, 1947	4
Pseudokellya cardiformis (E. A. Smith, 1885)	Animalia|Mollusca|Bivalvia|Veneroida|Kelliidae|Pseudokellya|cardiformis|Pseudokellya cardiformis (E. A. Smith, 1885)	4
Andreaea Dumort.	Plantae|Bryophyta|Andreaeopsida|Andreaeales|Andreaeaceae|Andreaea||Andreaea Dumort.	3
Cardenio paurodactylus Stebbing, 1888	Animalia|Arthropoda|Malacostraca|Amphipoda|Cardenioidae|Cardenio|paurodactylus|Cardenio paurodactylus Stebbing, 1888	3
Iothia coppingeri (E. A. Smith, 1881)	Animalia|Mollusca|Gastropoda||Lepetidae|Iothia|coppingeri|Iothia coppingeri (E. A. Smith, 1881)	3
Marseniopsis pacifica Bergh, 1886	Animalia|Mollusca|Gastropoda|Littorinimorpha|Velutinidae|Marseniopsis|pacifica|Marseniopsis pacifica Bergh, 1886	3
Andreaea J. Hedwig, 1801	Plantae|Bryophyta|Andreaeopsida|Andreaeales|Andreaeaceae|Andreaea||Andreaea J. Hedwig, 1801	3
Harpagifer kerguelensis Nybelin, 1947	Animalia|Chordata|Actinopterygii|Perciformes|Harpagiferidae|Harpagifer|kerguelensis|Harpagifer kerguelensis Nybelin, 1947	3
Cocconeis Ehrenberg, 1837	Chromista|Ochrophyta|Bacillariophyceae|Achnanthales|Cocconeidaceae|Cocconeis||Cocconeis Ehrenberg, 1837	3
Malletia gigantea (E.A. Smith, 1875)	Animalia|Mollusca|Bivalvia|Nuculoida|Malletiidae|Malletia|gigantea|Malletia gigantea (E.A. Smith, 1875)	3
Deschampsia P. Beauv.	Plantae|Magnoliophyta|Liliopsida|Poales|Poaceae|Deschampsia||Deschampsia P. Beauv.	3
Orthoseira Thwaites, 1848	Chromista|Ochrophyta|Coscinodiscophyceae|Orthoseirales|Orthoseiraceae|Orthoseira||Orthoseira Thwaites, 1848	3
Laevilitorina caliginosa (Gould, 1849)	Animalia|Mollusca|Gastropoda|Neotaenioglossa|Littorinidae|Laevilitorina|caliginosa|Laevilitorina caliginosa (Gould, 1849)	3
Leptychaster kerguelenensis subsp. kerguelenensis	Animalia|Echinodermata|Asteroidea|Paxillosida|Astropectinidae|Leptychaster|kerguelenensis|Leptychaster kerguelenensis subsp. kerguelenensis	3
Hypnum Hedw.	Plantae|Bryophyta|Bryopsida|Hypnales|Hypnaceae|Hypnum||Hypnum Hedw.	3
Phleum pratense L.	Plantae|Tracheophyta|Liliopsida|Poales|Poaceae|Phleum|pratense|Phleum pratense L.	3
Didymodon australasiae Zander, 1978	Plantae|Bryophyta|Bryopsida|Pottiales|Pottiaceae|Didymodon|australasiae|Didymodon australasiae Zander, 1978	3
Festuca cookii Hook.f.	Plantae|Tracheophyta|Liliopsida|Poales|Poaceae|Poa|cookii|Festuca cookii Hook.f.	3
Cocconeis Ehrenberg	Plantae|Bacillariophyta|Bacillariophyceae|Acnanthales|Cocconeidaceae|Cocconeis||Cocconeis Ehrenberg	3
Laternula elliptica (King & Broderip, 1832)	Animalia|Mollusca|Bivalvia|Anomalodesmata|Laternulidae|Laternula|elliptica|Laternula elliptica (King & Broderip, 1832)	3
Capsella bursa-pastoris (L.) Medik.	Plantae|Tracheophyta|Magnoliopsida|Brassicales|Brassicaceae|Capsella|bursa-pastoris|Capsella bursa-pastoris (L.) Medik.	3
Hymeniacidon kerguelensis Hentschel, 1914	Animalia|Porifera|Demospongiae|Suberitida|Halichondriidae|Hymeniacidon|kerguelensis|Hymeniacidon kerguelensis Hentschel, 1914	3
Poa pratensis L.	Plantae|Magnoliophyta|Liliopsida|Poales|Poaceae|Poa|pratensis|Poa pratensis L.	3
Lasaea consanguinea Smith, 1879	Animalia|Mollusca|Bivalvia|Veneroida|Lasaeidae|Lasaea|consanguinea|Lasaea consanguinea Smith, 1879	3
Hymeniacidon kerguelensis Hentschel, 1914	Animalia|Porifera|Demospongiae|Halichondrida|Halichondriidae|Hymeniacidon|kerguelensis|Hymeniacidon kerguelensis Hentschel, 1914	3
Aspiciliopsis macrophthalma (Hook. f. & Taylor) B. de Lesd.	Fungi|Ascomycota|Lecanoromycetes|Agyriales|Agyriaceae|Placopsis|macrophthalma|Aspiciliopsis macrophthalma (Hook. f. & Taylor) B. de Lesd.	3
Phleum pratense L.	Plantae|Magnoliophyta|Liliopsida|Poales|Poaceae|Phleum|pratense|Phleum pratense L.	3
Poa angustifolia L.	Plantae|Magnoliophyta|Liliopsida|Poales|Poaceae|Poa|angustifolia|Poa angustifolia L.	3
Cardenio paurodactylus Stebbing, 1888	Animalia|Arthropoda|Malacostraca|Amphipoda|Synopiidae|Cardenio|paurodactylus|Cardenio paurodactylus Stebbing, 1888	3
Guembelia kidderi (James) Ochyra & Żarnowiec	Plantae|Bryophyta|Bryopsida|Grimmiales|Grimmiaceae|Grimmia|kidderi|Guembelia kidderi (James) Ochyra & Żarnowiec	3
Hypnum cupressiforme Hedwig, 1801	Plantae|Bryophyta|Bryopsida|Hypnales|Hypnaceae|Hypnum|cupressiforme|Hypnum cupressiforme Hedwig, 1801	3
Deschampsia P. Beauv.	Plantae|Tracheophyta|Liliopsida|Poales|Poaceae|Deschampsia||Deschampsia P. Beauv.	3
Onoba schraderi (Strebel, 1908)	Animalia|Mollusca|Gastropoda|Littorinimorpha|Rissoidae|Onoba|schraderi|Onoba schraderi (Strebel, 1908)	3
Cyclocardia astartoides (Martens, 1878)	Animalia|Mollusca|Bivalvia|Carditoida|Carditidae|Cyclocardia|astartoides|Cyclocardia astartoides (Martens, 1878)	3
Agrostis stolonifera L.	Plantae|Tracheophyta|Liliopsida|Poales|Poaceae|Agrostis|stolonifera|Agrostis stolonifera L.	3
Rissoella notabilis (Thiele, 1912)	Animalia|Mollusca|Gastropoda|Heterostropha|Rissoellidae|Rissoella|notabilis|Rissoella notabilis (Thiele, 1912)	3
Onoba schraderi (Strebel, 1908)	Animalia|Mollusca|Gastropoda|Neotaenioglossa|Rissoidae|Onoba|schraderi|Onoba schraderi (Strebel, 1908)	3
Agrostis stolonifera L.	Plantae|Magnoliophyta|Liliopsida|Poales|Poaceae|Agrostis|stolonifera|Agrostis stolonifera L.	3
Banzarecolpus austrina	Animalia|Mollusca|Gastropoda|Neotaenioglossa|Turritellidae|Banzarecolpus|austrina|Banzarecolpus austrina	3
Iothia coppingeri (E.A. Smith, 1881)	Animalia|Mollusca|Gastropoda|Patellogastropoda|Lepetidae|Iothia|coppingeri|Iothia coppingeri (E.A. Smith, 1881)	3
Merizodus soledadinus (Guérin-Méneville, 1830)	Animalia|Arthropoda|Insecta|Coleoptera|Carabidae|Merizodus|soledadinus|Merizodus soledadinus (Guérin-Méneville, 1830)	3
Aptenodytes patagonicus halli	Animalia|Chordata|Aves|Sphenisciformes|Spheniscidae|Aptenodytes|patagonicus|Aptenodytes patagonicus halli	3
Capsella bursa-pastoris (L.) Medik.	Plantae|Magnoliophyta|Magnoliopsida|Brassicales|Brassicaceae|Capsella|bursa-pastoris|Capsella bursa-pastoris (L.) Medik.	3
Neidium Pfitzer, 1871	Chromista|Ochrophyta|Bacillariophyceae|Naviculales|Neidiaceae|Neidium||Neidium Pfitzer, 1871	3
Yoldia isonota Martens, 1881	Animalia|Mollusca|Bivalvia|Nuculanoida|Yoldiidae|Portlandia|isonota|Yoldia isonota Martens, 1881	3
Malletia gigantea (E. A. Smith, 1875)	Animalia|Mollusca|Bivalvia|Nuculanoida|Malletiidae|Malletia|gigantea|Malletia gigantea (E. A. Smith, 1875)	3
Rissoella notabilis (Thiele, 1912)	Animalia|Mollusca|Gastropoda||Rissoellidae|Rissoella|notabilis|Rissoella notabilis (Thiele, 1912)	3
Festuca kerguelensis (Hook.) F.Muell.	Plantae|Tracheophyta|Liliopsida|Poales|Poaceae|Poa|kerguelensis|Festuca kerguelensis (Hook.) F.Muell.	3
Laternula elliptica (King & Broderip, 1832)	Animalia|Mollusca|Bivalvia|Pholadomyoida|Laternulidae|Laternula|elliptica|Laternula elliptica (King & Broderip, 1832)	3
Ranunculus biternatus Sm.	Plantae|Tracheophyta|Magnoliopsida|Ranunculales|Ranunculaceae|Ranunculus|biternatus|Ranunculus biternatus Sm.	3
Neidium Pfitzer	Plantae|Bacillariophyta|Bacillariophyceae|Naviculales|Neidiaceae|Neidium||Neidium Pfitzer	3
Cyclocardia astartoides (Martens, 1878)	Animalia|Mollusca|Bivalvia|Veneroida|Carditidae|Cyclocardia|astartoides|Cyclocardia astartoides (Martens, 1878)	3
Trophon albolabratus E. A. Smith, 1875	Animalia|Mollusca|Gastropoda|Neogastropoda||Trophon|albolabratus|Trophon albolabratus E. A. Smith, 1875	3
Aspiciliopsis macrophthalma (Hook. f. & Taylor) B. de Lesd.	Fungi|Ascomycota|Lecanoromycetes|Baeomycetales|Trapeliaceae|Placopsis|macrophthalma|Aspiciliopsis macrophthalma (Hook. f. & Taylor) B. de Lesd.	3
Festuca kerguelensis (Hook.) F.Muell.	Plantae|Magnoliophyta|Liliopsida|Poales|Poaceae|Festuca|kerguelensis|Festuca kerguelensis (Hook.) F.Muell.	3
Orthoseira Thwaites, 1848	Chromista|Ochrophyta|Bacillariophyceae|Orthoseirales|Orthoseiraceae|Orthoseira||Orthoseira Thwaites, 1848	3
Yoldia isonota Martens, 1881	Animalia|Mollusca|Bivalvia|Nuculoida|Yoldiidae|Portlandia|isonota|Yoldia isonota Martens, 1881	3
Marseniopsis pacifica Bergh, 1886	Animalia|Mollusca|Gastropoda|Neotaenioglossa|Lamellariidae|Marseniopsis|pacifica|Marseniopsis pacifica Bergh, 1886	3
Banzarecolpus austrinus (Watson, 1881)	Animalia|Mollusca|Gastropoda||Turritellidae|Banzarecolpus|austrinus|Banzarecolpus austrinus (Watson, 1881)	3
Festuca cookii Hook.f.	Plantae|Magnoliophyta|Liliopsida|Poales|Poaceae|Poa|cookii|Festuca cookii Hook.f.	3
Schraderia Pfeffer, 1888	Animalia|Arthropoda|Malacostraca|Amphipoda|Eusiridae|Schraderia||Schraderia Pfeffer, 1888	3
Nacella kerguelenensis (Smith, 1877)	Animalia|Mollusca|Gastropoda|Archaeogastropoda|Nacellidae|Nacella|kerguelenensis|Nacella kerguelenensis (Smith, 1877)	3
Merizodus Solier in Gay, 1849	Animalia|Arthropoda|Insecta|Coleoptera|Carabidae|Merizodus||Merizodus Solier in Gay, 1849	3
Pertusaria subperrimosa Nyl.	Fungi|Ascomycota|Lecanoromycetes|Pertusariales|Pertusariaceae|Pertusaria|subperrimosa|Pertusaria subperrimosa Nyl.	3
Polytrichum Hedw.	Plantae|Bryophyta|Bryopsida|Polytrichales|Polytrichaceae|Polytrichum||Polytrichum Hedw.	2
Meridiosignum kerguelensis (Vanhöffen, 1914)	Animalia|Arthropoda|Malacostraca|Isopoda|Paramunnidae|Meridiosignum|kerguelensis|Meridiosignum kerguelensis (Vanhöffen, 1914)	2
Brachythecium subpilosum Jaeger, 1878	Plantae|Bryophyta|Bryopsida|Hypnales|Brachytheciaceae|Brachythecium|subpilosum|Brachythecium subpilosum Jaeger, 1878	2
Pagetina genarum K.H. Barnard, 1931	Animalia|Arthropoda|Malacostraca|Amphipoda|Pagetinidae|Pagetina|genarum|Pagetina genarum K.H. Barnard, 1931	2
Usnea lacunosa Willd. ex Delise	Fungi|Ascomycota|Lecanoromycetes|Lecanorales|Parmeliaceae|Usnea|lacunosa|Usnea lacunosa Willd. ex Delise	2
Trophon septus Watson, 1882	Animalia|Mollusca|Gastropoda|Neogastropoda|Muricidae|Nodulotrophon|septus|Trophon septus Watson, 1882	2
Uncinia Pers.	Plantae|Tracheophyta|Liliopsida|Poales|Cyperaceae|Uncinia||Uncinia Pers.	2
Dentalium Linnaeus, 1758	Animalia|Mollusca|Scaphopoda|Dentaliida|Dentaliidae|Dentalium||Dentalium Linnaeus, 1758	2
Mysidetes posthon Holt & W. M. Tattersall, 1906	Animalia|Arthropoda|Malacostraca|Mysida|Mysidae|Mysidetes|posthon|Mysidetes posthon Holt & W. M. Tattersall, 1906	2
Ophioplinthus carinata (Studer, 1876)	Animalia|Echinodermata|Ophiuroidea|Ophiurida|Ophiuridae|Ophioplinthus|carinata|Ophioplinthus carinata (Studer, 1876)	2
Acaena adscendens (Lam.) Vahl	Plantae|Tracheophyta|Magnoliopsida|Rosales|Rosaceae|Acaena|adscendens|Acaena adscendens (Lam.) Vahl	2
Pycnogonum magnirostrum Möbius, K., 1901	Animalia|Arthropoda|Pycnogonida||Pycnogonidae|Pycnogonum|magnirostrum|Pycnogonum magnirostrum Möbius, K., 1901	2
Iathrippa sarsi (Pfeffer, 1887)	Animalia|Arthropoda|Malacostraca|Isopoda|Janiridae|Iathrippa|sarsi|Iathrippa sarsi (Pfeffer, 1887)	2
Prosipho valdiviae Thiele, 1925	Animalia|Mollusca|Gastropoda|Neogastropoda|Buccinidae|Prosipho|valdiviae|Prosipho valdiviae Thiele, 1925	2
Prosipho Thiele, 1912	Animalia|Mollusca|Gastropoda|Neogastropoda|Buccinidae|Prosipho||Prosipho Thiele, 1912	2
Leucon kerguelensis Zimmer, 1908	Animalia|Arthropoda|Malacostraca|Cumacea|Leuconidae|Leucon|kerguelensis|Leucon kerguelensis Zimmer, 1908	2
Aristias antarcticus Walker, 1906	Animalia|Arthropoda|Malacostraca|Amphipoda|Aristiidae|Aristias|antarcticus|Aristias antarcticus Walker, 1906	2
Sterna paradisaea Pontoppidan, 1763	Animalia|Chordata|Aves|Charadriiformes|Laridae|Sterna|paradisaea|Sterna paradisaea Pontoppidan, 1763	2
Mytilus edulis subsp. platensis d'Orbigny, 1842	Animalia|Mollusca|Bivalvia|Mytiloida|Mytilidae|Mytilus|edulis|Mytilus edulis subsp. platensis d'Orbigny, 1842	2
Ditrichum Hampe	Plantae|Bryophyta|Bryopsida|Dicranales|Ditrichaceae|Ditrichum||Ditrichum Hampe	2
Abyssorchomene plebs (Hurley, 1965)	Animalia|Arthropoda|Malacostraca|Amphipoda|Lysianassidae|Pseudorchomene|plebs|Abyssorchomene plebs (Hurley, 1965)	2
Neolepton umbonatum (E. A. Smith, 1885)	Animalia|Mollusca|Bivalvia|Veneroida|Neoleptonidae|Neolepton|umbonatum|Neolepton umbonatum (E. A. Smith, 1885)	2
Tritoniella belli Eliot, 1907	Animalia|Mollusca|Gastropoda|Nudibranchia|Tritoniidae|Tritoniella|belli|Tritoniella belli Eliot, 1907	2
Bryum laevigatum J. D. Hooker & Wilson, 1844	Plantae|Bryophyta|Bryopsida|Bryales|Bryaceae|Bryum|laevigatum|Bryum laevigatum J. D. Hooker & Wilson, 1844	2
Socarnes Boeck, 1871	Animalia|Arthropoda|Malacostraca|Amphipoda|Lysianassidae|Socarnes||Socarnes Boeck, 1871	2
Pelecanoides urinatrix (Gmelin, 1789)	Animalia|Chordata|Aves|Procellariiformes|Pelecanoididae|Pelecanoides|urinatrix|Pelecanoides urinatrix (Gmelin, 1789)	2
Anasterias perrieri (E. A. Smith, 1876)	Animalia|Echinodermata|Asteroidea|Forcipulatida|Asteriidae|Anasterias|perrieri|Anasterias perrieri (E. A. Smith, 1876)	2
Torometopa crenatipalmata (Stebbing, 1888)	Animalia|Arthropoda|Malacostraca|Amphipoda|Stenothoidae|Torometopa|crenatipalmata|Torometopa crenatipalmata (Stebbing, 1888)	2
Orchomenella cavimanus (Stebbing, 1888)	Animalia|Arthropoda|Malacostraca|Amphipoda|Lysianassidae|Orchomenella|cavimanus|Orchomenella cavimanus (Stebbing, 1888)	2
Ceratodon purpureus Bridel, 1826	Plantae|Bryophyta|Bryopsida|Dicranales|Ditrichaceae|Ceratodon|purpureus|Ceratodon purpureus Bridel, 1826	2
Andreaea alpina Hedwig, 1801	Plantae|Bryophyta|Andreaeopsida|Andreaeales|Andreaeaceae|Andreaea|alpina|Andreaea alpina Hedwig, 1801	2
Monoculodes scabriculosus K.H. Barnard, 1932	Animalia|Arthropoda|Malacostraca|Amphipoda|Oedicerotidae|Monoculodes|scabriculosus|Monoculodes scabriculosus K.H. Barnard, 1932	2
Polytrichum piliferum Hedwig, 1801	Plantae|Bryophyta|Bryopsida|Polytrichales|Polytrichaceae|Polytrichum|piliferum|Polytrichum piliferum Hedwig, 1801	2
Podocerus ornatus Miers, 1875	Animalia|Arthropoda|Malacostraca|Amphipoda|Podoceridae|Podocerus|ornatus|Podocerus ornatus Miers, 1875	2
Acanthonotozomella Schellenberg, 1926	Animalia|Arthropoda|Malacostraca|Amphipoda|Acanthonotozomellidae|Acanthonotozomella||Acanthonotozomella Schellenberg, 1926	2
Amphidora Eschscholtz, 1829	Animalia|Arthropoda|Insecta|Coleoptera|Tenebrionidae|Eleodes||Amphidora Eschscholtz, 1829	2
Podocerus ornatus (Miers, 1875)	Animalia|Arthropoda|Malacostraca|Amphipoda|Podoceridae|Podocerus|ornatus|Podocerus ornatus (Miers, 1875)	2
Enchytraeus albidus Henle, 1837	Animalia|Annelida|Clitellata|Enchytraeida|Enchytraeidae|Enchytraeus|albidus|Enchytraeus albidus Henle, 1837	2
Prothaumatelson Schellenberg, 1931	Animalia|Arthropoda|Malacostraca|Amphipoda|Stenothoidae|Prothaumatelson||Prothaumatelson Schellenberg, 1931	2
Nacella edgari (Powell, 1957)	Animalia|Mollusca|Gastropoda||Nacellidae|Nacella|edgari|Nacella edgari (Powell, 1957)	2
Sycozoa sigillinoides Lesson, 1830	Animalia|Chordata|Ascidiacea|Enterogona|Holozoidae|Sycozoa|sigillinoides|Sycozoa sigillinoides Lesson, 1830	2
Jassa Leach, 1814	Animalia|Arthropoda|Malacostraca|Amphipoda|Ischyroceridae|Jassa||Jassa Leach, 1814	2
Yoldia eightsi (Couthouy, in Jay, 1839)	Animalia|Mollusca|Bivalvia|Nuculoida|Yoldiidae|Yoldia|eightsi|Yoldia eightsi (Couthouy, in Jay, 1839)	2
Haliclona similis (Topsent, 1897)	Animalia|Porifera|Demospongiae|Haplosclerida|Chalinidae|Haliclona|similis|Haliclona similis (Topsent, 1897)	2
Collema tenax (Sw.) Ach.	Fungi|Ascomycota|Lecanoromycetes|Peltigerales|Collemataceae|Collema|tenax|Collema tenax (Sw.) Ach.	2
Ranunculus moseleyi Hook. fil.	Plantae|Tracheophyta|Magnoliopsida|Ranunculales|Ranunculaceae|Ranunculus|moseleyi|Ranunculus moseleyi Hook. fil.	2
Hippasteria phrygiana (Parelius, 1768)	Animalia|Echinodermata|Asteroidea|Valvatida|Goniasteridae|Hippasteria|phrygiana|Hippasteria phrygiana (Parelius, 1768)	2
Prostebbingia Schellenberg, 1926	Animalia|Arthropoda|Malacostraca|Amphipoda|Eusiridae|Prostebbingia||Prostebbingia Schellenberg, 1926	2
Puncturella spirigera Thiele, 1912	Animalia|Mollusca|Gastropoda|Archaeogastropoda|Fissurellidae|Puncturella|spirigera|Puncturella spirigera Thiele, 1912	2
Isis Linnaeus, 1758	Animalia|Cnidaria|Anthozoa|Alcyonacea|Isididae|Isis||Isis Linnaeus, 1758	2
Pagonana rostrata (Hodgson, 1910)	Animalia|Arthropoda|Malacostraca|Isopoda|Paramunnidae|Pagonana|rostrata|Pagonana rostrata (Hodgson, 1910)	2
Calliergon (Sull.) Kindb.	Plantae|Bryophyta|Bryopsida|Hypnales|Amblystegiaceae|Calliergon||Calliergon (Sull.) Kindb.	2
Dicranoloma kerguelense Paris, 1904	Plantae|Bryophyta|Bryopsida|Dicranales|Dicranaceae|Dicranoloma|kerguelense|Dicranoloma kerguelense Paris, 1904	2
Drepanocladus (Müller Hal.) G. Roth, 1899	Plantae|Bryophyta|Bryopsida|Hypnales|Amblystegiaceae|Drepanocladus||Drepanocladus (Müller Hal.) G. Roth, 1899	2
Stegocephalus kergueleni (Schellenberg, 1926a)	Animalia|Arthropoda|Malacostraca|Amphipoda|Stegocephalidae|Stegocephalus|kergueleni|Stegocephalus kergueleni (Schellenberg, 1926a)	2
Nacella delicatissima Strebel, 1907	Animalia|Mollusca|Gastropoda|Archaeogastropoda|Nacellidae|Nacella|delicatissima|Nacella delicatissima Strebel, 1907	2
Paramoera hamiltoni Nicholls, 1938	Animalia|Arthropoda|Malacostraca|Amphipoda|Eusiridae|Paramoera|hamiltoni|Paramoera hamiltoni Nicholls, 1938	2
Polytrichastrum alpinum G. L. Smith, 1971	Plantae|Bryophyta|Bryopsida|Polytrichales|Polytrichaceae|Polytrichastrum|alpinum|Polytrichastrum alpinum G. L. Smith, 1971	2
Urothoe Dana, 1852	Animalia|Arthropoda|Malacostraca|Amphipoda|Urothoidae|Urothoe||Urothoe Dana, 1852	2
Choriactis subantarctica Pax, 1922	Animalia|Cnidaria|Anthozoa|Actiniaria|Sagartiidae|Choriactis|subantarctica|Choriactis subantarctica Pax, 1922	2
Galium L.	Plantae|Tracheophyta|Magnoliopsida|Gentianales|Rubiaceae|Galium||Galium L.	2
Hennediella antarctica Ochyra & Matteri, 1996	Plantae|Bryophyta|Bryopsida|Pottiales|Pottiaceae|Hennediella|antarctica|Hennediella antarctica Ochyra & Matteri, 1996	2
Margarella expansa (G.B. Sowerby I, 1838)	Animalia|Mollusca|Gastropoda||Calliostomatidae|Margarella|expansa|Margarella expansa (G.B. Sowerby I, 1838)	2
Gammaropsis Lilljeborg, 1855	Animalia|Arthropoda|Malacostraca|Amphipoda|Isaeidae|Gammaropsis||Gammaropsis Lilljeborg, 1855	2
Kidderia minuta Dall, 1876	Animalia|Mollusca|Bivalvia|Veneroida|Cyamiidae|Kidderia|minuta|Kidderia minuta Dall, 1876	2
Polycheria dentata Schellenberg, 1931	Animalia|Arthropoda|Malacostraca|Amphipoda|Dexaminidae|Polycheria|dentata|Polycheria dentata Schellenberg, 1931	2
Modiolarca Gray, 1842	Animalia|Mollusca|Bivalvia|Mytiloida|Mytilidae|Musculus||Modiolarca Gray, 1842	2
Rhytidactis antarctica Pax, 1922	Animalia|Cnidaria|Anthozoa|Actiniaria|Halcampidae|Halianthella|antarctica|Rhytidactis antarctica Pax, 1922	2
Breutelia (Bruch & Schimp.) Schimp.	Plantae|Bryophyta|Bryopsida|Bryales|Bartramiaceae|Breutelia||Breutelia (Bruch & Schimp.) Schimp.	2
Globicephala melas (Traill, 1809)	Animalia|Chordata|Mammalia|Cetacea|Delphinidae|Globicephala|melas|Globicephala melas (Traill, 1809)	2
Trophon septus Watson, 1882	Animalia|Mollusca|Gastropoda|Neogastropoda||Nodulotrophon|septus|Trophon septus Watson, 1882	2
Xanthoparmelia stygiodes (Nyl.) O. Blanco, A. Crespo, Elix, D. Hawksw. & Lumbsch	Fungi|Ascomycota|Lecanoromycetes|Lecanorales|Parmeliaceae|Xanthoparmelia|stygiodes|Xanthoparmelia stygiodes (Nyl.) O. Blanco, A. Crespo, Elix, D. Hawksw. & Lumbsch	2
Haliclona kerguelensis (Hentschel, 1914)	Animalia|Porifera|Demospongiae|Haplosclerida|Phloeodictyidae|Calyx|kerguelensis|Haliclona kerguelensis (Hentschel, 1914)	2
Lecania kerguelensis C.W. Dodge	Fungi|Ascomycota|Lecanoromycetes|Lecanorales|Ramalinaceae|Lecania|kerguelensis|Lecania kerguelensis C.W. Dodge	2
Bolocera kerguelensis Studer, 1879	Animalia|Cnidaria|Anthozoa|Actiniaria|Actiniidae|Bolocera|kerguelensis|Bolocera kerguelensis Studer, 1879	2
Nacella Schumacher, 1817	Animalia|Mollusca|Gastropoda|Archaeogastropoda|Nacellidae|Nacella||Nacella Schumacher, 1817	2
Lolium temulentum L.	Plantae|Magnoliophyta|Liliopsida|Poales|Poaceae|Lolium|temulentum|Lolium temulentum L.	2
Yoldia eightsii (Jay, 1839)	Animalia|Mollusca|Bivalvia|Nuculanoida|Yoldiidae|Yoldia|eightsii|Yoldia eightsii (Jay, 1839)	2
Mysidetes kerguelensis (Illig, 1906)	Animalia|Arthropoda|Malacostraca|Mysida|Mysidae|Mysidetes|kerguelensis|Mysidetes kerguelensis (Illig, 1906)	2
Marionia Michaelsen, 1889	Animalia|Annelida|Clitellata|Enchytraeida|Enchytraeidae|Marionina||Marionia Michaelsen, 1889	2
Munna maculata Beddard, 1886	Animalia|Arthropoda|Malacostraca|Isopoda|Munnidae|Munna|maculata|Munna maculata Beddard, 1886	2
Acodontaster hodgsoni (Bell, 1908)	Animalia|Echinodermata|Asteroidea|Valvatida|Odontasteridae|Acodontaster|hodgsoni|Acodontaster hodgsoni (Bell, 1908)	2
Agrostis canina L.	Plantae|Tracheophyta|Liliopsida|Poales|Poaceae|Agrostis|canina|Agrostis canina L.	2
Caprellinoides tristanensis Stebbing, 1888	Animalia|Arthropoda|Malacostraca|Amphipoda|Caprellidae|Caprellinoides|tristanensis|Caprellinoides tristanensis Stebbing, 1888	2
Bunodes kerguelensis Studer, 1879	Animalia|Cnidaria|Anthozoa|Actiniaria|Actiniidae|Parantheopsis|kerguelensis|Bunodes kerguelensis Studer, 1879	2
Rhynchothorax australis Hodgson, T.V., 1907	Animalia|Arthropoda|Pycnogonida||Rhynchothoracidae|Rhynchothorax|australis|Rhynchothorax australis Hodgson, T.V., 1907	2
Asterina Nardo, 1834	Animalia|Echinodermata|Asteroidea|Valvatida|Asterinidae|Asterina||Asterina Nardo, 1834	2
Mesoproboloides spinosa Bellan-Santini & Ledoyer, 1974	Animalia|Arthropoda|Malacostraca|Amphipoda|Stenothoidae|Mesoproboloides|spinosa|Mesoproboloides spinosa Bellan-Santini & Ledoyer, 1974	2
Nymphon brevicaudatum Miers, E.J., 1875	Animalia|Arthropoda|Pycnogonida||Nymphonidae|Nymphon|brevicaudatum|Nymphon brevicaudatum Miers, E.J., 1875	2
Lepidopleurus Dall, 1879	Animalia|Mollusca||||Lepidopleurus||Lepidopleurus Dall, 1879	2
Artemisina apollinis (Ridley & Dendy, 1886)	Animalia|Porifera|Demospongiae|Poecilosclerida|Microcionidae|Artemisina|apollinis|Artemisina apollinis (Ridley & Dendy, 1886)	2
Margarella expansa (G.B. Sowerby I, 1838)	Animalia|Mollusca|Gastropoda|Archaeogastropoda|Trochidae|Margarella|expansa|Margarella expansa (G.B. Sowerby I, 1838)	2
Modiolarca Gray, 1847	Animalia|Mollusca|Bivalvia|Veneroida|Gaimardiidae|Gaimardia||Modiolarca Gray, 1847	2
Serolis trilobitoides Eights, 1833	Animalia|Arthropoda|Malacostraca|Isopoda|Serolidae|Ceratoserolis|trilobitoides|Serolis trilobitoides Eights, 1833	2
Anasterias rupicola (Verrill, 1876)	Animalia|Echinodermata|Asteroidea|Forcipulatida|Asteriidae|Anasterias|rupicola|Anasterias rupicola (Verrill, 1876)	2
Photis Krøyer, 1842	Animalia|Arthropoda|Malacostraca|Amphipoda|Isaeidae|Photis||Photis Krøyer, 1842	2
Tetrastemma unilineatum Joubin, 1910	Animalia|Nemertea|Enopla|Monostilifera|Tetrastemmatidae|Tetrastemma|unilineatum|Tetrastemma unilineatum Joubin, 1910	2
Lissarca media Thiele, 1912	Animalia|Mollusca|Bivalvia|Arcoida|Philobryidae|Lissarca|media|Lissarca media Thiele, 1912	2
Brassicaceae	Plantae|Tracheophyta|Magnoliopsida|Brassicales|Brassicaceae|||Brassicaceae	2
Bartramia ithyphylla Bridel, 1803	Plantae|Bryophyta|Bryopsida|Bryales|Bartramiaceae|Bartramia|ithyphylla|Bartramia ithyphylla Bridel, 1803	2
Spirotropis studeriana (Martens, 1878)	Animalia|Mollusca|Gastropoda|Neogastropoda|Turridae|Spirotropis|studeriana|Spirotropis studeriana (Martens, 1878)	2
Huperzia saururus (Lam.) Trevis.	Plantae|Tracheophyta|Lycopodiopsida|Lycopodiales|Lycopodiaceae|Phlegmariurus|saururus|Huperzia saururus (Lam.) Trevis.	2
Dicranella (Müller Hal.) W.P. Schimper, 1856	Plantae|Bryophyta|Bryopsida|Dicranales|Dicranaceae|Dicranella||Dicranella (Müller Hal.) W.P. Schimper, 1856	2
Notopais quadrispinosa (Beddard, 1886)	Animalia|Arthropoda|Malacostraca|Isopoda|Munnopsidae|Notopais|quadrispinosa|Notopais quadrispinosa (Beddard, 1886)	2
Neojaera antarctica (Pfeffer, 1887)	Animalia|Arthropoda|Malacostraca|Isopoda|Janiridae|Neojaera|antarctica|Neojaera antarctica (Pfeffer, 1887)	2
Dendrilla antarctica Topsent, 1905	Animalia|Porifera|Demospongiae|Dendroceratida|Darwinellidae|Dendrilla|antarctica|Dendrilla antarctica Topsent, 1905	2
Powellisetia australis (Watson, 1886)	Animalia|Mollusca|Gastropoda|Neotaenioglossa|Rissoidae|Powellisetia|australis|Powellisetia australis (Watson, 1886)	2
Acaena L.	Plantae|Tracheophyta|Magnoliopsida|Rosales|Rosaceae|Acaena||Acaena L.	2
Joeropsis marionis Beddard, 1886	Animalia|Arthropoda|Malacostraca|Isopoda|Joeropsididae|Joeropsis|marionis|Joeropsis marionis Beddard, 1886	2
Nipponnemertes marioni (Hubrecht, 1887)	Animalia|Nemertea|Enopla|Monostilifera|Cratenemertidae|Nipponnemertes|marioni|Nipponnemertes marioni (Hubrecht, 1887)	2
Fusinella jucunda (Thiele, 1912)	Animalia|Mollusca|Gastropoda|Neogastropoda|Buccinidae|Fusinella|jucunda|Fusinella jucunda (Thiele, 1912)	2
Hymenoloma immersum (Broth.) Broth.	Plantae|Bryophyta|Bryopsida|Seligerales|Seligeriaceae|Verrucidens|immersum|Hymenoloma immersum (Broth.) Broth.	2
Oediceroides newnesi (Walker, 1903)	Animalia|Arthropoda|Malacostraca|Amphipoda|Oedicerotidae|Oediceroides|newnesi|Oediceroides newnesi (Walker, 1903)	2
Breutelia (Bruch & W.P. Schimper) W.P. Schimper, 1856	Plantae|Bryophyta|Bryopsida|Bryales|Bartramiaceae|Breutelia||Breutelia (Bruch & W.P. Schimper) W.P. Schimper, 1856	2
Craniella coactifera (Lendenfeld, 1907)	Animalia|Porifera|Demospongiae|Tetractinellida|Tetillidae|Craniella|coactifera|Craniella coactifera (Lendenfeld, 1907)	2
Austrodoris kerguelenensis (Bergh, 1884)	Animalia|Mollusca|Gastropoda|Nudibranchia|Dorididae|Doris|kerguelenensis|Austrodoris kerguelenensis (Bergh, 1884)	2
Schraderia gracilis Pfeffer, 1888	Animalia|Arthropoda|Malacostraca|Amphipoda|Eusiridae|Schraderia|gracilis|Schraderia gracilis Pfeffer, 1888	2
Atyloella magellanica (Stebbing, 1888)	Animalia|Arthropoda|Malacostraca|Amphipoda|Eusiridae|Atyloella|magellanica|Atyloella magellanica (Stebbing, 1888)	2
Gammaropsis exsertipes Stebbing, 1888	Animalia|Arthropoda|Malacostraca|Amphipoda|Isaeidae|Gammaropsis|exsertipes|Gammaropsis exsertipes Stebbing, 1888	2
Phelliogeton kerguelensis Carlgren, 1928	Animalia|Cnidaria|Anthozoa|Actiniaria|Bathyphellidae|Phelliogeton|kerguelensis|Phelliogeton kerguelensis Carlgren, 1928	2
Haliclonissa sacciformis Burton, 1932	Animalia|Porifera|Demospongiae|Haplosclerida|Niphatidae|Haliclonissa|sacciformis|Haliclonissa sacciformis Burton, 1932	2
Agrostis canina L.	Plantae|Magnoliophyta|Liliopsida|Poales|Poaceae|Agrostis|canina|Agrostis canina L.	2
Cephalorhynchus commersoni Yanez, 1948	Animalia|Chordata|Mammalia|Cetacea|Delphinidae|Cephalorhynchus|commersoni|Cephalorhynchus commersoni Yanez, 1948	2
Ascorhynchus ornatus (Helfer, H., 1938)	Animalia|Arthropoda|Pycnogonida||Ammotheidae|Ascorhynchus|ornatus|Ascorhynchus ornatus (Helfer, H., 1938)	2
Hemiarthrum setulosum Carpenter in Dall, 1876	Animalia|Mollusca|Polyplacophora|Chitonida|Hemiarthridae|Hemiarthrum|setulosum|Hemiarthrum setulosum Carpenter in Dall, 1876	2
Anthoxanthum odoratum L.	Plantae|Magnoliophyta|Liliopsida|Poales|Poaceae|Anthoxanthum|odoratum|Anthoxanthum odoratum L.	2
Gammaropsis Liljeborg, 1855	Animalia|Arthropoda|Malacostraca|Amphipoda|Isaeidae|Gammaropsis||Gammaropsis Liljeborg, 1855	2
Aulacomya atra (Molina, 1782)	Animalia|Mollusca|Bivalvia|Mytiloida|Mytilidae|Aulacomya|atra|Aulacomya atra (Molina, 1782)	2
Kidderia minuta Dall, 1876	Animalia|Arthropoda|Malacostraca|Amphipoda|Cyamidae|Kidderia|minuta|Kidderia minuta Dall, 1876	2
Sematophyllum lebouvieri Ochyra	Plantae|Bryophyta|Bryopsida|Hypnales|Sematophyllaceae|Sematophyllum|lebouvieri|Sematophyllum lebouvieri Ochyra	2
Henricia spinulifera Smith, 1876	Animalia|Echinodermata|Asteroidea|Spinulosida|Echinasteridae|Henricia|spinulifera|Henricia spinulifera Smith, 1876	2
Neolepton umbonatum (E.A. Smith, 1885)	Animalia|Mollusca|Bivalvia|Veneroida|Neoleptonidae|Neolepton|umbonatum|Neolepton umbonatum (E.A. Smith, 1885)	2
Microdiscula subcanaliculata (Smith, 1875)	Animalia|Mollusca|Gastropoda|Archaeogastropoda|Orbitestellidae|Microdiscula|subcanaliculata|Microdiscula subcanaliculata (Smith, 1875)	2
Dicranoloma billardierei (Brid.) Paris	Plantae|Bryophyta|Bryopsida|Dicranales|Dicranaceae|Dicranoloma|billardierei|Dicranoloma billardierei (Brid.) Paris	2
Amphilectus fucorum (Esper, 1794)	Animalia|Porifera|Demospongiae|Poecilosclerida|Esperiopsidae|Amphilectus|fucorum|Amphilectus fucorum (Esper, 1794)	2
Drepanocladus (Müll.Hal.) Roth	Plantae|Bryophyta|Bryopsida|Hypnales|Amblystegiaceae|Drepanocladus||Drepanocladus (Müll.Hal.) Roth	2
Philobrya meridionalis (E. A. Smith, 1885)	Animalia|Mollusca|Bivalvia|Arcoida|Philobryidae|Philobrya|meridionalis|Philobrya meridionalis (E. A. Smith, 1885)	2
Puncturella spirigera Thiele, 1912	Animalia|Mollusca|Gastropoda||Fissurellidae|Puncturella|spirigera|Puncturella spirigera Thiele, 1912	2
Jassa alonsoae Conlan, 1990	Animalia|Arthropoda|Malacostraca|Amphipoda|Ischyroceridae|Jassa|alonsoae|Jassa alonsoae Conlan, 1990	2
Colossendeis robusta Hoek, P.P.C., 1881	Animalia|Arthropoda|Pycnogonida||Colossendeidae|Colossendeis|robusta|Colossendeis robusta Hoek, P.P.C., 1881	2
Garrodia nereis (Gould, 1841)	Animalia|Chordata|Aves|Procellariiformes|Hydrobatidae|Garrodia|nereis|Garrodia nereis (Gould, 1841)	2
Waldo parasiticus (Dall, 1876)	Animalia|Mollusca|Bivalvia|Veneroida|Lasaeidae|Waldo|parasiticus|Waldo parasiticus (Dall, 1876)	2
Ophiocten amitinum Lyman, 1878	Animalia|Echinodermata|Ophiuroidea|Ophiurida|Ophiuridae|Ophiocten|amitinum|Ophiocten amitinum Lyman, 1878	2
Tritonia antarctica Pfeffer in Martens & Pfeffer, 1886	Animalia|Mollusca|Gastropoda|Nudibranchia|Tritoniidae|Tritonia|antarctica|Tritonia antarctica Pfeffer in Martens & Pfeffer, 1886	2
Gammaropsis (Gammaropsis) exsertipes Stebbing, 1888	Animalia|Arthropoda|Malacostraca|Amphipoda|Isaeidae|Gammaropsis|exsertipes|Gammaropsis (Gammaropsis) exsertipes Stebbing, 1888	2
Craniella coactifera (Lendenfeld, 1907)	Animalia|Porifera|Demospongiae|Spirophorida|Tetillidae|Craniella|coactifera|Craniella coactifera (Lendenfeld, 1907)	2
Poa pratensis L.	Plantae|Tracheophyta|Liliopsida|Poales|Poaceae|Poa|pratensis|Poa pratensis L.	2
Bryum validinervium Müll. Hal.	Plantae|Bryophyta|Bryopsida|Bryales|Bryaceae|Bryum|validinervium|Bryum validinervium Müll. Hal.	2
Hypnum chalarocladum Müll. Hal.	Plantae|Bryophyta|Bryopsida|Hypnales|Amblystegiaceae|Hygroamblystegium|chalarocladum|Hypnum chalarocladum Müll. Hal.	2
Haliclona rudis (Topsent, 1901)	Animalia|Porifera|Demospongiae|Haplosclerida|Chalinidae|Haliclona|rudis|Haliclona rudis (Topsent, 1901)	2
Stegocephalus kergueleni (Schellenberg, 1926)	Animalia|Arthropoda|Malacostraca|Amphipoda|Stegocephalidae|Phippsiella|kergueleni|Stegocephalus kergueleni (Schellenberg, 1926)	2
Anthoxanthum odoratum L.	Plantae|Tracheophyta|Liliopsida|Poales|Poaceae|Anthoxanthum|odoratum|Anthoxanthum odoratum L.	2
Munna antarctica (Pfeffer, 1887)	Animalia|Arthropoda|Malacostraca|Isopoda|Munnidae|Munna|antarctica|Munna antarctica (Pfeffer, 1887)	2
Haliclona Grant, 1836	Animalia|Porifera|Demospongiae|Haplosclerida|Chalinidae|Haliclona||Haliclona Grant, 1836	2
Skenella sinapi (Watson, 1886)	Animalia|Mollusca|Gastropoda|Mesogastropoda|Cingulopsidae|Skenella|sinapi|Skenella sinapi (Watson, 1886)	2
Entosthodon laxus Mitten, 1856	Plantae|Bryophyta|Bryopsida|Funariales|Funariaceae|Entosthodon|laxus|Entosthodon laxus Mitten, 1856	2
Tanystylum styligerum (Miers, E.J., 1875)	Animalia|Arthropoda|Pycnogonida||Ammotheidae|Tanystylum|styligerum|Tanystylum styligerum (Miers, E.J., 1875)	2
Ditrichum Hampe, 1867	Plantae|Bryophyta|Bryopsida|Dicranales|Ditrichaceae|Ditrichum||Ditrichum Hampe, 1867	2
Leucon vanhoeffeni Zimmer, 1907	Animalia|Arthropoda|Malacostraca|Cumacea|Leuconidae|Leucon|vanhoeffeni|Leucon vanhoeffeni Zimmer, 1907	2
Lissarca miliaris (Philippi, 1845)	Animalia|Mollusca|Bivalvia|Arcoida|Philobryidae|Lissarca|miliaris|Lissarca miliaris (Philippi, 1845)	2
Dicranella (Müll.Hal.) Schimp.	Plantae|Bryophyta|Bryopsida|Dicranales|Dicranaceae|Dicranella||Dicranella (Müll.Hal.) Schimp.	2
Acaena adscendens Vahl	Plantae|Magnoliophyta|Magnoliopsida|Rosales|Rosaceae|Acaena|adscendens|Acaena adscendens Vahl	2
Ranunculus pseudotrullifolius Skottsberg	Plantae|Tracheophyta|Magnoliopsida|Ranunculales|Ranunculaceae|Ranunculus|pseudotrullifolius|Ranunculus pseudotrullifolius Skottsberg	2
Munna dentata Vanhöffen, 1914	Animalia|Arthropoda|Malacostraca|Isopoda|Munnidae|Munna|dentata|Munna dentata Vanhöffen, 1914	2
Oradarea tridentata K.H. Barnard, 1932	Animalia|Arthropoda|Malacostraca|Amphipoda|Calliopiidae|Oradarea|tridentata|Oradarea tridentata K.H. Barnard, 1932	2
Paramoera gregaria (Pfeffer, 1888)	Animalia|Arthropoda|Malacostraca|Amphipoda|Eusiridae|Paramoera|gregaria|Paramoera gregaria (Pfeffer, 1888)	2
Tanystylum neorhetum Marcus, E., 1940	Animalia|Arthropoda|Pycnogonida||Ammotheidae|Tanystylum|neorhetum|Tanystylum neorhetum Marcus, E., 1940	2
Ophiomisidium speciosum Koehler, 1914	Animalia|Echinodermata|Ophiuroidea|Ophiurida|Ophiuridae|Ophiomisidium|speciosum|Ophiomisidium speciosum Koehler, 1914	2
Isodictya kerguelenensis (Ridley & Dendy, 1886)	Animalia|Porifera|Demospongiae|Poecilosclerida|Isodictyidae|Isodictya|kerguelenensis|Isodictya kerguelenensis (Ridley & Dendy, 1886)	2
Gitanopsis squamosa (Thomson, 1880)	Animalia|Arthropoda|Malacostraca|Amphipoda|Amphilochidae|Gitanopsis|squamosa|Gitanopsis squamosa (Thomson, 1880)	2
Orchomenella (Orchomenopsis) cavimanus (Stebbing, 1888)	Animalia|Arthropoda|Malacostraca|Amphipoda|Lysianassidae|Orchomenella|cavimanus|Orchomenella (Orchomenopsis) cavimanus (Stebbing, 1888)	2
Eudyptes chrysocome (J. R. Forster, 1781)	Animalia|Chordata|Aves|Sphenisciformes|Spheniscidae|Eudyptes|chrysocome|Eudyptes chrysocome (J. R. Forster, 1781)	2
Goniocidaris membranipora Studer, 1876	Animalia|Echinodermata|Echinoidea|Cidaroida|Ctenocidaridae|Ctenocidaris|membranipora|Goniocidaris membranipora Studer, 1876	2
Bryoerythrophyllum campylocarpum H. Crum, 1957	Plantae|Bryophyta|Bryopsida|Pottiales|Pottiaceae|Bryoerythrophyllum|campylocarpum|Bryoerythrophyllum campylocarpum H. Crum, 1957	2
Nacella delicatissima Strebel, 1907	Animalia|Mollusca|Gastropoda||Nacellidae|Nacella|delicatissima|Nacella delicatissima Strebel, 1907	2
Podocerus capillimanus Nicholls, 1938	Animalia|Arthropoda|Malacostraca|Amphipoda|Podoceridae|Podocerus|capillimanus|Podocerus capillimanus Nicholls, 1938	2
Prosipho pellitus Thiele, 1912	Animalia|Mollusca|Gastropoda|Neogastropoda|Buccinidae|Prosipho|pellitus|Prosipho pellitus Thiele, 1912	2
Abyssorchomene plebs (Hurley, 1965)	Animalia|Arthropoda|Malacostraca|Amphipoda|Lysianassidae|Orchomene|plebs|Abyssorchomene plebs (Hurley, 1965)	2
Tedania charcoti Topsent, 1907	Animalia|Porifera|Demospongiae|Poecilosclerida|Tedaniidae|Tedania|charcoti|Tedania charcoti Topsent, 1907	2
Eatoniella caliginosa (E. A. Smith, 1875)	Animalia|Mollusca|Gastropoda|Littorinimorpha|Eatoniellidae|Eatoniella|caliginosa|Eatoniella caliginosa (E. A. Smith, 1875)	2
Leucosolenia discoveryi Jenkin, 1908	Animalia|Porifera|Calcarea|Leucosolenida|Leucosoleniidae|Leucosolenia|discoveryi|Leucosolenia discoveryi Jenkin, 1908	2
Holodontium (Mitten) V.F. Brotherus in Engler & Prantl, 1924	Plantae|Bryophyta|Bryopsida|Dicranales|Dicranaceae|Holodontium||Holodontium (Mitten) V.F. Brotherus in Engler & Prantl, 1924	2
Eumetula ornata (Thiele, 1912)	Animalia|Mollusca|Gastropoda|Neotaenioglossa|Cerithiopsidae|Eumetula|ornata|Eumetula ornata (Thiele, 1912)	2
Leptochiton kerguelensis Haddon, 1886	Animalia|Mollusca|Polyplacophora|Neoloricata|Leptochitonidae|Leptochiton|kerguelensis|Leptochiton kerguelensis Haddon, 1886	2
Cuthona georgiana (Pfeffer in Martens & Pfeffer, 1886)	Animalia|Mollusca|Gastropoda|Nudibranchia|Tergipedidae|Cuthona|georgiana|Cuthona georgiana (Pfeffer in Martens & Pfeffer, 1886)	2
Skenella sinapi (Watson, 1886)	Animalia|Mollusca|Gastropoda|Littorinimorpha|Cingulopsidae|Skenella|sinapi|Skenella sinapi (Watson, 1886)	2
Toledonia punctata Thiele, 1912	Animalia|Mollusca|Gastropoda|Cephalaspidea|Diaphanidae|Toledonia|punctata|Toledonia punctata Thiele, 1912	2
Spirotropis studeriana (Martens, 1878)	Animalia|Mollusca|Gastropoda|Neogastropoda|Drilliidae|Spirotropis|studeriana|Spirotropis studeriana (Martens, 1878)	2
Leptogium puberulum Hue	Fungi|Ascomycota|Lecanoromycetes|Peltigerales|Collemataceae|Leptogium|puberulum|Leptogium puberulum Hue	2
Eumetula ornata (Thiele, 1912)	Animalia|Mollusca|Gastropoda||Newtoniellidae|Eumetula|ornata|Eumetula ornata (Thiele, 1912)	2
Eurythenes obesus (Chevreux, 1905)	Animalia|Arthropoda|Malacostraca|Amphipoda|Lysianassidae|Eurythenes|obesus|Eurythenes obesus (Chevreux, 1905)	2
Socarnoides kergueleni Stebbing, 1888	Animalia|Arthropoda|Malacostraca|Amphipoda|Lysianassidae|Socarnoides|kergueleni|Socarnoides kergueleni Stebbing, 1888	2
Clathria antarctica (Topsent, 1917)	Animalia|Porifera|Demospongiae|Poecilosclerida|Microcionidae|Clathria|antarctica|Clathria antarctica (Topsent, 1917)	2
Serolis latifrons White, 1847	Animalia|Arthropoda|Malacostraca|Isopoda|Serolidae|Spinoserolis|latifrons|Serolis latifrons White, 1847	2
Cephalophoxoides kergueleni (Stebbing, 1888)	Animalia|Arthropoda|Malacostraca|Amphipoda|Phoxocephalidae|Cephalophoxoides|kergueleni|Cephalophoxoides kergueleni (Stebbing, 1888)	2
Schistidium falcatum B. Bremer, 1980	Plantae|Bryophyta|Bryopsida|Grimmiales|Grimmiaceae|Schistidium|falcatum|Schistidium falcatum B. Bremer, 1980	2
Chlanidota densesculpta (Martens, 1885)	Animalia|Mollusca|Gastropoda|Neogastropoda|Buccinidae|Chlanidota|densesculpta|Chlanidota densesculpta (Martens, 1885)	2
Austrofilius furcatus Hodgson, 1910	Animalia|Arthropoda|Malacostraca|Isopoda|Janiridae|Austrofilius|furcatus|Austrofilius furcatus Hodgson, 1910	2
Notothenia acuta Günther, 1880	Animalia|Chordata|Actinopterygii|Perciformes|Nototheniidae|Gobionotothen|acuta|Notothenia acuta Günther, 1880	2
Clytia paulensis (Vanhöffen, 1910)	Animalia|Cnidaria|Hydrozoa|Leptothecata|Campanulariidae|Clytia|paulensis|Clytia paulensis (Vanhöffen, 1910)	2
Prosipho certus Thiele, 1912	Animalia|Mollusca|Gastropoda|Neogastropoda|Buccinidae|Prosipho|certus|Prosipho certus Thiele, 1912	2
Ixodes auritulus Neumann, 1904	Animalia|Arthropoda|Arachnida|Ixodida|Ixodidae|Ixodes|auritulus|Ixodes auritulus Neumann, 1904	2
Microdiscula subcanaliculata (E. A. Smith, 1875)	Animalia|Mollusca|Gastropoda||Orbitestellidae|Microdiscula|subcanaliculata|Microdiscula subcanaliculata (E. A. Smith, 1875)	2
Dicranaceae	Plantae|Bryophyta|Bryopsida|Dicranales|Dicranaceae|||Dicranaceae	2
Lolium temulentum L.	Plantae|Tracheophyta|Liliopsida|Poales|Poaceae|Lolium|temulentum|Lolium temulentum L.	2
Gammaropsis valdiviae (Schellenberg, 1926)	Animalia|Arthropoda|Malacostraca|Amphipoda|Isaeidae|Gammaropsis|valdiviae|Gammaropsis valdiviae (Schellenberg, 1926)	2
Powellisetia australis (Watson, 1886)	Animalia|Mollusca|Gastropoda|Littorinimorpha|Rissoidae|Powellisetia|australis|Powellisetia australis (Watson, 1886)	2
Gammaropsis (Gammaropsis) valdiviae (Schellenberg, 1926)	Animalia|Arthropoda|Malacostraca|Amphipoda|Isaeidae|Gammaropsis|valdiviae|Gammaropsis (Gammaropsis) valdiviae (Schellenberg, 1926)	2
Onoba kergueleni (E. A. Smith, 1875)	Animalia|Mollusca|Gastropoda|Littorinimorpha|Rissoidae|Onoba|kergueleni|Onoba kergueleni (E. A. Smith, 1875)	2
Galium L.	Plantae|Magnoliophyta|Magnoliopsida|Gentianales|Rubiaceae|Galium||Galium L.	2
Kerguelenia compacta Stebbing, 1888	Animalia|Arthropoda|Malacostraca|Amphipoda|Lysianassidae|Kerguelenia|compacta|Kerguelenia compacta Stebbing, 1888	2
Colossendeis megalonyx Hoek, P.P.C., 1881	Animalia|Arthropoda|Pycnogonida||Colossendeidae|Colossendeis|megalonyx|Colossendeis megalonyx Hoek, P.P.C., 1881	2
Phalaris aquatica L.	Plantae|Tracheophyta|Liliopsida|Poales|Poaceae|Phalaris|aquatica|Phalaris aquatica L.	1
Eatoniella caliginosa (Smith, 1875)	Animalia|Mollusca|Gastropoda|Neotaenioglossa|Eatoniellidae|Eatoniella|caliginosa|Eatoniella caliginosa (Smith, 1875)	1
Lineus longifissus sensu Iwata, 1952	Animalia|Nemertea|Anopla||Lineidae|Lineus|longifissus|Lineus longifissus sensu Iwata, 1952	1
Santia marmorata (Vanhoeffen, 1914)	Animalia|Arthropoda|Malacostraca|Isopoda|Santiidae|Santia|marmorata|Santia marmorata (Vanhoeffen, 1914)	1
Halisarca Johnston, 1842	Animalia|Porifera|Demospongiae|Chondrosida|Halisarcidae|Halisarca||Halisarca Johnston, 1842	1
Paradoxostoma kerguelensis Müller, 1908	Animalia|Arthropoda|Ostracoda|Podocopida|Paradoxostomatidae|Paradoxostoma|kerguelensis|Paradoxostoma kerguelensis Müller, 1908	1
Laevilacunaria Powell, 1951	Animalia|Mollusca|Gastropoda|Neotaenioglossa|Littorinidae|Laevilitorina||Laevilacunaria Powell, 1951	1
Stellaria L.	Plantae|Tracheophyta|Magnoliopsida|Caryophyllales|Caryophyllaceae|Stellaria||Stellaria L.	1
Pleurotomella Verrill, 1872	Animalia|Mollusca|Gastropoda|Neogastropoda|Raphitomidae|Pleurotomella||Pleurotomella Verrill, 1872	1
Bryum argenteum f. argenteum	Plantae|Bryophyta|Bryopsida|Bryales|Bryaceae|Bryum|argenteum|Bryum argenteum f. argenteum	1
Neopsolidium kerguelensis (Théel, 1886)	Animalia|Echinodermata|Holothuroidea|Dendrochirotida|Psolidae|Neopsolidium|kerguelensis|Neopsolidium kerguelensis (Théel, 1886)	1
Bryum argenteum Hedwig, 1801	Plantae|Bryophyta|Bryopsida|Bryales|Bryaceae|Bryum|argenteum|Bryum argenteum Hedwig, 1801	1
Omalogyra atomus (Philippi, 1841)	Animalia|Mollusca|Gastropoda||Omalogyridae|Omalogyra|atomus|Omalogyra atomus (Philippi, 1841)	1
Alopecurus geniculatus L.	Plantae|Magnoliophyta|Liliopsida|Poales|Poaceae|Alopecurus|geniculatus|Alopecurus geniculatus L.	1
Muraenolepis microps Lönnberg, 1905	Animalia|Chordata|Actinopterygii|Gadiformes|Muraenolepididae|Muraenolepis|microps|Muraenolepis microps Lönnberg, 1905	1
Cyclotella (Kütz.) de Brebisson	Chromista|Ochrophyta|Coscinodiscophyceae|Thalassiosirales|Stephanodiscaceae|Cyclotella||Cyclotella (Kütz.) de Brebisson	1
Hymeniacidon agminata Ridley, 1884	Animalia|Porifera|Demospongiae|Suberitida|Halichondriidae|Hymeniacidon|agminata|Hymeniacidon agminata Ridley, 1884	1
Hiatella solida (Sowerby, 1834)	Animalia|Mollusca|Bivalvia|Anomalodesmata|Lyonsiidae|Hiatella|solida|Hiatella solida (Sowerby, 1834)	1
Othilia Gray, 1840	Animalia|Echinodermata|Asteroidea|Spinulosida|Echinasteridae|Othilia||Othilia Gray, 1840	1
Pseudosuberites sulcatus (Thiele, 1905)	Animalia|Porifera|Demospongiae|Suberitida|Suberitidae|Pseudosuberites|sulcatus|Pseudosuberites sulcatus (Thiele, 1905)	1
Rhachotropis S. I. Smith, 1883	Animalia|Arthropoda|Malacostraca|Amphipoda|Eusiridae|Rhachotropis||Rhachotropis S. I. Smith, 1883	1
Phreodrilus Beddard, 1891	Animalia|Annelida|Clitellata|Haplotaxida|Phreodrilidae|Phreodrilus||Phreodrilus Beddard, 1891	1
Typhlomangelia fluctuosa (Watson, 1881)	Animalia|Mollusca|Gastropoda|Neogastropoda|Borsoniidae|Typhlomangelia|fluctuosa|Typhlomangelia fluctuosa (Watson, 1881)	1
Uromunna schauinslandi (G. O. Sars, 1905)	Animalia|Arthropoda|Malacostraca|Isopoda|Munnidae|Uromunna|schauinslandi|Uromunna schauinslandi (G. O. Sars, 1905)	1
Pellilitorina pellita (Martens, 1885)	Animalia|Mollusca|Gastropoda|Littorinimorpha|Littorinidae|Pellilitorina|pellita|Pellilitorina pellita (Martens, 1885)	1
Dynamenella eatoni (Miers, 1875)	Animalia|Arthropoda|Malacostraca|Isopoda|Sphaeromatidae|Ischyromene|eatoni|Dynamenella eatoni (Miers, 1875)	1
Leptinella plumosa Hook.f.	Plantae|Tracheophyta|Magnoliopsida|Asterales|Asteraceae|Leptinella|plumosa|Leptinella plumosa Hook.f.	1
Leptodontium (Müll.Hal.) Lindb.	Plantae|Bryophyta|Bryopsida|Pottiales|Pottiaceae|Leptodontium||Leptodontium (Müll.Hal.) Lindb.	1
Hordeum vulgare L.	Plantae|Magnoliophyta|Liliopsida|Poales|Poaceae|Hordeum|vulgare|Hordeum vulgare L.	1
Boraginaceae	Plantae|Tracheophyta|Magnoliopsida|Boraginales|Boraginaceae|||Boraginaceae	1
Festuca rubra L.	Plantae|Magnoliophyta|Liliopsida|Poales|Poaceae|Festuca|rubra|Festuca rubra L.	1
Holcus mollis L.	Plantae|Tracheophyta|Liliopsida|Poales|Poaceae|Holcus|mollis|Holcus mollis L.	1
Halichondria panicea (Pallas, 1766)	Animalia|Porifera|Demospongiae|Suberitida|Halichondriidae|Halichondria|panicea|Halichondria panicea (Pallas, 1766)	1
Elaphoglossum randii Alston & Schelpe	Plantae|Pteridophyta|Polypodiopsida|Polypodiales|Dryopteridaceae|Elaphoglossum|randii|Elaphoglossum randii Alston & Schelpe	1
Scissurella supraplicata E.A. Smith, 1875	Animalia|Mollusca|Gastropoda|Archaeogastropoda|Scissurellidae|Scissurella|supraplicata|Scissurella supraplicata E.A. Smith, 1875	1
Brachythecium austrosalebrosum Paris, 1894	Plantae|Bryophyta|Bryopsida|Hypnales|Brachytheciaceae|Brachythecium|austrosalebrosum|Brachythecium austrosalebrosum Paris, 1894	1
Molpadia violacea Studer, 1876	Animalia|Echinodermata|Holothuroidea|Molpadida|Molpadiidae|Molpadia|violacea|Molpadia violacea Studer, 1876	1
Triticum aestivum L.	Plantae|Magnoliophyta|Liliopsida|Poales|Poaceae|Triticum|aestivum|Triticum aestivum L.	1
Pseudocnus laevigatus (Ekman, 1925)	Animalia|Echinodermata|Holothuroidea|Dendrochirotida|Cucumariidae|Pseudocnus|laevigatus|Pseudocnus laevigatus (Ekman, 1925)	1
Xestoleberis kerguelensis Müller, 1908	Animalia|Arthropoda|Ostracoda|Podocopida|Xestoleberididae|Xestoleberis|kerguelensis|Xestoleberis kerguelensis Müller, 1908	1
Alopecurus geniculatus L.	Plantae|Tracheophyta|Liliopsida|Poales|Poaceae|Alopecurus|geniculatus|Alopecurus geniculatus L.	1
Travisia kerguelensis McIntosh, 1885	Animalia|Annelida|Polychaeta||Opheliidae|Travisia|kerguelensis|Travisia kerguelensis McIntosh, 1885	1
Lyncina lynx (Linnaeus, 1758)	Animalia|Mollusca|Gastropoda|Littorinimorpha|Cypraeidae|Lyncina|lynx|Lyncina lynx (Linnaeus, 1758)	1
Isolepis R. Br.	Plantae|Magnoliophyta|Liliopsida|Poales|Cyperaceae|Isolepis||Isolepis R. Br.	1
Cythereis kerguelensis (Brady, 1880)	Animalia|Arthropoda|Ostracoda|Podocopida|Hemicytheridae|Serratocythere|kerguelensis|Cythereis kerguelensis (Brady, 1880)	1
Cirratulus cirratus (O. F. Müller, 1776)	Animalia|Annelida|Polychaeta|Terebellida|Cirratulidae|Cirratulus|cirratus|Cirratulus cirratus (O. F. Müller, 1776)	1
Bryum subrotundifolium A. Jaeger	Plantae|Bryophyta|Bryopsida|Bryales|Bryaceae|Bryum|subrotundifolium|Bryum subrotundifolium A. Jaeger	1
Typhlomangelia fluctuosa (Watson, 1881)	Animalia|Mollusca|Gastropoda|Neogastropoda|Conidae|Typhlomangelia|fluctuosa|Typhlomangelia fluctuosa (Watson, 1881)	1
Cerebratulus malvini Wheeler, 1934	Animalia|Nemertea|Anopla||Lineidae|Cerebratulus|malvini|Cerebratulus malvini Wheeler, 1934	1
Hymeniacidon agminata Ridley, 1884	Animalia|Porifera|Demospongiae|Halichondrida|Halichondriidae|Hymeniacidon|agminata|Hymeniacidon agminata Ridley, 1884	1
Chaetonymphon Sars, 1888	Animalia|Arthropoda|Pycnogonida||Nymphonidae|Nymphon||Chaetonymphon Sars, 1888	1
Amblystegium serpens W. P. Schimper in B.S.G., 1853	Plantae|Bryophyta|Bryopsida|Hypnales|Amblystegiaceae|Amblystegium|serpens|Amblystegium serpens W. P. Schimper in B.S.G., 1853	1
Ranunculus pseudotrullifolius Skottsb.	Plantae|Magnoliophyta|Magnoliopsida|Ranunculales|Ranunculaceae|Ranunculus|pseudotrullifolius|Ranunculus pseudotrullifolius Skottsb.	1
Glabraster antarctica (E. A. Smith, 1876)	Animalia|Echinodermata|Asteroidea|Valvatida|Poraniidae|Glabraster|antarctica|Glabraster antarctica (E. A. Smith, 1876)	1
Arrhenatherum elatius (L.) P.Beauv. ex J.Presl & C.Presl.	Plantae|Magnoliophyta|Liliopsida|Poales|Poaceae|Arrhenatherum|elatius|Arrhenatherum elatius (L.) P.Beauv. ex J.Presl & C.Presl.	1
Cythereis kerguelensis (Brady, 1880)	Animalia|Arthropoda|Ostracoda|Podocopida|Hemicytheridae|Hemicythere|kerguelensis|Cythereis kerguelensis (Brady, 1880)	1
Halisarca Johnston, 1842	Animalia|Porifera|Demospongiae|Chondrillida|Halisarcidae|Halisarca||Halisarca Johnston, 1842	1
Dicranella campylophylla (Taylor) A. Jaeger	Plantae|Bryophyta|Bryopsida|Dicranales|Dicranaceae|Dicranum|campylophylla|Dicranella campylophylla (Taylor) A. Jaeger	1
Eatoniella ainsworthi (Hedley, 1916)	Animalia|Mollusca|Gastropoda|Neotaenioglossa|Eatoniellidae|Eatoniella|ainsworthi|Eatoniella ainsworthi (Hedley, 1916)	1
Blechnum australe L.	Plantae|Tracheophyta|Polypodiopsida|Polypodiales|Blechnaceae|Blechnum|australe|Blechnum australe L.	1
Alopecurus myosuroides Huds.	Plantae|Tracheophyta|Liliopsida|Poales|Poaceae|Alopecurus|myosuroides|Alopecurus myosuroides Huds.	1
Uromunna schauinslandi (Sars G.O., 1905)	Animalia|Arthropoda|Malacostraca|Isopoda|Munnidae|Uromunna|schauinslandi|Uromunna schauinslandi (Sars G.O., 1905)	1
Othilia Gray, 1840	Animalia|Echinodermata|Asteroidea|Spinulosida|Echinasteridae|Echinaster||Othilia Gray, 1840	1
Surirella Turp.	Plantae|Bacillariophyta|Bacillariophyceae|Surirellales|Surirellaceae|Surirella||Surirella Turp.	1
Fragilariopsis Hustedt, 1913	Chromista|Ochrophyta|Bacillariophyceae|Bacillariales|Bacillariaceae|Fragilariopsis||Fragilariopsis Hustedt, 1913	1
Trophon declinans Watson, 1882	Animalia|Mollusca|Gastropoda|Neogastropoda||Pagodula|declinans|Trophon declinans Watson, 1882	1
Halichondria Fleming, 1828	Animalia|Porifera|Demospongiae|Halichondrida|Halichondriidae|Halichondria||Halichondria Fleming, 1828	1
Homaxinella balfourensis (Ridley & Dendy, 1886)	Animalia|Porifera|Demospongiae|Suberitida|Suberitidae|Homaxinella|balfourensis|Homaxinella balfourensis (Ridley & Dendy, 1886)	1
Alopecurus myosuroides Huds.	Plantae|Magnoliophyta|Liliopsida|Poales|Poaceae|Alopecurus|myosuroides|Alopecurus myosuroides Huds.	1
Xestoleberis Sars, 1866	Animalia|Arthropoda|Ostracoda|Podocopida|Xestoleberididae|Xestoleberis||Xestoleberis Sars, 1866	1
Agrostis capillaris L.	Plantae|Magnoliophyta|Liliopsida|Poales|Poaceae|Agrostis|capillaris|Agrostis capillaris L.	1
Steinera Zahlbr.	Fungi|Ascomycota|Lecanoromycetes|Peltigerales|Coccocarpiaceae|Steinera||Steinera Zahlbr.	1
Huperzia saururus (Lam.) Trevis.	Plantae|Lycopodiophyta|Lycopodiopsida|Lycopodiales|Lycopodiaceae|Huperzia|saururus|Huperzia saururus (Lam.) Trevis.	1
Agrostis capillaris L.	Plantae|Tracheophyta|Liliopsida|Poales|Poaceae|Agrostis|capillaris|Agrostis capillaris L.	1
Caloplaca cribrosa (Hue) Zahlbr., 1931	Fungi|Ascomycota|Lecanoromycetes|Teloschistales|Teloschistaceae|Caloplaca|cribrosa|Caloplaca cribrosa (Hue) Zahlbr., 1931	1
Aulacomya Mörch, 1853	Animalia|Mollusca|Bivalvia|Mytiloida|Mytilidae|Aulacomya||Aulacomya Mörch, 1853	1
Crassulaceae	Plantae|Tracheophyta|Magnoliopsida|Saxifragales|Crassulaceae|||Crassulaceae	1
Clavularia crassa (Milne Edwards, 1868)	Animalia|Cnidaria|Anthozoa|Alcyonacea|Clavulariidae|Clavularia|crassa|Clavularia crassa (Milne Edwards, 1868)	1
Cerebratulus malvini Wheeler, 1934	Animalia|Nemertea|Anopla||Cerebratulidae|Cerebratulus|malvini|Cerebratulus malvini Wheeler, 1934	1
Elaphoglossum randii Alston & Schelpe	Plantae|Tracheophyta|Polypodiopsida|Polypodiales|Dryopteridaceae|Elaphoglossum|randii|Elaphoglossum randii Alston & Schelpe	1
Bryochiton perpusillus Döbbeler, 1978	Fungi|Ascomycota|Dothideomycetes|Pleosporales|Pseudoperisporiaceae|Bryochiton|perpusillus|Bryochiton perpusillus Döbbeler, 1978	1
Syntrichia geheebiaeopsis Zander, 1993	Plantae|Bryophyta|Bryopsida|Pottiales|Pottiaceae|Syntrichia|geheebiaeopsis|Syntrichia geheebiaeopsis Zander, 1993	1
Philobrya kerguelensis (E.A. Smith, 1885)	Animalia|Mollusca|Bivalvia|Arcoida|Philobryidae|Philobrya|kerguelensis|Philobrya kerguelensis (E.A. Smith, 1885)	1
Breutelia chrysura (Müll. Hal.) Broth.	Plantae|Bryophyta|Bryopsida|Bryales|Bartramiaceae|Breutelia|chrysura|Breutelia chrysura (Müll. Hal.) Broth.	1
Trophon condensatus Hedley, 1916	Animalia|Mollusca|Gastropoda|Neogastropoda||Trophon|condensatus|Trophon condensatus Hedley, 1916	1
Ophiacantha vivipara Ljungman, 1870	Animalia|Echinodermata|Ophiuroidea|Ophiurida|Ophiacanthidae|Ophiacantha|vivipara|Ophiacantha vivipara Ljungman, 1870	1
Chaperiopsis patulosa (Waters, 1904)	Animalia|Bryozoa|Gymnolaemata|Cheilostomatida|Chaperiidae|Chaperiopsis|patulosa|Chaperiopsis patulosa (Waters, 1904)	1
Waldeckia Chevreux, 1907	Plantae|Magnoliophyta|Magnoliopsida|Rosales|Rosaceae|Waldeckia||Waldeckia Chevreux, 1907	1
Aira praecox L.	Plantae|Magnoliophyta|Liliopsida|Poales|Poaceae|Aira|praecox|Aira praecox L.	1
Patella Linnaeus, 1758	Animalia|Mollusca|Gastropoda||Patellidae|Patella||Patella Linnaeus, 1758	1
Anatoma euglypta (Pelseneer, 1903)	Animalia|Mollusca|Gastropoda||Anatomidae|Anatoma|euglypta|Anatoma euglypta (Pelseneer, 1903)	1
Eatoniella kerguelenensis subsp. kerguelenensis	Animalia|Mollusca|Gastropoda|Littorinimorpha|Eatoniellidae|Eatoniella|kerguelenensis|Eatoniella kerguelenensis subsp. kerguelenensis	1
Philobrya kerguelensis (E. A. Smith, 1885)	Animalia|Mollusca|Bivalvia|Arcoida|Philobryidae|Philobrya|kerguelensis|Philobrya kerguelensis (E. A. Smith, 1885)	1
Scissurella supraplicata E. A. Smith, 1875	Animalia|Mollusca|Gastropoda||Scissurellidae|Scissurella|supraplicata|Scissurella supraplicata E. A. Smith, 1875	1
Polypodium L.	Plantae|Tracheophyta|Polypodiopsida|Polypodiales|Polypodiaceae|Polypodium||Polypodium L.	1
Breutelia chrysea Jaeger, 1875	Plantae|Bryophyta|Bryopsida|Bryales|Bartramiaceae|Breutelia|chrysea|Breutelia chrysea Jaeger, 1875	1
Cardamine glacialis (G. Forst.) DC.	Plantae|Magnoliophyta|Magnoliopsida|Brassicales|Brassicaceae|Cardamine|glacialis|Cardamine glacialis (G. Forst.) DC.	1
Racomitrium crispulum var. crispulum	Plantae|Bryophyta|Bryopsida|Grimmiales|Grimmiaceae|Racomitrium|crispulum|Racomitrium crispulum var. crispulum	1
Festuca rubra L.	Plantae|Tracheophyta|Liliopsida|Poales|Poaceae|Festuca|rubra|Festuca rubra L.	1
Didymodon J. Hedwig, 1801	Plantae|Bryophyta|Bryopsida|Pottiales|Pottiaceae|Didymodon||Didymodon J. Hedwig, 1801	1
Molpadia violacea Studer, 1876	Animalia|Echinodermata|Holothuroidea|Molpadiida|Molpadiidae|Molpadia|violacea|Molpadia violacea Studer, 1876	1
Kerguelenella lateralis (Gould, 1846)	Animalia|Mollusca|Gastropoda||Siphonariidae|Kerguelenella|lateralis|Kerguelenella lateralis (Gould, 1846)	1
Laevilacunaria antarctica (Martens, 1885)	Animalia|Mollusca|Gastropoda|Littorinimorpha|Littorinidae|Laevilacunaria|antarctica|Laevilacunaria antarctica (Martens, 1885)	1
Pohlia cruda var. cruda	Plantae|Bryophyta|Bryopsida|Bryales|Bryaceae|Pohlia|cruda|Pohlia cruda var. cruda	1
Falsilunatia soluta (Gould, 1848)	Animalia|Mollusca|Gastropoda|Neotaenioglossa|Naticidae|Falsilunatia|soluta|Falsilunatia soluta (Gould, 1848)	1
Condylactis kerguelensis (Studer, 1879)	Animalia|Cnidaria|Anthozoa|Actiniaria|Actiniidae|Condylactis|kerguelensis|Condylactis kerguelensis (Studer, 1879)	1
Melosira C.Agardh, 1824	Chromista|Ochrophyta|Bacillariophyceae|Melosirales|Melosiraceae|Melosira||Melosira C.Agardh, 1824	1
Omalogyra atomus (Philippi, 1841)	Animalia|Mollusca|Gastropoda|Heterostropha|Omalogyridae|Omalogyra|atomus|Omalogyra atomus (Philippi, 1841)	1
Patinigera fuegiensis subsp. edgari Powell, 1957	Animalia|Mollusca|Gastropoda||Nacellidae|Nacella|fuegiensis|Patinigera fuegiensis subsp. edgari Powell, 1957	1
Halichondria panicea (Pallas, 1766)	Animalia|Porifera|Demospongiae|Halichondrida|Halichondriidae|Halichondria|panicea|Halichondria panicea (Pallas, 1766)	1
Melanella amblia (Watson, 1883)	Animalia|Mollusca|Gastropoda|Littorinimorpha|Eulimidae|Melanella|amblia|Melanella amblia (Watson, 1883)	1
Bryochiton perpusillus Döbbeler, 1978	Fungi|Ascomycota|Dothideomycetes||Pseudoperisporiaceae|Bryochiton|perpusillus|Bryochiton perpusillus Döbbeler, 1978	1
Rosaceae	Plantae|Tracheophyta|Magnoliopsida|Rosales|Rosaceae|||Rosaceae	1
Andreaea australis F. Müller ex Mitten, 1856	Plantae|Bryophyta|Andreaeopsida|Andreaeales|Andreaeaceae|Andreaea|australis|Andreaea australis F. Müller ex Mitten, 1856	1
Onoba grisea (Martens, 1885)	Animalia|Mollusca|Gastropoda|Littorinimorpha|Rissoidae|Onoba|grisea|Onoba grisea (Martens, 1885)	1
Xestoleberis G. O. Sars, 1866	Animalia|Arthropoda|Ostracoda|Podocopida|Xestoleberididae|Xestoleberis||Xestoleberis G. O. Sars, 1866	1
Halicarcinus planatus (Fabricius, 1775)	Animalia|Arthropoda|Malacostraca|Decapoda|Hymenosomatidae|Halicarcinus|planatus|Halicarcinus planatus (Fabricius, 1775)	1
Melanella ameliae Engl, 2007	Animalia|Mollusca|Gastropoda|Neotaenioglossa|Eulimidae|Melanella|ameliae|Melanella ameliae Engl, 2007	1
Cardita astartoides Martens, 1878	Animalia|Mollusca|Bivalvia|Carditoida|Carditidae|Cyclocardia|astartoides|Cardita astartoides Martens, 1878	1
Lycopodium saururus Lam.	Plantae|Tracheophyta|Lycopodiopsida|Lycopodiales|Lycopodiaceae|Phlegmariurus|saururus|Lycopodium saururus Lam.	1
Amauropsis xantha (Watson, 1881)	Animalia|Mollusca|Gastropoda|Neotaenioglossa|Naticidae|Falsilunatia|xantha|Amauropsis xantha (Watson, 1881)	1
Henricia spinulfera (E.A. Smith, 1876)	Animalia|Echinodermata|Asteroidea|Spinulosida|Echinasteridae|Henricia|spinulfera|Henricia spinulfera (E.A. Smith, 1876)	1
Lepidonotothen Balushkin, 1976	Animalia|Chordata|Actinopterygii|Perciformes|Nototheniidae|Lepidonotothen||Lepidonotothen Balushkin, 1976	1
Obrimoposthia ohlini (Bergendal, 1899)	Animalia|Platyhelminthes|Rhabditophora|Seriata|Uteriporidae|Obrimoposthia|ohlini|Obrimoposthia ohlini (Bergendal, 1899)	1
Admete Moller, 1842	Animalia|Mollusca|Gastropoda|Neogastropoda|Cancellariidae|Admete||Admete Moller, 1842	1
Melanella subantarctica (Strebel, 1908)	Animalia|Mollusca|Gastropoda|Littorinimorpha|Eulimidae|Melanella|subantarctica|Melanella subantarctica (Strebel, 1908)	1
Clavularia Blainville, 1830	Animalia|Cnidaria|Anthozoa|Alcyonacea|Clavulariidae|Clavularia||Clavularia Blainville, 1830	1
Paradoxostoma kerguelense Mueller, 1908	Animalia|Arthropoda|Ostracoda|Podocopida|Paradoxostomatidae|Paradoxostoma|kerguelense|Paradoxostoma kerguelense Mueller, 1908	1
Trophon condensatus Hedley, 1916	Animalia|Mollusca|Gastropoda|Neogastropoda|Muricidae|Trophon|condensatus|Trophon condensatus Hedley, 1916	1
Sosanopsis kerguelensis Monro, 1939	Animalia|Annelida|Polychaeta|Terebellida|Ampharetidae|Sosane|kerguelensis|Sosanopsis kerguelensis Monro, 1939	1
Caecianiropsis ectiformis (Vanhöffen, 1914)	Animalia|Arthropoda|Malacostraca|Isopoda|Janiridae|Caecianiropsis|ectiformis|Caecianiropsis ectiformis (Vanhöffen, 1914)	1
Pellilitorina pellita (Martens, 1885)	Animalia|Mollusca|Gastropoda|Neotaenioglossa|Littorinidae|Pellilitorina|pellita|Pellilitorina pellita (Martens, 1885)	1
Abarenicola affinis (Ashworth, 1902)	Animalia|Annelida|Polychaeta||Arenicolidae|Abarenicola|affinis|Abarenicola affinis (Ashworth, 1902)	1
Onoba steineni (Strebel, 1908)	Animalia|Mollusca|Gastropoda|Littorinimorpha|Rissoidae|Onoba|steineni|Onoba steineni (Strebel, 1908)	1
Travisia kerguelensis McIntosh, 1885	Animalia|Annelida|Polychaeta||Travisiidae|Travisia|kerguelensis|Travisia kerguelensis McIntosh, 1885	1
Gemmabryum dichotomum (Hedw.) J.R. Spence & H.P. Ramsay	Plantae|Bryophyta|Bryopsida|Bryales|Bryaceae|Bryum|dichotomum|Gemmabryum dichotomum (Hedw.) J.R. Spence & H.P. Ramsay	1
Didemnum studeri Hartmeyer, 1911	Animalia|Chordata|Ascidiacea|Enterogona|Didemnidae|Didemnum|studeri|Didemnum studeri Hartmeyer, 1911	1
Polymastia isidis Thiele, 1905	Animalia|Porifera|Demospongiae|Polymastiida|Polymastiidae|Polymastia|isidis|Polymastia isidis Thiele, 1905	1
Proneptunea amabilis Thiele, 1912	Animalia|Mollusca|Gastropoda|Neogastropoda|Buccinidae|Proneptunea|amabilis|Proneptunea amabilis Thiele, 1912	1
Ophiacantha vivipara subsp. kerguelensis Studer, 1876	Animalia|Echinodermata|Ophiuroidea|Ophiurida|Ophiacanthidae|Ophiacantha|vivipara|Ophiacantha vivipara subsp. kerguelensis Studer, 1876	1
Pancoloides litoralis (Vanhöffen, 1914)	Animalia|Arthropoda|Malacostraca|Tanaidacea|Tanaididae|Pancoloides|litoralis|Pancoloides litoralis (Vanhöffen, 1914)	1
Parantheopsis cruentata (Couthouy in Dana, 1846)	Animalia|Cnidaria|Anthozoa|Actiniaria|Actiniidae|Parantheopsis|cruentata|Parantheopsis cruentata (Couthouy in Dana, 1846)	1
Kerguelenatica bioperculata Dell, 1990	Animalia|Mollusca|Gastropoda|Neotaenioglossa|Naticidae|Kerguelenatica|bioperculata|Kerguelenatica bioperculata Dell, 1990	1
Polystichum mohrioides (Bory ex Willd.) C. Presl	Plantae|Tracheophyta|Polypodiopsida|Polypodiales|Dryopteridaceae|Polystichum|mohrioides|Polystichum mohrioides (Bory ex Willd.) C. Presl	1
Gammaropsis dentifera (Haswell, 1879)	Animalia|Arthropoda|Malacostraca|Amphipoda|Isaeidae|Gammaropsis|dentifera|Gammaropsis dentifera (Haswell, 1879)	1
Anatina elliptica King & Broderip, 1832	Animalia|Mollusca|Bivalvia|Anomalodesmata|Laternulidae|Laternula|elliptica|Anatina elliptica King & Broderip, 1832	1
Psilopilum antarcticum (Müll. Hal.) Paris	Plantae|Bryophyta|Bryopsida|Polytrichales|Polytrichaceae|Notoligotrichum|antarcticum|Psilopilum antarcticum (Müll. Hal.) Paris	1
Montia L.	Plantae|Tracheophyta|Magnoliopsida|Caryophyllales|Montiaceae|Montia||Montia L.	1
Pohlia Hedw.	Plantae|Bryophyta|Bryopsida|Bryales|Bryaceae|Pohlia||Pohlia Hedw.	1
Steinera brattii	Fungi|Ascomycota|Lecanoromycetes|Peltigerales|Coccocarpiaceae|Steinera|brattii|Steinera brattii	1
Protopannaria alcicornis P. M. Jørg. & R. S. Poulsen	Fungi|Ascomycota|Lecanoromycetes|Peltigerales|Pannariaceae|Protopannaria|alcicornis|Protopannaria alcicornis P. M. Jørg. & R. S. Poulsen	1
Cerithiella Verrill, 1882	Animalia|Mollusca|Gastropoda|Neotaenioglossa|Cerithiidae|Cerithiella||Cerithiella Verrill, 1882	1
Pagonana dilatata (Vanhoeffen, 1914)	Animalia|Arthropoda|Malacostraca|Isopoda|Paramunnidae|Pagonana|dilatata|Pagonana dilatata (Vanhoeffen, 1914)	1
Moraria Scott T. & A. Scott, 1893	Animalia|Arthropoda|Maxillopoda|Harpacticoida|Canthocamptidae|Moraria||Moraria Scott T. & A. Scott, 1893	1
Tubificidae	Animalia|Annelida|Clitellata|Haplotaxida|Tubificidae|||Tubificidae	1
Bryoerythrophyllum recurvirostrum Chen Pan-chieh, 1941	Plantae|Bryophyta|Bryopsida|Pottiales|Pottiaceae|Bryoerythrophyllum|recurvirostrum|Bryoerythrophyllum recurvirostrum Chen Pan-chieh, 1941	1
Drepanocladus uncinatus (Hedw.) Warnst.	Plantae|Bryophyta|Bryopsida|Hypnales|Amblystegiaceae|Sanionia|uncinatus|Drepanocladus uncinatus (Hedw.) Warnst.	1
Pecten Muller, 1776	Animalia|Mollusca|Bivalvia|Ostreoida|Pectinidae|Pecten||Pecten Muller, 1776	1
Amauropsis xantha (Watson, 1881)	Animalia|Mollusca|Gastropoda|Littorinimorpha|Naticidae|Falsilunatia|xantha|Amauropsis xantha (Watson, 1881)	1
Lecanora broccha Nyl.	Fungi|Ascomycota|Lecanoromycetes|Lecanorales|Lecanoraceae|Lecanora|broccha|Lecanora broccha Nyl.	1
Santia marmorata (Vanhöffen, 1914)	Animalia|Arthropoda|Malacostraca|Isopoda|Santiidae|Santia|marmorata|Santia marmorata (Vanhöffen, 1914)	1
Isolepis R. Br.	Plantae|Tracheophyta|Liliopsida|Poales|Cyperaceae|Isolepis||Isolepis R. Br.	1
Eatoniella ainsworthi (Hedley, 1916)	Animalia|Mollusca|Gastropoda|Littorinimorpha|Eatoniellidae|Eatoniella|ainsworthi|Eatoniella ainsworthi (Hedley, 1916)	1
Ranunculus moseleyi Hook.f.	Plantae|Magnoliophyta|Magnoliopsida|Ranunculales|Ranunculaceae|Ranunculus|moseleyi|Ranunculus moseleyi Hook.f.	1
Nesidea villosa (Brady, 1880) Mueller, 1908	Animalia|Arthropoda|Ostracoda|Podocopida|Bairdiidae|Bairdia|villosa|Nesidea villosa (Brady, 1880) Mueller, 1908	1
Nebaliella antarctica Thiele, 1904	Animalia|Arthropoda|Malacostraca|Leptostraca|Nebaliidae|Nebaliella|antarctica|Nebaliella antarctica Thiele, 1904	1
Torellia mirabilis (E. A. Smith, 1907)	Animalia|Mollusca|Gastropoda|Littorinimorpha|Capulidae|Torellia|mirabilis|Torellia mirabilis (E. A. Smith, 1907)	1
Mytilus Linnaeus, 1758	Animalia|Mollusca|Bivalvia|Mytiloida|Mytilidae|Mytilus||Mytilus Linnaeus, 1758	1
Onoba suavis (Thiele, 1925)	Animalia|Mollusca|Gastropoda|Littorinimorpha|Rissoidae|Onoba|suavis|Onoba suavis (Thiele, 1925)	1
Pohlia J. Hedwig, 1801	Plantae|Bryophyta|Bryopsida|Bryales|Bryaceae|Pohlia||Pohlia J. Hedwig, 1801	1
Atylus villosus Bate, 1862	Animalia|Arthropoda|Malacostraca|Amphipoda|Dexaminidae|Atylus|villosus|Atylus villosus Bate, 1862	1
Halichondria Fleming, 1828	Animalia|Porifera|Demospongiae|Suberitida|Halichondriidae|Halichondria||Halichondria Fleming, 1828	1
Sosanopsis kerguelensis Monro, 1939	Animalia|Annelida|Polychaeta|Terebellida|Ampharetidae|Sosanopsis|kerguelensis|Sosanopsis kerguelensis Monro, 1939	1
Luzula campestris (L.) DC.	Plantae|Tracheophyta|Liliopsida|Poales|Juncaceae|Luzula|campestris|Luzula campestris (L.) DC.	1
Cardamine glacialis (G. Forst.) DC.	Plantae|Tracheophyta|Magnoliopsida|Brassicales|Brassicaceae|Cardamine|glacialis|Cardamine glacialis (G. Forst.) DC.	1
Patinigera Dall, 1905	Animalia|Mollusca|Gastropoda|Archaeogastropoda|Patellidae|Patinigera||Patinigera Dall, 1905	1
Polytrichastrum alpinum (Hedw.) G. L. Sm.	Plantae|Bryophyta|Bryopsida|Polytrichales|Polytrichaceae|Polytrichastrum|alpinum|Polytrichastrum alpinum (Hedw.) G. L. Sm.	1
Aforia trilix (Watson, 1881)	Animalia|Mollusca|Gastropoda|Neogastropoda|Cochlespiridae|Aforia|trilix|Aforia trilix (Watson, 1881)	1
Lissarca rubrofusca (E. A. Smith, 1879)	Animalia|Mollusca|Bivalvia|Arcoida|Philobryidae|Lissarca|rubrofusca|Lissarca rubrofusca (E. A. Smith, 1879)	1
Proneptunea Thiele, 1912	Animalia|Mollusca|Gastropoda|Neogastropoda|Buccinidae|Proneptunea||Proneptunea Thiele, 1912	1
Kidderia bicolor (Martens, 1885)	Animalia|Mollusca|Bivalvia|Veneroida|Cyamiidae|Kidderia|bicolor|Kidderia bicolor (Martens, 1885)	1
Bathyraja Ishyama & Hubbs, 1968	Animalia|Chordata|Elasmobranchii|Rajiformes|Arhynchobatidae|Bathyraja||Bathyraja Ishyama & Hubbs, 1968	1
Cerithiella superba Thiele, 1912	Animalia|Mollusca|Gastropoda||Newtoniellidae|Cerithiella|superba|Cerithiella superba Thiele, 1912	1
Beania magellanica (Busk, 1852)	Animalia|Bryozoa|Gymnolaemata|Cheilostomatida|Beaniidae|Beania|magellanica|Beania magellanica (Busk, 1852)	1
Arrhenatherum elatius (L.) P.Beauv. ex J.Presl & C.Presl.	Plantae|Tracheophyta|Liliopsida|Poales|Poaceae|Arrhenatherum|elatius|Arrhenatherum elatius (L.) P.Beauv. ex J.Presl & C.Presl.	1
Aira praecox L.	Plantae|Tracheophyta|Liliopsida|Poales|Poaceae|Aira|praecox|Aira praecox L.	1
Homaxinella balfourensis (Ridley & Dendy, 1886)	Animalia|Porifera|Demospongiae|Hadromerida|Suberitidae|Homaxinella|balfourensis|Homaxinella balfourensis (Ridley & Dendy, 1886)	1
Molpadia musculus Risso, 1826	Animalia|Echinodermata|Holothuroidea|Molpadida|Molpadiidae|Molpadia|musculus|Molpadia musculus Risso, 1826	1
Lepidonotothen mizops (Günther, 1880)	Animalia|Chordata|Actinopterygii|Perciformes|Nototheniidae|Lepidonotothen|mizops|Lepidonotothen mizops (Günther, 1880)	1
Pseudosuberites sulcatus (Thiele, 1905)	Animalia|Porifera|Demospongiae|Hadromerida|Suberitidae|Pseudosuberites|sulcatus|Pseudosuberites sulcatus (Thiele, 1905)	1
Tortula princeps De Not.	Plantae|Bryophyta|Bryopsida|Pottiales|Pottiaceae|Syntrichia|princeps|Tortula princeps De Not.	1
Henricia spinulfera (E. A. Smith, 1876)	Animalia|Echinodermata|Asteroidea|Spinulosida|Echinasteridae|Henricia|spinulfera|Henricia spinulfera (E. A. Smith, 1876)	1
Drepanocladus uncinatus (Hedw.) Warnst.	Plantae|Bryophyta|Bryopsida|Hypnales|Amblystegiaceae|Harpidium|uncinatus|Drepanocladus uncinatus (Hedw.) Warnst.	1
Triticum aestivum L.	Plantae|Tracheophyta|Liliopsida|Poales|Poaceae|Triticum|aestivum|Triticum aestivum L.	1
Tortula princeps De Not.	Plantae|Bryophyta|Bryopsida|Pottiales|Pottiaceae|Tortula|princeps|Tortula princeps De Not.	1
Cyclotella (Kützing) Brébisson, 1838	Chromista|Ochrophyta|Bacillariophyceae|Thalassiosirales|Stephanodiscaceae|Cyclotella||Cyclotella (Kützing) Brébisson, 1838	1
Cerithiella astrolabiensis (Strebel, 1908)	Animalia|Mollusca|Gastropoda||Newtoniellidae|Cerithiella|astrolabiensis|Cerithiella astrolabiensis (Strebel, 1908)	1
Onoba H. Adams & A. Adams, 1852	Animalia|Mollusca|Gastropoda|Neotaenioglossa|Rissoidae|Onoba||Onoba H. Adams & A. Adams, 1852	1
Molgula kerguelenensis Kott, 1954	Animalia|Chordata|Ascidiacea|Pleurogona|Molgulidae|Molgula|kerguelenensis|Molgula kerguelenensis Kott, 1954	1
Torellia mirabilis (Smith, 1907)	Animalia|Mollusca|Gastropoda|Neotaenioglossa|Capulidae|Torellia|mirabilis|Torellia mirabilis (Smith, 1907)	1
Cerithiella astrolabiensis (Strebel, 1908)	Animalia|Mollusca|Gastropoda|Neotaenioglossa|Cerithiidae|Cerithiella|astrolabiensis|Cerithiella astrolabiensis (Strebel, 1908)	1
Caecianiropsis ectiformis (Vanhoeffen, 1914)	Animalia|Arthropoda|Malacostraca|Isopoda|Janiridae|Caecianiropsis|ectiformis|Caecianiropsis ectiformis (Vanhoeffen, 1914)	1
Notothenia mizops Günther, 1880	Animalia|Chordata|Actinopterygii|Perciformes|Nototheniidae|Lepidonotothen|mizops|Notothenia mizops Günther, 1880	1
Licomophora	Plantae|Bacillariophyta|Bacillariophyceae|Surirellales|Surirellaceae|Licomophora||Licomophora	1
Hiatella solida (Sowerby, 1834)	Animalia|Mollusca|Bivalvia|Myoida|Hiatellidae|Hiatella|solida|Hiatella solida (Sowerby, 1834)	1
Licmophora C.Agardh, 1827	Chromista|Ochrophyta|Bacillariophyceae|Licmophorales|Licmophoraceae|Licmophora||Licmophora C.Agardh, 1827	1
Kerguelenatica bioperculata Dell, 1990	Animalia|Mollusca|Gastropoda|Littorinimorpha|Naticidae|Kerguelenatica|bioperculata|Kerguelenatica bioperculata Dell, 1990	1
Anatina elliptica King & Broderip, 1832	Animalia|Mollusca|Bivalvia|Pholadomyoida|Laternulidae|Laternula|elliptica|Anatina elliptica King & Broderip, 1832	1
Pagonana dilatata (Vanhöffen, 1914)	Animalia|Arthropoda|Malacostraca|Isopoda|Paramunnidae|Pagonana|dilatata|Pagonana dilatata (Vanhöffen, 1914)	1
Admete carinata (Watson, 1882)	Animalia|Mollusca|Gastropoda|Neogastropoda|Cancellariidae|Zeadmete|carinata|Admete carinata (Watson, 1882)	1
Polymastia isidis Thiele, 1905	Animalia|Porifera|Demospongiae|Hadromerida|Polymastiidae|Polymastia|isidis|Polymastia isidis Thiele, 1905	1
Cerithiella superba Thiele, 1912	Animalia|Mollusca|Gastropoda|Neotaenioglossa|Cerithiidae|Cerithiella|superba|Cerithiella superba Thiele, 1912	1
Carbasea ovoidea Busk, 1852	Animalia|Bryozoa|Gymnolaemata|Cheilostomatida|Flustridae|Carbasea|ovoidea|Carbasea ovoidea Busk, 1852	1
Nesidea villosa (Brady, 1880)	Animalia|Arthropoda|Ostracoda|Podocopida|Bairdiidae|Bairdoppilata|villosa|Nesidea villosa (Brady, 1880)	1
Fragilariopsis Hustedt in A. Schmidt	Plantae|Bacillariophyta|Bacillariophyceae|Bacillariales|Bacillariaceae|Fragilariopsis||Fragilariopsis Hustedt in A. Schmidt	1
Hordeum vulgare L.	Plantae|Tracheophyta|Liliopsida|Poales|Poaceae|Hordeum|vulgare|Hordeum vulgare L.	1
Cycethra frigida (Koehler, 1917)	Animalia|Echinodermata|Asteroidea|Valvatida|Ganeriidae|Cycethra|frigida|Cycethra frigida (Koehler, 1917)	1
Siphonaria G. B. Sowerby I, 1823	Animalia|Mollusca|Gastropoda||Siphonariidae|Siphonaria||Siphonaria G. B. Sowerby I, 1823	1
Struthiolaria Lamarck, 1816	Animalia|Mollusca|Gastropoda|Littorinimorpha|Struthiolariidae|Struthiolaria||Struthiolaria Lamarck, 1816	1
Rhachotropis S.I. Smith, 1883	Animalia|Arthropoda|Malacostraca|Amphipoda|Eusiridae|Rhachotropis||Rhachotropis S.I. Smith, 1883	1
Lissarca rubrofusca E. A. Smith, 1877	Animalia|Mollusca|Bivalvia|Arcoida|Philobryidae|Lissarca|rubrofusca|Lissarca rubrofusca E. A. Smith, 1877	1
Pecten	Animalia|Mollusca|Bivalvia|Pectinoida|Propeamussiidae|Pecten||Pecten	1
Caloplaca cribrosa (Hue) Zahlbr.	Fungi|Ascomycota|Lecanoromycetes|Teloschistales|Teloschistaceae|Caloplaca|cribrosa|Caloplaca cribrosa (Hue) Zahlbr.	1
Anatoma euglypta (Pelseneer, 1903)	Animalia|Mollusca|Gastropoda|Archaeogastropoda|Scissurellidae|Anatoma|euglypta|Anatoma euglypta (Pelseneer, 1903)	1
Phalaris aquatica L.	Plantae|Magnoliophyta|Liliopsida|Poales|Poaceae|Phalaris|aquatica|Phalaris aquatica L.	1
Gammaropsis (Paranaenia) dentifera (Haswell, 1879)	Animalia|Arthropoda|Malacostraca|Amphipoda|Isaeidae|Gammaropsis|dentifera|Gammaropsis (Paranaenia) dentifera (Haswell, 1879)	1
Patella kerguelenensis Smith, 1877	Animalia|Mollusca|Gastropoda|Archaeogastropoda|Nacellidae|Nacella|kerguelenensis|Patella kerguelenensis Smith, 1877	1
Didymodon Hedw.	Plantae|Bryophyta|Bryopsida|Pottiales|Pottiaceae|Didymodon||Didymodon Hedw.	1
Trophon declinans Watson, 1882	Animalia|Mollusca|Gastropoda|Neogastropoda|Muricidae|Pagodula|declinans|Trophon declinans Watson, 1882	1
Siphonaria lateralis Gould, 1846	Animalia|Mollusca|Gastropoda||Siphonariidae|Kerguelenella|lateralis|Siphonaria lateralis Gould, 1846	1
Cardita astartoides Martens, 1878	Animalia|Mollusca|Bivalvia|Veneroida|Carditidae|Cyclocardia|astartoides|Cardita astartoides Martens, 1878	1
Siphonaria Sowerby, 1823	Animalia|Mollusca|Gastropoda|Basommatophora|Siphonariidae|Siphonaria||Siphonaria Sowerby, 1823	1
Bathyraja Ishiyama, 1958	Animalia|Chordata|Elasmobranchii|Rajiformes|Arhynchobatidae|Bathyraja||Bathyraja Ishiyama, 1958	1
Lineus longifissus (Hubrecht, 1887)	Animalia|Nemertea|Anopla||Lineidae|Heteronemertes|longifissus|Lineus longifissus (Hubrecht, 1887)	1
Polyzoa opuntia Lesson, 1830	Animalia|Chordata|Ascidiacea|Pleurogona|Styelidae|Polyzoa|opuntia|Polyzoa opuntia Lesson, 1830	1
Onoba steineni (Strebel, 1908)	Animalia|Mollusca|Gastropoda|Neotaenioglossa|Rissoidae|Onoba|steineni|Onoba steineni (Strebel, 1908)	1
Lycopodium saururus Lam.	Plantae|Lycopodiophyta|Lycopodiopsida|Lycopodiales|Lycopodiaceae|Lycopodium|saururus|Lycopodium saururus Lam.	1
Craniella crassispicula (Lendenfeld, 1907)	Animalia|Porifera|Demospongiae|Tetractinellida|Tetillidae|Craniella|crassispicula|Craniella crassispicula (Lendenfeld, 1907)	1
Leptodontium (Müller Hal.) Hampe ex S.O. Lindberg, 1864	Plantae|Bryophyta|Bryopsida|Pottiales|Pottiaceae|Leptodontium||Leptodontium (Müller Hal.) Hampe ex S.O. Lindberg, 1864	1
Isopterygiopsis pulchella Iwatsuki, 1987	Plantae|Bryophyta|Bryopsida|Hypnales|Plagiotheciaceae|Isopterygiopsis|pulchella|Isopterygiopsis pulchella Iwatsuki, 1987	1
Blechnum australe L.	Plantae|Pteridophyta|Polypodiopsida|Polypodiales|Blechnaceae|Blechnum|australe|Blechnum australe L.	1
Chordata	Animalia|Chordata||||||Chordata	1
Protopannaria alcicornis P.M. Jørg. & R.S. Poulsen	Fungi|Ascomycota|Lecanoromycetes|Peltigerales|Pannariaceae|Protopannaria|alcicornis|Protopannaria alcicornis P.M. Jørg. & R.S. Poulsen	1
Zanclorhynchus spinifer Günther, 1880	Animalia|Chordata|Actinopterygii|Scorpaeniformes|Congiopodidae|Zanclorhynchus|spinifer|Zanclorhynchus spinifer Günther, 1880	1
Racomitrium crispulum J. D. Hooker & Wilson, 1854	Plantae|Bryophyta|Bryopsida|Grimmiales|Grimmiaceae|Racomitrium|crispulum|Racomitrium crispulum J. D. Hooker & Wilson, 1854	1
Aptenodytes patagonicus subsp. halli	Animalia|Chordata|Aves|Sphenisciformes|Spheniscidae|Aptenodytes|patagonicus|Aptenodytes patagonicus subsp. halli	1
Ranunculus biternatus Sm.	Plantae|Magnoliophyta|Magnoliopsida|Ranunculales|Ranunculaceae|Ranunculus|biternatus|Ranunculus biternatus Sm.	1
Moraria T. Scott & A. Scott, 1893	Animalia|Arthropoda|Maxillopoda|Harpacticoida|Canthocamptidae|Moraria||Moraria T. Scott & A. Scott, 1893	1
Melanella subantarctica (Strebel, 1908)	Animalia|Mollusca|Gastropoda|Neotaenioglossa|Eulimidae|Melanella|subantarctica|Melanella subantarctica (Strebel, 1908)	1
Onoba kergueleni (E. A. Smith, 1875)	Animalia|Mollusca|Gastropoda|Neotaenioglossa|Rissoidae|Onoba|kergueleni|Onoba kergueleni (E. A. Smith, 1875)	1
Craniella crassispicula (Lendenfeld, 1907)	Animalia|Porifera|Demospongiae|Spirophorida|Tetillidae|Craniella|crassispicula|Craniella crassispicula (Lendenfeld, 1907)	1
Lyncina lynx (Linnaeus, 1758)	Animalia|Mollusca|Gastropoda|Neotaenioglossa|Cypraeidae|Lyncina|lynx|Lyncina lynx (Linnaeus, 1758)	1
Waldeckia chevreuxi Stebbing, 1910	Animalia|Arthropoda|Malacostraca|Amphipoda|Lysianassidae|Waldeckia|chevreuxi|Waldeckia chevreuxi Stebbing, 1910	1
Surirella Turpin, 1828	Chromista|Ochrophyta|Bacillariophyceae|Surirellales|Surirellaceae|Surirella||Surirella Turpin, 1828	1
Dynamenella huttoni (Thomson, 1879)	Animalia|Arthropoda|Malacostraca|Isopoda|Sphaeromatidae|Dynamenella|huttoni|Dynamenella huttoni (Thomson, 1879)	1
Plagiochila (Dumort.) Dumort.	Plantae|Marchantiophyta|Jungermanniopsida|Jungermanniales|Plagiochilaceae|Plagiochila||Plagiochila (Dumort.) Dumort.	1
Nebaliella antarctica Thiele, 1904	Animalia|Arthropoda|Malacostraca|Nebaliacea|Nebaliidae|Nebaliella|antarctica|Nebaliella antarctica Thiele, 1904	1
Xestoleberis kerguelensis Mueller, 1908	Animalia|Arthropoda|Ostracoda|Podocopida|Xestoleberididae|Xestoleberis|kerguelensis|Xestoleberis kerguelensis Mueller, 1908	1
Pleurotomella Verrill, 1872	Animalia|Mollusca|Gastropoda|Neogastropoda|Conidae|Pleurotomella||Pleurotomella Verrill, 1872	1
Kidderia bicolor (Martens, 1885)	Animalia|Arthropoda|Malacostraca|Amphipoda|Cyamidae|Kidderia|bicolor|Kidderia bicolor (Martens, 1885)	1
Falsilunatia soluta (Gould, 1848)	Animalia|Mollusca|Gastropoda|Littorinimorpha|Naticidae|Falsilunatia|soluta|Falsilunatia soluta (Gould, 1848)	1
Melosira C. A. Agardh	Chromista|Ochrophyta|Coscinodiscophyceae|Meloseirales|Melosiraceae|Melosira||Melosira C. A. Agardh	1
Cerithiella werthi Thiele, 1912	Animalia|Mollusca|Gastropoda||Newtoniellidae|Cerithiella|werthi|Cerithiella werthi Thiele, 1912	1
Aforia trilix (Watson, 1881)	Animalia|Mollusca|Gastropoda|Neogastropoda|Turridae|Aforia|trilix|Aforia trilix (Watson, 1881)	1
Aulacomya regia Powell, 1957	Animalia|Mollusca|Bivalvia|Mytiloida|Mytilidae|Aulacomya|regia|Aulacomya regia Powell, 1957	1
Notothenia mizops Günther, 1880	Animalia|Chordata|Actinopterygii|Perciformes|Nototheniidae|Lindbergichthys|mizops|Notothenia mizops Günther, 1880	1